Time(S);YoungBefore(KB);YoungAfter(KB);YoungAllocated(KB);OldBefore(KB);OldAfter(KB);OldAllocated(KB);OldYoungBefore(KB);OldYoungAfter(KB);OldYoungAllocated(KB);PermBefore(KB);PermAfter(KB);PermAllocated(KB);TotalBefore(KB);TotalAfter(KB);TotalAllocated(KB)
5,365;95137;9545;153600;0;72;349696;95137;9617;503296;;;;;;
5,391;9545;0;153600;72;9235;349696;9617;9235;503296;15964;15956;786432;25581;25191;1289728
8,593;132096;11448;153600;9235;9235;349696;141331;20683;503296;;;;;;
10,099;143544;18112;153600;9235;9236;349696;152779;27348;503296;;;;;;
12,243;150208;21491;285696;9236;11750;349696;159444;33241;635392;;;;;;
18,659;285683;21486;285696;11750;27707;349696;297433;49193;635392;;;;;;
20,917;285678;21486;524800;27707;44997;349696;313385;66483;874496;;;;;;
24,904;524782;46586;549888;44997;52637;349696;569779;99223;899584;;;;;;
28,992;549882;58858;600576;52637;74521;349696;602519;133379;950272;;;;;;
31,795;600554;78839;620544;74521;101112;349696;675075;179951;970240;;;;;;
36,333;620535;78826;537600;101112;127751;349696;721647;206577;887296;;;;;;
45,310;537578;50648;579072;127751;191037;349696;665329;241685;928768;;;;;;
50,651;509400;43130;560640;191037;227504;349696;700437;270634;910336;;;;;;
56,621;508026;26871;572928;227504;242201;349696;735530;269072;922624;;;;;;
60,212;491767;16484;587264;242201;252614;349696;733968;269098;936960;;;;;;
243,167;501860;24834;590336;252614;257367;349696;754474;282201;940032;;;;;;
243,882;510210;4081;594432;257367;272401;349696;767577;276482;944128;;;;;;
280,194;496625;23655;516608;272401;274028;349696;769026;297683;866304;;;;;;
382,099;516069;15244;595968;274029;285563;349696;790098;300807;945664;;;;;;
419,681;208844;12983;593408;285564;292703;349696;494408;305686;943104;;;;;;
419,703;12983;0;593408;292703;245337;349696;305686;245337;943104;157091;156743;786432;462777;402080;1729536
548,827;498176;20319;593408;245337;245337;349696;743513;265656;943104;;;;;;
642,296;246279;13781;525312;245337;250762;349696;491616;264543;875008;;;;;;
642,320;13781;0;525312;250762;252376;349696;264543;252376;875008;157735;157733;786432;422278;410109;1661440
724,684;117698;9295;592896;252377;252377;349696;370075;261672;942592;;;;;;
724,698;9295;0;592896;252377;249553;349696;261672;249553;942592;157819;157819;786432;419491;407372;1729024
765,963;29982;5537;517120;249553;249553;349696;279535;255090;866816;;;;;;
765,975;5537;0;517120;249553;246892;349696;255090;246892;866816;157846;157846;786432;412936;404738;1653248
1088,459;368578;14623;584704;246893;246892;349696;615471;261515;934400;;;;;;
1088,494;14623;0;584704;246892;255459;349696;261515;255459;934400;159826;159824;786432;421341;415283;1720832
1151,843;107797;9371;521216;255460;255459;349696;363257;264830;870912;;;;;;
1151,863;9371;0;521216;255459;253316;349696;264830;253316;870912;159932;159932;786432;424762;413248;1657344
1311,289;511488;7822;540160;253316;253317;349696;764804;261139;889856;;;;;;
1852,120;499342;11130;483840;253317;255931;349696;752659;267061;833536;;;;;;
2264,832;483706;11101;497152;255931;258554;349696;739637;269655;846848;;;;;;
2408,125;465245;15946;453120;258554;261024;349696;723799;276970;802816;;;;;;
2441,455;452682;2562;461824;261024;264556;349696;713706;267118;811520;;;;;;
2464,375;422914;18153;422912;264556;265191;349696;687470;283344;772608;;;;;;
2480,010;422633;22940;427520;265191;272149;349696;687824;295089;777216;;;;;;
2529,159;412572;3525;378880;272149;277275;349696;684721;280800;728576;;;;;;
2547,943;378821;5098;397312;277275;278051;349696;656096;283149;747008;;;;;;
2649,497;366570;5016;353792;278051;279727;349696;644621;284743;703488;;;;;;
2694,845;353688;3396;370176;279727;281354;349696;633415;284750;719872;;;;;;
2824,849;339780;4921;329728;281354;282330;349696;621134;287251;679424;;;;;;
2913,210;329529;1321;344576;282330;283122;349696;611859;284443;694272;;;;;;
3037,670;314665;2664;305664;283122;283387;349696;597787;286051;655360;;;;;;
3139,387;305256;5100;319488;283387;284130;349696;588643;289230;669184;;;;;;
3330,195;297452;1359;284160;284130;284930;349696;581582;286289;633856;;;;;;
4258,338;283848;4368;298496;284929;285537;349696;568777;289905;648192;;;;;;
4752,695;221557;3838;277504;285537;286852;349696;507094;290690;627200;;;;;;
4752,711;3838;0;277504;286852;230847;349696;290690;230847;627200;179703;179115;786432;470393;409962;1413632
5389,893;273408;7584;284160;230847;230847;349696;504255;238431;633856;;;;;;
6284,395;271776;9304;265216;230847;232069;349696;502623;241373;614912;;;;;;
6462,771;264792;2995;266240;232069;233781;349696;496861;236776;615936;;;;;;
6594,835;250291;4232;244224;233781;234484;349696;484072;238716;593920;;;;;;
6744,323;243523;9135;249344;234485;235806;349696;478008;244941;599040;;;;;;
6892,003;241071;8016;232960;235806;237670;349696;476877;245686;582656;;;;;;
7178,413;232784;7031;231936;237670;239315;349696;470454;246346;581632;;;;;;
7222,248;225143;5181;217088;239315;240891;349696;464458;246072;566784;;;;;;
7283,035;216637;4557;218624;240891;241813;349696;457528;246370;568320;;;;;;
7322,297;209869;2880;202240;241813;242919;349696;451682;245799;551936;;;;;;
7410,879;202048;2032;206848;242919;243623;349696;444967;245655;556544;;;;;;
7781,290;195568;6436;194560;243623;244297;349696;439191;250733;544256;;;;;;
7860,978;194340;1315;195072;244297;245540;349696;438637;246855;544768;;;;;;
8207,496;184097;1115;179200;245539;245995;349696;429636;247110;528896;;;;;;
8354,014;93376;3541;193024;245995;246371;349696;339371;249912;542720;;;;;;
8354,027;3541;0;193024;246371;238280;349696;249912;238280;542720;180215;179628;786432;430127;417908;1329152
8452,729;177664;3763;177152;238280;238281;349696;415944;242044;526848;;;;;;
8499,063;176819;1024;178688;238281;239435;349696;415100;240459;528384;;;;;;
8831,987;169472;4533;168448;239435;239690;349696;408907;244223;518144;;;;;;
8950,657;168373;6700;169984;239690;240662;349696;408063;247362;519680;;;;;;
9210,676;166444;6848;162816;240662;242511;349696;407106;249359;512512;;;;;;
9846,272;162496;4373;160256;242511;244519;349696;405007;248892;509952;;;;;;
10209,341;155903;4944;156672;244518;246062;349696;400421;251006;506368;;;;;;
10305,000;87661;7894;161792;246063;247220;349696;333724;255114;511488;;;;;;
10305,021;7894;0;161792;247220;243549;349696;255114;243549;511488;179944;179649;786432;435058;423198;1297920
10560,008;149504;5027;162304;243549;243549;349696;393053;248576;512000;;;;;;
10614,067;154531;4195;163328;243549;244453;349696;398080;248648;513024;;;;;;
10647,560;155235;848;162816;244453;245464;349696;399688;246312;512512;;;;;;
10652,960;151888;384;163328;245464;245680;349696;397352;246064;513024;;;;;;
10734,189;151936;2916;163328;245680;245840;349696;397616;248756;513024;;;;;;
10744,478;154468;2116;164352;245840;246424;349696;400308;248540;514048;;;;;;
10759,305;155204;993;163840;246424;246903;349696;401628;247896;513536;;;;;;
10774,961;154081;4764;164864;246903;247224;349696;400984;251988;514560;;;;;;
10787,508;158876;2032;164352;247224;248001;349696;406100;250033;514048;;;;;;
10986,549;155944;2481;165376;248002;248473;349696;403946;250954;515072;;;;;;
11018,265;157587;3755;164864;248473;249270;349696;406060;253025;514560;;;;;;
11042,753;158891;735;165888;249270;250065;349696;408161;250800;515584;;;;;;
11052,829;157407;672;165888;250065;250321;349696;407472;250993;515584;;;;;;
11062,260;157344;576;166400;250321;250416;349696;407665;250992;516096;;;;;;
11088,517;158272;608;166400;250416;250512;349696;408688;251120;516096;;;;;;
11496,089;158304;1427;166912;250512;250625;349696;408816;252052;516608;;;;;;
11522,559;43150;6420;164864;250625;251328;349696;293775;257748;514560;;;;;;
11522,570;6420;0;164864;251328;242812;349696;257748;242812;514560;180051;179762;786432;437799;422574;1300992
11608,733;158208;3381;166400;242812;242812;349696;401020;246193;516096;;;;;;
11642,527;160565;2851;165888;242812;243339;349696;403377;246190;515584;;;;;;
11684,326;160035;1169;166912;243339;244270;349696;403374;245439;516608;;;;;;
11693,023;159889;1469;166912;244270;244510;349696;404159;245979;516608;;;;;;
11718,086;160189;1809;167936;244510;244893;349696;404699;246702;517632;;;;;;
11736,301;162065;1456;167424;244893;245214;349696;406958;246670;517120;;;;;;
11766,788;161712;1088;168448;245214;245485;349696;406926;246573;518144;;;;;;
11802,832;162368;2192;167936;245485;245917;349696;407853;248109;517632;;;;;;
11866,785;163472;1486;168960;245917;246077;349696;409389;247563;518656;;;;;;
11903,032;164302;2952;168960;246077;246737;349696;410379;249689;518656;;;;;;
11910,845;165768;2032;169472;246737;247317;349696;412505;249349;519168;;;;;;
11927,790;165360;2815;168960;247317;247624;349696;412677;250439;518656;;;;;;
11941,277;166143;897;169472;247624;248423;349696;413767;249320;519168;;;;;;
11955,681;164737;3035;169472;248423;248519;349696;413160;251554;519168;;;;;;
12042,407;166875;640;169472;248519;249075;349696;415394;249715;519168;;;;;;
12127,260;164480;1603;169472;249075;249363;349696;413555;250966;519168;;;;;;
12149,730;165443;720;169984;249363;249555;349696;414806;250275;519680;;;;;;
12197,073;165584;2239;169984;249555;249756;349696;415139;251995;519680;;;;;;
12231,737;167103;3772;168960;249756;250222;349696;416859;253994;518656;;;;;;
12243,321;167612;3912;169472;250222;250924;349696;417834;254836;519168;;;;;;
12261,618;167694;1680;169472;250924;251703;349696;418618;253383;519168;;;;;;
12294,525;165520;4665;168960;251703;252332;349696;417223;256997;518656;;;;;;
12315,394;168505;3971;168960;252332;253156;349696;420837;257127;518656;;;;;;
12328,577;166787;896;168960;253156;253960;349696;419943;254856;518656;;;;;;
12378,029;163712;1184;168960;253960;254248;349696;417672;255432;518656;;;;;;
12404,451;164000;4465;167424;254248;254613;349696;418248;259078;517120;;;;;;
12415,861;167281;4004;168448;254613;255635;349696;421894;259639;518144;;;;;;
12466,093;165796;1328;168448;255635;256521;349696;421431;257849;518144;;;;;;
12508,297;163120;6167;166400;256521;256705;349696;419641;262872;516096;;;;;;
12519,276;165911;3795;167424;256705;258174;349696;422616;261969;517120;;;;;;
12532,711;163539;864;167936;258174;259032;349696;421713;259896;517632;;;;;;
12539,959;161120;3797;167424;259032;259281;349696;420152;263078;517120;;;;;;
12557,243;164053;4285;166912;259281;259913;349696;423334;264198;516608;;;;;;
12575,804;164029;6652;166400;259913;260950;349696;423942;267602;516096;;;;;;
12583,017;166396;4099;166912;260950;262132;349696;427346;266231;516608;;;;;;
12604,639;162589;2758;166912;262132;263115;349696;424721;265873;516608;;;;;;
12628,744;161478;4792;167424;263115;263659;349696;424593;268451;517120;;;;;;
12641,816;164536;800;160768;263659;264558;349696;428195;265358;510464;;;;;;
12652,342;160544;1700;167424;264558;264694;349696;425102;266394;517120;;;;;;
12677,455;160932;2327;166912;264694;265079;349696;425626;267406;516608;;;;;;
12687,787;161559;3060;167936;265079;266040;349696;426638;269100;517632;;;;;;
12714,928;163316;848;167424;266040;266608;349696;429356;267456;517120;;;;;;
12748,274;161104;1072;167936;266608;266952;349696;427712;268024;517632;;;;;;
12774,848;161840;5698;166912;267925;268206;349696;429765;273904;516608;;;;;;
12783,010;166466;6025;166400;268210;269291;349696;434676;275316;516096;;;;;;
12800,512;164745;4632;166912;269291;270799;349696;434036;275431;516608;;;;;;
12821,995;163352;991;166912;270799;271474;349696;434151;272465;516608;;;;;;
12855,917;159711;4164;166912;271474;271994;349696;431185;276158;516608;;;;;;
12902,448;162884;944;166912;271994;272956;349696;434878;273900;516608;;;;;;
12948,575;159664;3732;166912;272956;273364;349696;432620;277096;516608;;;;;;
12982,495;162452;720;167424;273364;274157;349696;435816;274877;517120;;;;;;
13035,667;160464;3988;167424;274157;274478;349696;434621;278466;517120;;;;;;
13089,518;163732;656;167424;274478;275387;349696;438210;276043;517120;;;;;;
13116,509;160400;3668;167424;275387;275643;349696;435787;279311;517120;;;;;;
13140,707;163412;864;167424;275643;276659;349696;439055;277523;517120;;;;;;
13157,174;160608;928;167424;276659;276907;349696;437267;277835;517120;;;;;;
13223,806;160672;6088;165888;276907;277243;349696;437579;283331;515584;;;;;;
13335,410;164808;3772;166912;277243;278530;349696;442051;282302;516608;;;;;;
13426,949;162492;1347;167424;278530;279482;349696;441022;280829;517120;;;;;;
13502,153;160579;4049;166912;279482;279897;349696;440061;283946;516608;;;;;;
13533,483;163281;1440;167424;279897;280748;349696;443178;282188;517120;;;;;;
13548,509;161180;4303;167424;280749;281053;349696;441929;285356;517120;;;;;;
13568,806;164047;5963;166400;281053;281896;349696;445100;287859;516096;;;;;;
13580,673;164683;1536;166912;281896;283145;349696;446579;284681;516608;;;;;;
13803,568;160256;5304;165888;283145;283979;349696;443401;289283;515584;;;;;;
13828,536;163000;3588;166400;283979;285548;349696;446979;289136;516096;;;;;;
13924,268;161284;4121;166912;285548;286429;349696;446832;290550;516608;;;;;;
13951,328;162841;3984;166912;286429;287487;349696;449270;291471;516608;;;;;;
13963,148;162704;2724;167424;287487;288493;349696;450191;291217;517120;;;;;;
14028,009;162468;3349;167424;288493;288837;349696;450961;292186;517120;;;;;;
14040,118;163093;2806;168448;288837;289580;349696;451930;292386;518144;;;;;;
14087,232;164086;3164;167936;289580;290260;349696;453666;293424;517632;;;;;;
14111,133;164444;1152;168448;290260;291188;349696;454704;292340;518144;;;;;;
14124,748;162944;903;168448;291188;291525;349696;454132;292428;518144;;;;;;
14163,221;162695;1984;168448;291525;291700;349696;454220;293684;518144;;;;;;
14206,956;163776;6140;167936;291700;292284;349696;455476;298424;517632;;;;;;
14332,473;167932;1504;167936;292284;293331;349696;460216;294835;517632;;;;;;
14387,287;162272;1872;167936;293331;294156;349696;455603;296028;517632;;;;;;
14462,348;162640;6249;166912;294156;294492;349696;456796;300741;516608;;;;;;
14476,553;165993;1136;167424;294492;295544;349696;460485;296680;517120;;;;;;
14535,425;160880;6333;165376;295544;296112;349696;456424;302445;515072;;;;;;
14630,671;164029;5735;163840;296112;297489;349696;460141;303224;513536;;;;;;
14657,074;163431;5815;165888;297489;298704;349696;460920;304519;515584;;;;;;
14734,989;162487;3140;165888;298704;299967;349696;461191;303107;515584;;;;;;
14850,842;159812;1753;166400;299967;300855;349696;459779;302608;516096;;;;;;
15062,811;159449;3908;166400;300855;301537;349696;460304;305445;516096;;;;;;
15123,434;91740;1488;166912;301537;302379;349696;393277;303867;516608;;;;;;
15123,448;1488;0;166912;302379;259965;349696;303867;259965;516608;184161;180998;786432;488028;440963;1303040
15167,081;158720;4632;166912;259965;259965;349696;418685;264597;516608;;;;;;
15185,170;163352;5788;165888;259965;260949;349696;423317;266737;515584;;;;;;
15208,390;163484;3414;166400;260949;262248;349696;424433;265662;516096;;;;;;
15228,617;161110;1587;166912;262248;263096;349696;423358;264683;516608;;;;;;
15252,385;160307;832;166912;263096;263368;349696;423403;264200;516608;;;;;;
15268,807;159552;736;166912;263368;263656;349696;422920;264392;516608;;;;;;
15289,706;159456;3892;166912;263656;263896;349696;423112;267788;516608;;;;;;
15312,190;162612;4136;167424;263896;264927;349696;426508;269063;517120;;;;;;
15359,400;163368;2129;166912;264927;265754;349696;428295;267883;516608;;;;;;
15383,524;161361;2996;167936;265754;266355;349696;427115;269351;517632;;;;;;
15422,086;163252;896;167424;266355;266955;349696;429607;267851;517120;;;;;;
15432,826;161152;800;167936;266955;267291;349696;428107;268091;517632;;;;;;
15458,785;161568;4133;167936;267291;267660;349696;428859;271793;517632;;;;;;
15469,954;164901;4473;166912;267660;268521;349696;432561;272994;516608;;;;;;
15522,220;164217;1224;167424;268521;269140;349696;432738;270364;517120;;;;;;
15547,149;160968;4084;167936;269140;269580;349696;430108;273664;517632;;;;;;
15567,187;164852;2815;167936;269580;270468;349696;434432;273283;517632;;;;;;
15609,495;163583;1168;168448;270468;271179;349696;434051;272347;518144;;;;;;
15627,255;162448;3551;167936;271179;271603;349696;433627;275154;517632;;;;;;
15793,149;164831;6583;166400;271603;272209;349696;436434;278792;516096;;;;;;
16186,415;166327;1072;167424;272209;273293;349696;438536;274365;517120;;;;;;
16237,037;160816;3092;167936;273293;273573;349696;434109;276665;517632;;;;;;
16333,094;163348;3391;167424;273573;274294;349696;436921;277685;517120;;;;;;
16400,020;163647;4899;167936;274294;275166;349696;437941;280065;517632;;;;;;
16698,771;165667;5035;165888;275166;276279;349696;440833;281314;515584;;;;;;
16916,512;165803;1168;167424;276279;277462;349696;442082;278630;517120;;;;;;
16951,677;160912;6901;166912;277462;277679;349696;438374;284580;516608;;;;;;
16980,961;166645;4828;165888;277679;279026;349696;444324;283854;515584;;;;;;
16991,530;162524;1507;166400;279026;280298;349696;441550;281805;516096;;;;;;
17010,218;159203;3120;166912;280298;280713;349696;439501;283833;516608;;;;;;
17014,672;161328;3382;166400;280713;282606;349696;442041;285988;516096;;;;;;
17024,643;161590;2536;167936;282606;284317;349696;444196;286853;517632;;;;;;
17063,274;162792;992;167424;284317;284893;349696;447109;285885;517120;;;;;;
17089,367;161248;912;167936;284893;285189;349696;446141;286101;517632;;;;;;
17104,964;161680;3615;167936;285189;285518;349696;446869;289133;517632;;;;;;
17134,929;164383;768;167936;285518;286053;349696;449901;286821;517632;;;;;;
17151,258;161536;977;167936;286053;286326;349696;447589;287303;517632;;;;;;
17163,300;161745;4096;167936;286326;286493;349696;448071;290589;517632;;;;;;
17197,802;164864;4016;167936;286493;287029;349696;451357;291045;517632;;;;;;
17208,957;164784;3266;167936;287029;288293;349696;451813;291559;517632;;;;;;
17327,865;164034;4062;167936;288293;289487;349696;452327;293549;517632;;;;;;
17387,253;164830;2224;168448;289487;290829;349696;454317;293053;518144;;;;;;
17504,302;163504;4244;167936;290829;291110;349696;454333;295354;517632;;;;;;
17557,896;165524;2639;168448;291110;292182;349696;456634;294821;518144;;;;;;
17599,139;163919;864;167936;292182;292894;349696;456101;293758;517632;;;;;;
17611,091;162144;1872;168448;292894;293302;349696;455038;295174;518144;;;;;;
17642,958;163638;3248;168448;293303;293901;349696;456941;297149;518144;;;;;;
17666,462;165040;1024;168960;293901;294660;349696;458941;295684;518656;;;;;;
17674,080;163840;978;168960;294660;294997;349696;458500;295975;518656;;;;;;
17686,612;163783;3361;168960;294996;295156;349696;458779;298517;518656;;;;;;
17709,213;166177;1792;168960;295156;295776;349696;461333;297568;518656;;;;;;
17722,781;164608;1661;169472;295776;296248;349696;460384;297909;519168;;;;;;
17733,912;164989;1792;168960;296248;296488;349696;461237;298280;518656;;;;;;
17745,272;165120;4277;168448;296488;297102;349696;461608;301379;518144;;;;;;
17777,530;167093;5498;168448;297102;297575;349696;464195;303073;518144;;;;;;
17804,243;168314;1217;168448;297575;298749;349696;465889;299966;518144;;;;;;
17837,999;163009;2816;168448;298749;299181;349696;461758;301997;518144;;;;;;
17877,133;164608;2682;168960;299181;299821;349696;463789;302503;518656;;;;;;
17891,204;165498;3976;168960;299821;300408;349696;465319;304384;518656;;;;;;
17901,565;166792;3172;168960;300408;300784;349696;467200;303956;518656;;;;;;
17905,481;165988;2663;168960;300784;301772;349696;466772;304435;518656;;;;;;
17914,186;165479;3956;168448;301772;302307;349696;467251;306263;518144;;;;;;
17934,006;166772;2721;168960;302307;303235;349696;469079;305956;518656;;;;;;
17945,094;165537;1201;169472;303235;303953;349696;468772;305154;519168;;;;;;
17956,958;165041;1328;169472;303953;304385;349696;468994;305713;519168;;;;;;
17964,813;165168;3452;169472;304385;304858;349696;469553;308310;519168;;;;;;
17971,489;167292;1425;169472;304858;305891;349696;472150;307316;519168;;;;;;
18007,420;165265;1092;169472;305891;306531;349696;471156;307623;519168;;;;;;
18018,268;164932;2820;169472;306531;306851;349696;471463;309671;519168;;;;;;
18034,329;166660;4680;168448;306851;307564;349696;473511;312244;518144;;;;;;
18075,414;167496;1024;168960;307564;308227;349696;475060;309251;518656;;;;;;
18094,348;163840;512;168960;308227;308763;349696;472067;309275;518656;;;;;;
18157,924;163328;1913;168960;308763;309028;349696;472091;310941;518656;;;;;;
18269,603;164650;3312;169472;309028;309556;349696;473678;312868;519168;;;;;;
18310,617;167152;1057;169472;309556;310147;349696;476708;311204;519168;;;;;;
18339,803;164897;704;169472;310147;310443;349696;475044;311147;519168;;;;;;
18378,834;164544;2676;169472;310443;310659;349696;474987;313335;519168;;;;;;
18435,917;166516;4488;168448;310659;311389;349696;477175;315877;518144;;;;;;
18463,708;167304;1216;168960;311389;312256;349696;478693;313472;518656;;;;;;
18510,438;164032;1184;169472;312256;312384;349696;476288;313568;519168;;;;;;
18550,327;164512;1364;168960;312384;312912;349696;476896;314276;518656;;;;;;
18584,529;164692;2464;169472;312912;313056;349696;477604;315520;519168;;;;;;
18676,479;166304;1568;169472;313056;313512;349696;479360;315080;519168;;;;;;
18724,458;128336;640;169984;313512;313688;349696;441848;314328;519680;;;;;;
18724,468;640;0;169984;313688;266629;349696;314328;266629;519680;184045;181300;786432;498373;447929;1306112
18775,100;164714;3566;168448;266954;266954;349696;431668;270520;518144;;;;;;
18926,442;168430;2849;169472;266957;267791;349696;435387;270640;519168;;;;;;
18969,533;166689;4060;169472;267791;268679;349696;434480;272739;519168;;;;;;
19023,343;167900;3620;168448;268679;269718;349696;436579;273338;518144;;;;;;
19053,078;166436;4044;168960;269718;270594;349696;436154;274638;518656;;;;;;
19064,853;166860;2496;168960;270594;271273;349696;437454;273769;518656;;;;;;
19076,120;165312;1440;168960;271273;271881;349696;436585;273321;518656;;;;;;
19118,668;164256;4940;167424;271881;272723;349696;436137;277663;517120;;;;;;
19188,579;166732;1090;168448;272723;274389;349696;439455;275479;518144;;;;;;
19196,508;162882;1060;168960;274389;274549;349696;437271;275609;518656;;;;;;
19247,288;163876;4166;167424;274549;274892;349696;438425;279058;517120;;;;;;
19294,152;166982;912;168448;274892;275879;349696;441874;276791;518144;;;;;;
19361,323;162704;4550;168448;275879;276006;349696;438583;280556;518144;;;;;;
19403,243;166342;3068;168448;276006;276980;349696;442348;280048;518144;;;;;;
19449,473;164860;4597;166400;276980;277731;349696;441840;282328;516096;;;;;;
19493,313;166389;755;167936;277731;278868;349696;444120;279623;517632;;;;;;
19601,551;161523;2511;167936;278868;278971;349696;440391;281482;517632;;;;;;
19644,074;163279;4502;168448;278971;280125;349696;442250;284627;518144;;;;;;
19694,691;166294;4948;166912;280125;281126;349696;446419;286074;516608;;;;;;
19820,127;166740;2564;167936;281126;282051;349696;447866;284615;517632;;;;;;
19895,915;163332;2863;167936;282051;282755;349696;445383;285618;517632;;;;;;
19934,887;163631;4776;167424;282755;283492;349696;446386;288268;517120;;;;;;
20150,595;165544;4991;167936;283492;284532;349696;449036;289523;517632;;;;;;
20488,275;165759;3140;167936;284532;285417;349696;450291;288557;517632;;;;;;
20527,023;163908;5141;167936;285417;286209;349696;449325;291350;517632;;;;;;
20553,885;165909;7154;164864;286209;287962;349696;452118;295116;514560;;;;;;
20572,314;164850;4413;166400;287962;289544;349696;452812;293957;516096;;;;;;
20610,896;162109;3132;166912;289544;290522;349696;451653;293654;516608;;;;;;
20637,046;161340;1151;166400;290522;291155;349696;451862;292306;516096;;;;;;
20658,056;159359;1408;166912;291155;291746;349696;450514;293154;516608;;;;;;
20666,598;160128;2387;166912;291746;292138;349696;451874;294525;516608;;;;;;
20695,973;161107;2704;167424;292138;292698;349696;453245;295402;517120;;;;;;
20863,034;161936;3636;166912;292698;293611;349696;454634;297247;516608;;;;;;
20939,266;162868;3284;167936;293611;294504;349696;456479;297788;517632;;;;;;
20975,866;163540;3433;167424;294504;295311;349696;458044;298744;517120;;;;;;
21001,826;163689;4744;167424;295311;296139;349696;459000;300883;517120;;;;;;
21089,952;165512;1056;167936;296139;297054;349696;461651;298110;517632;;;;;;
21138,905;161824;899;167936;297054;297463;349696;458878;298362;517632;;;;;;
21221,627;161667;4868;167936;297463;297719;349696;459130;302587;517632;;;;;;
21345,605;165636;1584;167936;297719;298772;349696;463355;300356;517632;;;;;;
21392,426;162352;1968;167936;298772;299228;349696;461124;301196;517632;;;;;;
21420,429;162736;1075;167936;299228;299946;349696;461964;301021;517632;;;;;;
21593,170;161843;5059;165888;299946;300186;349696;461789;305245;515584;;;;;;
21651,823;165827;784;167936;300186;301171;349696;466013;301955;517632;;;;;;
21747,094;161040;4146;167424;301171;301452;349696;462211;305598;517120;;;;;;
21778,044;164402;4416;167424;301452;302188;349696;465854;306604;517120;;;;;;
21805,167;164160;800;167424;302188;303083;349696;466348;303883;517120;;;;;;
21819,281;160544;1423;167936;303083;303356;349696;463627;304779;517632;;;;;;
21845,844;161679;4351;167424;303356;303898;349696;465035;308249;517120;;;;;;
21908,067;164607;5442;166400;303898;304692;349696;468505;310134;516096;;;;;;
21979,385;164162;3956;166912;304692;305727;349696;468854;309683;516608;;;;;;
22000,010;162676;704;167424;305727;306927;349696;468403;307631;517120;;;;;;
22076,105;160448;6245;166400;306927;307191;349696;467375;313436;516096;;;;;;
22094,334;165989;1233;166400;307191;308689;349696;473180;309922;516096;;;;;;
22129,260;158929;4820;166400;308689;309505;349696;467618;314325;516096;;;;;;
22146,752;162516;1023;166400;309505;310847;349696;472021;311870;516096;;;;;;
22153,639;158719;3268;166400;310847;311477;349696;469566;314745;516096;;;;;;
22173,595;160964;2304;167424;311477;312326;349696;472441;314630;517120;;;;;;
22185,700;161536;5800;166912;312326;313493;349696;473862;319293;516608;;;;;;
22210,434;165032;960;166912;313493;314620;349696;478525;315580;516608;;;;;;
22226,160;159680;3247;166912;314620;314949;349696;474300;318196;516608;;;;;;
22245,827;161967;7650;164352;314949;315763;349696;476916;323413;514048;;;;;;
22263,019;164322;1776;165888;315763;317101;349696;480085;318877;515584;;;;;;
22271,082;158448;3535;166400;317101;317925;349696;475549;321460;516096;;;;;;
22297,561;160719;2852;165888;317925;318552;349696;478644;321404;515584;;;;;;
22325,486;144791;576;166912;318552;319200;349696;463343;319776;516608;;;;;;
22325,497;576;0;166912;319200;273511;349696;319776;273511;516608;186198;181443;786432;505974;454954;1303040
22346,732;158720;3267;166912;273511;273512;349696;432231;276779;516608;;;;;;
22379,232;161987;2096;167424;273512;274423;349696;435499;276519;517120;;;;;;
22408,323;161840;3408;167424;274423;275224;349696;436263;278632;517120;;;;;;
22438,465;163152;3371;167936;275224;275609;349696;438376;278980;517632;;;;;;
22507,510;164139;5862;166912;275609;276515;349696;439748;282377;516608;;;;;;
22514,219;166630;2368;167936;276515;277379;349696;443145;279747;517632;;;;;;
22587,164;162624;5716;167424;277379;278431;349696;440003;284147;517120;;;;;;
22597,335;165972;2249;167424;278431;280095;349696;444403;282344;517120;;;;;;
22634,900;161993;3200;167424;280095;280726;349696;442088;283926;517120;;;;;;
22695,113;162944;2371;167936;280726;281679;349696;443670;284050;517632;;;;;;
22723,809;163139;2675;167936;281679;282337;349696;444818;285012;517632;;;;;;
22756,078;163443;864;167424;282337;283208;349696;445780;284072;517120;;;;;;
22926,514;161632;5365;166400;283208;283457;349696;444840;288822;516096;;;;;;
22946,238;166133;5599;166400;283457;284658;349696;449590;290257;516096;;;;;;
22962,725;164319;1260;166912;284658;285993;349696;448977;287253;516608;;;;;;
22975,604;159980;1186;167424;285993;286256;349696;445973;287442;517120;;;;;;
22992,020;160930;3027;167424;286256;286713;349696;447186;289740;517120;;;;;;
23040,892;162771;1008;167936;286713;287528;349696;449484;288536;517632;;;;;;
23163,330;161776;1904;167936;287528;287800;349696;449304;289704;517632;;;;;;
23394,380;162672;3300;168448;287800;288439;349696;450472;291739;518144;;;;;;
23441,491;164580;1346;167936;288439;289326;349696;453019;290672;517632;;;;;;
23463,763;162626;4632;167424;289326;289689;349696;451952;294321;517120;;;;;;
23485,357;165400;1760;167936;289689;290603;349696;455089;292363;517632;;;;;;
23589,861;162528;1104;168448;290603;291758;349696;453131;292862;518144;;;;;;
23626,313;162896;5715;167936;291758;292270;349696;454654;297985;517632;;;;;;
23660,166;167507;832;167936;292270;293459;349696;459777;294291;517632;;;;;;
23678,627;161600;640;167936;293459;293819;349696;455059;294459;517632;;;;;;
23687,648;161408;2899;167936;293819;294068;349696;455227;296967;517632;;;;;;
23697,666;163667;2208;167936;294068;294626;349696;457735;296834;517632;;;;;;
23753,908;162976;672;168448;294626;295522;349696;457602;296194;518144;;;;;;
23797,675;162464;4707;166912;295522;295715;349696;457986;300422;516608;;;;;;
23813,024;166499;5268;166912;295715;296817;349696;462214;302085;516608;;;;;;
23872,513;165012;2947;167424;296817;297774;349696;461829;300721;517120;;;;;;
23886,633;162691;1888;167936;297774;298630;349696;460465;300518;517632;;;;;;
23895,759;162656;768;167936;298630;299213;349696;461286;299981;517632;;;;;;
23907,207;161536;992;168448;299213;299469;349696;460749;300461;518144;;;;;;
23942,205;162784;5414;167424;299469;299853;349696;462253;305267;517120;;;;;;
24024,585;167206;800;167936;299853;301045;349696;467059;301845;517632;;;;;;
24272,425;161056;4303;167424;301045;301260;349696;462101;305563;517120;;;;;;
24290,922;164559;6100;166400;301260;302371;349696;465819;308471;516096;;;;;;
24318,602;164820;4546;166912;302371;303322;349696;467191;307868;516608;;;;;;
24321,712;163266;2412;166912;303322;304200;349696;466588;306612;516608;;;;;;
24345,022;161132;832;166912;304200;305575;349696;465332;306407;516608;;;;;;
24370,793;159552;3090;167424;305575;305936;349696;465127;309026;517120;;;;;;
24378,242;162322;816;166912;305936;308420;349696;468258;309236;516608;;;;;;
24383,683;160048;1320;167936;308420;308740;349696;468468;310060;517632;;;;;;
24412,665;161576;5272;167424;308740;309512;349696;470316;314784;517120;;;;;;
24447,732;165528;3286;167424;309512;310705;349696;475040;313991;517120;;;;;;
24496,179;163015;2161;167424;310705;311617;349696;473720;313778;517120;;;;;;
24543,090;161905;4922;166912;311617;312322;349696;473522;317244;516608;;;;;;
24604,886;164666;3441;167424;312322;313494;349696;476988;316935;517120;;;;;;
24629,173;163185;1152;167936;313494;314477;349696;476679;315629;517632;;;;;;
24647,994;161920;1840;167936;314477;314868;349696;476397;316708;517632;;;;;;
24662,928;162608;803;167936;314868;315687;349696;477476;316490;517632;;;;;;
24831,559;161571;4451;167936;315687;315918;349696;477258;320369;517632;;;;;;
24884,320;165219;544;167936;315918;317110;349696;481137;317654;517632;;;;;;
24960,249;161312;4534;165376;317110;317367;349696;478422;321901;515072;;;;;;
24985,744;165302;1104;167936;317367;318287;349696;482669;319391;517632;;;;;;
25053,731;161360;3107;167424;318287;318511;349696;479647;321618;517120;;;;;;
25070,323;163363;2771;168448;318511;319007;349696;481874;321778;518144;;;;;;
25081,229;164051;1133;167936;319007;319759;349696;483058;320892;517632;;;;;;
25092,584;162413;2655;168960;319759;320118;349696;482172;322773;518656;;;;;;
25148,138;164959;2899;168448;320118;320686;349696;485077;323585;518144;;;;;;
25171,929;165203;1632;169472;320686;321339;349696;485889;322971;519168;;;;;;
25236,965;164960;4742;168448;321339;321989;349696;486299;326731;518144;;;;;;
25281,996;168070;5177;167424;321989;323014;349696;490059;328191;517120;;;;;;
25288,948;165945;2927;167936;323014;324009;349696;488959;326936;517632;;;;;;
25313,299;163695;3556;168448;324009;324602;349696;487704;328158;518144;;;;;;
25335,420;165348;784;168448;324602;325432;349696;489950;326216;518144;;;;;;
25352,820;162576;1234;168448;325432;325648;349696;488008;326882;518144;;;;;;
25404,789;163026;2226;168448;325648;326096;349696;488674;328322;518144;;;;;;
25482,971;164018;6115;165888;326096;327050;349696;490114;333165;515584;;;;;;
25552,505;165859;2164;167424;327050;328248;349696;492909;330412;517120;;;;;;
25591,624;161908;1616;167936;328248;328391;349696;490156;330007;517632;;;;;;
25729,968;162384;5395;166400;328391;328816;349696;490775;334211;516096;;;;;;
25744,675;166163;1793;167936;328816;329930;349696;494979;331723;517632;;;;;;
25785,034;162049;4755;167424;329930;330611;349696;491979;335366;517120;;;;;;
25847,742;165011;2208;167936;330611;331791;349696;495622;333999;517632;;;;;;
25865,496;162381;3809;167424;331791;332620;349696;494172;336429;517120;;;;;;
25882,261;164065;5608;166912;332620;333335;349696;496685;338943;516608;;;;;;
25897,977;165352;640;167424;333335;334483;349696;498687;335123;517120;;;;;;
25919,957;160384;1666;167424;334483;334843;349696;494867;336509;517120;;;;;;
25926,274;54452;576;167424;334843;335443;349696;389295;336019;517120;;;;;;
25926,286;576;0;167424;335443;284617;349696;336019;284617;517120;185952;181762;786432;521971;466379;1303552
25968,673;159744;6915;165376;284617;284617;349696;444361;291532;515072;;;;;;
25988,777;164611;1268;166400;284617;285811;349696;449228;287079;516096;;;;;;
26005,697;158964;3124;166912;285811;286108;349696;444775;289232;516608;;;;;;
26019,867;161332;960;166400;286108;286683;349696;447440;287643;516096;;;;;;
26028,055;159168;1562;167424;286683;287163;349696;445851;288725;517120;;;;;;
26048,311;161306;3844;167424;287163;287491;349696;448469;291335;517120;;;;;;
26071,366;163588;3016;167936;287491;288115;349696;451079;291131;517632;;;;;;
26082,043;163226;4884;167424;288116;288833;349696;451342;293717;517120;;;;;;
26097,202;165140;1456;167936;288833;289480;349696;453973;290936;517632;;;;;;
26110,769;161712;2208;167424;289480;290080;349696;451192;292288;517120;;;;;;
26118,635;162464;672;167936;290080;290914;349696;452544;291586;517632;;;;;;
26125,355;161440;992;167936;290914;291146;349696;452354;292138;517632;;;;;;
26131,270;161760;2209;168448;291146;291482;349696;452906;293691;518144;;;;;;
26170,306;164001;2272;168448;291482;291967;349696;455483;294239;518144;;;;;;
26188,213;164063;5208;167936;291968;292679;349696;456031;297887;517632;;;;;;
26203,825;167000;5225;167424;292679;294184;349696;459679;299409;517120;;;;;;
26208,413;167017;5269;166912;294184;294847;349696;461201;300116;516608;;;;;;
26225,886;165013;3966;167424;294847;295471;349696;459860;299437;517120;;;;;;
26237,471;163710;2592;167936;295471;296095;349696;459181;298687;517632;;;;;;
26259,958;162848;7143;163328;296095;299181;349696;458943;306324;513024;;;;;;
26278,477;163303;4761;164352;299181;300821;349696;462484;305582;514048;;;;;;
26296,504;161433;1760;165888;300821;301764;349696;462254;303524;515584;;;;;;
26305,286;158432;3125;166400;301764;302549;349696;460196;305674;516096;;;;;;
26320,164;160309;1503;165888;302549;303140;349696;462858;304643;515584;;;;;;
26328,980;158687;1232;166400;303140;303980;349696;461827;305212;516096;;;;;;
26342,651;158928;4664;166400;303980;304564;349696;462908;309228;516096;;;;;;
26350,852;162360;1184;166400;304564;305436;349696;466924;306620;516096;;;;;;
26358,178;158880;2576;166400;305436;305884;349696;464316;308460;516096;;;;;;
26369,280;160272;1632;167424;305884;306910;349696;466156;308542;517120;;;;;;
26390,991;160864;2528;166912;306910;307310;349696;467774;309838;516608;;;;;;
26408,371;161760;1926;167936;307310;308576;349696;469070;310502;517632;;;;;;
26421,558;162182;2241;167424;308576;309152;349696;470758;311393;517120;;;;;;
26471,315;162497;5384;166400;309152;309824;349696;471649;315208;516096;;;;;;
26490,648;165128;3926;167424;309824;311014;349696;474952;314940;517120;;;;;;
26506,339;163670;1506;167936;311014;311717;349696;474684;313223;517632;;;;;;
26531,464;162274;1124;167936;311717;312125;349696;473991;313249;517632;;;;;;
26566,555;161892;3467;167936;312125;312301;349696;474017;315768;517632;;;;;;
26607,319;164235;4347;167936;312301;313205;349696;476536;317552;517632;;;;;;
26730,700;165115;5430;166912;313205;314222;349696;478320;319652;516608;;;;;;
26753,899;165174;1088;167424;314222;315602;349696;479396;316690;517120;;;;;;
26788,266;160832;560;167424;315602;316098;349696;476434;316658;517120;;;;;;
26848,865;160304;2575;167424;316098;316218;349696;476402;318793;517120;;;;;;
26892,663;162319;3496;167936;316218;317167;349696;478537;320663;517632;;;;;;
26990,134;164264;5672;166912;317167;317727;349696;481431;323399;516608;;;;;;
27109,713;166440;3395;167936;317727;318727;349696;484167;322122;517632;;;;;;
27218,275;163599;3898;167424;318727;319410;349696;482326;323308;517120;;;;;;
27282,581;164154;6020;166912;319410;320442;349696;483564;326462;516608;;;;;;
27294,712;165764;2160;167424;320442;322208;349696;486206;324368;517120;;;;;;
27299,497;161904;3136;167936;322208;323489;349696;484112;326625;517632;;;;;;
27312,130;163392;5894;167424;323489;326446;349696;486881;332340;517120;;;;;;
27318,445;166150;4510;167424;326446;328179;349696;492596;332689;517120;;;;;;
27339,128;164254;896;160768;328179;329045;349696;492433;329941;510464;;;;;;
27355,661;160640;1088;167424;329045;329390;349696;489685;330478;517120;;;;;;
27363,384;160320;608;166912;329390;329845;349696;489710;330453;516608;;;;;;
27425,566;159840;5836;165376;329845;330182;349696;489685;336018;515072;;;;;;
27441,243;163532;1261;166400;330182;331176;349696;493714;332437;516096;;;;;;
27452,040;158957;3459;166912;331176;331464;349696;490133;334923;516608;;;;;;
27468,657;162179;1997;166912;331464;332353;349696;493643;334350;516608;;;;;;
27481,971;160717;6229;165376;332353;333475;349696;493070;339704;515072;;;;;;
27495,729;163925;4283;166400;333475;334537;349696;497400;338820;516096;;;;;;
27506,602;161979;1533;166912;334537;335415;349696;496516;336948;516608;;;;;;
27520,329;160253;1952;166912;335415;335902;349696;495668;337854;516608;;;;;;
27532,033;160672;800;167424;335902;336488;349696;496574;337288;517120;;;;;;
27568,181;160544;896;167424;336488;336865;349696;497032;337761;517120;;;;;;
27606,052;160640;3312;167424;336865;337234;349696;497505;340546;517120;;;;;;
27618,443;163056;3863;167424;337234;337827;349696;500290;341690;517120;;;;;;
27645,685;163607;928;167936;337827;338793;349696;501434;339721;517632;;;;;;
27710,938;161184;1984;167424;338793;338897;349696;499977;340881;517120;;;;;;
27807,488;162240;1360;168448;338897;339568;349696;501137;340928;518144;;;;;;
27840,988;162640;4776;167936;339568;340063;349696;502208;344839;517632;;;;;;
27898,277;166056;3171;167936;340063;340207;349696;506119;343378;517632;;;;;;
27912,398;163939;1635;167936;340207;340783;349696;504146;342418;517632;;;;;;
27933,704;162403;2241;168448;340783;341374;349696;503186;343615;518144;;;;;;
27953,667;164033;2769;168448;341374;341470;349696;505407;344239;518144;;;;;;
28013,038;164561;1424;168960;341470;341550;349696;506031;342974;518656;;;;;;
28077,883;164240;6124;168960;341550;343622;349696;505790;349746;518656;;;;;;
28107,723;168940;2996;166912;343622;345011;349696;512562;348007;516608;;;;;;
28118,968;163764;2959;167936;345011;345682;349696;508775;348641;517632;;;;;;
28136,503;163727;1520;168448;345682;346529;349696;509409;348049;518144;;;;;;
28153,292;162800;6629;167936;346529;346923;349696;509329;353552;517632;;;;;;
28174,840;167909;3811;166912;346923;347946;349696;514832;351757;516608;;;;;;
28174,854;3811;0;166912;347946;299104;430592;351757;299104;597504;187242;182049;786432;538999;481153;1383936
28230,274;159744;3200;167424;299104;299104;430592;458848;302304;598016;;;;;;
28246,801;162944;3110;167936;299104;300778;430592;462048;303888;598528;;;;;;
28351,071;163878;4632;167936;300778;301618;430592;464656;306250;598528;;;;;;
28377,996;165400;740;167936;301618;302786;430592;467018;303526;598528;;;;;;
28408,486;161508;3828;167936;302786;302874;430592;464294;306702;598528;;;;;;
28433,324;164596;3700;167936;302874;303883;430592;467470;307583;598528;;;;;;
28452,608;105443;6095;166912;303882;304690;430592;409325;310785;597504;;;;;;
28452,617;6095;0;166912;304690;300992;430592;310785;300992;597504;182412;181742;786432;493197;482734;1383936
28470,137;160768;1310;167424;300992;300992;430592;461760;302302;598016;;;;;;
28538,019;161054;2372;167424;300992;301662;430592;462046;304034;598016;;;;;;
28596,691;162116;5283;166912;301662;302310;430592;463778;307593;597504;;;;;;
28611,334;165027;2640;167424;302310;303417;430592;467337;306057;598016;;;;;;
28627,942;162384;993;167424;303417;304265;430592;465801;305258;598016;;;;;;
28768,268;160737;2985;167424;304265;304577;430592;465002;307562;598016;;;;;;
28800,808;162729;3133;168448;304577;305707;430592;467306;308840;599040;;;;;;
28807,960;164413;5788;167936;305707;306171;430592;470120;311959;598528;;;;;;
28819,247;167068;1376;167936;306171;307470;430592;473239;308846;598528;;;;;;
28841,680;162144;6594;167424;307470;308030;430592;469614;314624;598016;;;;;;
28853,473;167362;2694;166400;308030;309469;430592;475392;312163;596992;;;;;;
28881,433;161414;4356;166912;309469;310457;430592;470883;314813;597504;;;;;;
28905,263;163076;1404;167424;310457;311273;430592;473533;312677;598016;;;;;;
28919,509;161148;2656;167424;311273;311656;430592;472421;314312;598016;;;;;;
28948,497;162400;1592;167936;311656;312505;430592;474056;314097;598528;;;;;;
29002,672;161848;2230;167424;312505;313035;430592;474353;315265;598016;;;;;;
29073,971;162486;5516;166912;313035;313815;430592;475521;319331;597504;;;;;;
29104,501;165260;3848;167424;313815;314878;430592;479075;318726;598016;;;;;;
29124,974;163592;3043;167936;314878;315678;430592;478470;318721;598528;;;;;;
29139,784;163299;1024;167424;315678;316517;430592;478977;317541;598016;;;;;;
29154,817;161280;928;167936;316517;316885;430592;477797;317813;598528;;;;;;
29164,722;161696;1096;167936;316885;317125;430592;478581;318221;598528;;;;;;
29175,200;161864;2416;168448;317125;317342;430592;478989;319758;599040;;;;;;
29182,820;163696;3408;167936;317342;317781;430592;481038;321189;598528;;;;;;
29265,994;164688;3421;168448;317781;318645;430592;482469;322066;599040;;;;;;
29308,792;165213;3780;168448;318645;319620;430592;483858;323400;599040;;;;;;
29320,275;165572;3448;168960;319620;320332;430592;485192;323780;599552;;;;;;
29342,033;165752;2102;168448;320332;320944;430592;486084;323046;599040;;;;;;
29351,210;164406;3588;168960;320944;321490;430592;485350;325078;599552;;;;;;
29357,554;166404;6129;168960;321490;322775;430592;487894;328904;599552;;;;;;
29376,329;168945;912;165888;322775;324787;430592;491720;325699;596480;;;;;;
29403,484;160656;3776;167424;324787;325026;430592;485443;328802;598016;;;;;;
29408,915;163520;1394;167936;325026;326026;430592;488546;327420;598528;;;;;;
29436,833;162162;3123;167936;326026;326402;430592;488188;329525;598528;;;;;;
29444,129;163891;1475;168448;326402;327578;430592;490293;329053;599040;;;;;;
29460,716;162699;6628;167936;327577;329449;430592;490276;336077;598528;;;;;;
29486,959;74716;6567;164352;329449;331910;430592;404165;338477;594944;;;;;;
29486,971;6567;0;164352;331910;306708;430592;338477;306708;594944;183597;181685;786432;522074;488393;1381376
29586,227;157184;4309;166400;306708;306708;430592;463892;311017;596992;;;;;;
29688,030;161493;2756;166400;306708;307740;430592;468201;310496;596992;;;;;;
29700,660;160452;2719;166400;307740;308268;430592;468192;310987;596992;;;;;;
29724,166;160415;2561;166912;308268;309068;430592;468683;311629;597504;;;;;;
29736,412;161281;4544;166912;309068;309524;430592;470349;314068;597504;;;;;;
29743,124;163264;1872;167424;309524;310145;430592;472788;312017;598016;;;;;;
29761,604;161104;2868;166912;310145;310792;430592;471249;313660;597504;;;;;;
29785,580;162100;2548;167936;310792;311328;430592;472892;313876;598528;;;;;;
29799,325;162804;3296;167424;311328;311912;430592;474132;315208;598016;;;;;;
29878,558;163552;3204;168448;311912;312473;430592;475464;315677;599040;;;;;;
29889,496;164484;640;167936;312473;313335;430592;476957;313975;598528;;;;;;
29913,903;161920;4140;168448;313335;313504;430592;475255;317644;599040;;;;;;
30046,898;165932;5560;167424;313504;314427;430592;479436;319987;598016;;;;;;
30101,823;167352;4094;167936;314427;315551;430592;481779;319645;598528;;;;;;
30125,610;164862;6430;167424;315551;316385;430592;480413;322815;598016;;;;;;
30144,004;167198;4052;167424;316385;317265;430592;483583;321317;598016;;;;;;
30150,410;163796;2297;167424;317265;318281;430592;481061;320578;598016;;;;;;
30169,100;162041;3328;167936;318281;318612;430592;480322;321940;598528;;;;;;
30173,547;163584;960;167424;318612;319575;430592;482196;320535;598016;;;;;;
30177,713;161216;2911;167936;319575;319894;430592;480791;322805;598528;;;;;;
30196,933;163679;1263;167936;319894;320518;430592;483573;321781;598528;;;;;;
30203,783;162031;5016;167936;320518;320966;430592;482549;325982;598528;;;;;;
30211,052;165784;4820;165888;320966;321566;430592;486750;326386;596480;;;;;;
30217,067;165588;3175;167936;321566;322965;430592;487154;326140;598528;;;;;;
30228,706;163431;1971;167424;322965;323725;430592;486396;325696;598016;;;;;;
30246,865;162227;3235;168448;323725;324521;430592;485952;327756;599040;;;;;;
30261,165;164515;1824;167936;324521;325288;430592;489036;327112;598528;;;;;;
30286,536;163104;1152;168448;325288;325768;430592;488392;326920;599040;;;;;;
30294,129;162944;1184;168448;325768;326224;430592;488712;327408;599040;;;;;;
30321,226;162976;1459;168448;326224;326465;430592;489200;327924;599040;;;;;;
30360,404;163251;4180;168448;326465;326736;430592;489716;330916;599040;;;;;;
30372,451;165972;1536;168448;326736;327737;430592;492708;329273;599040;;;;;;
30396,006;163328;5149;167424;327737;328619;430592;491065;333768;598016;;;;;;
30411,300;166941;3440;167936;328619;329825;430592;495560;333265;598528;;;;;;
30460,962;164208;752;167936;329825;330601;430592;494033;331353;598528;;;;;;
30478,520;161520;2240;168448;330601;330754;430592;492121;332994;599040;;;;;;
30537,521;163520;6655;167936;330754;331771;430592;494274;338426;598528;;;;;;
30584,249;167608;3496;166912;331771;333039;430592;499379;336535;597504;;;;;;
30629,159;163240;5549;165376;333039;333712;430592;496279;339261;595968;;;;;;
30654,150;165293;1712;166912;333712;334954;430592;499005;336666;597504;;;;;;
30710,143;160432;6086;164864;334954;335506;430592;495386;341592;595456;;;;;;
30733,737;164806;608;166400;335506;336620;430592;500312;337228;596992;;;;;;
30760,480;158304;6536;164352;336620;336869;430592;494924;343405;594944;;;;;;
30778,263;164232;832;165888;336869;338035;430592;501101;338867;596480;;;;;;
30786,156;157504;3023;165888;338035;338412;430592;495539;341435;596480;;;;;;
30793,885;159695;4222;166400;338412;338963;430592;498107;343185;596992;;;;;;
30818,497;161918;2387;166400;338963;340326;430592;500881;342713;596992;;;;;;
30862,209;160083;6030;165888;340326;341899;430592;500409;347929;596480;;;;;;
30869,830;163726;6432;164352;341899;343121;430592;505625;349553;594944;;;;;;
30883,661;164128;2916;165888;343121;344452;430592;507249;347368;596480;;;;;;
30897,463;159588;4419;165888;344452;344844;430592;504040;349263;596480;;;;;;
30911,446;161091;2206;166400;344844;345381;430592;505935;347587;596992;;;;;;
30916,244;159902;2831;166400;345381;345853;430592;505283;348684;596992;;;;;;
30920,201;160527;1744;166912;345853;346532;430592;506380;348276;597504;;;;;;
30930,247;160464;6251;165376;346532;347225;430592;506996;353476;595968;;;;;;
30938,829;164971;928;166400;347225;348792;430592;512196;349720;596992;;;;;;
30948,781;158624;2848;166400;348792;349112;430592;507416;351960;596992;;;;;;
30968,336;160544;832;166912;349112;350017;430592;509656;350849;597504;;;;;;
30975,002;159552;2176;166912;350017;350513;430592;509569;352689;597504;;;;;;
30982,897;160896;3565;167424;350513;350882;430592;511409;354447;598016;;;;;;
30992,658;163309;6826;166912;350882;351820;430592;514191;358646;597504;;;;;;
31002,364;166570;2925;166912;351820;353015;430592;518390;355940;597504;;;;;;
31016,014;161645;3126;166912;353015;353407;430592;514660;356533;597504;;;;;;
31031,414;161846;2224;167424;353407;354198;430592;515253;356422;598016;;;;;;
31037,752;161968;1328;167424;354198;354868;430592;516166;356196;598016;;;;;;
31046,277;161072;2112;167936;354868;355244;430592;515940;357356;598528;;;;;;
31050,736;162368;7145;167424;355244;356191;430592;517612;363336;598016;;;;;;
31060,666;167401;3216;166400;356191;358754;430592;523592;361970;596992;;;;;;
31076,612;161936;2448;166912;358754;359554;430592;520690;362002;597504;;;;;;
31096,148;161168;4227;167424;359554;360154;430592;520722;364381;598016;;;;;;
31105,731;163459;5472;166912;360154;360884;430592;523613;366356;597504;;;;;;
31129,076;164704;4158;166912;360884;361500;430592;525588;365658;597504;;;;;;
31139,470;162878;3280;166912;361500;362614;430592;524378;365894;597504;;;;;;
31153,610;162000;3357;167936;362614;363106;430592;524614;366463;598528;;;;;;
31161,103;163613;1232;167424;363106;363812;430592;526719;365044;598016;;;;;;
31176,087;161488;3741;167936;363812;364260;430592;525300;368001;598528;;;;;;
31182,237;164509;2688;167936;364260;364812;430592;528769;367500;598528;;;;;;
31188,209;163456;1024;167936;364812;365811;430592;528268;366835;598528;;;;;;
31199,746;161792;1952;167936;365811;366155;430592;527603;368107;598528;;;;;;
31215,140;162720;914;168448;366155;367013;430592;528875;367927;599040;;;;;;
31224,140;162706;1408;168448;367013;367260;430592;529719;368668;599040;;;;;;
31244,546;163200;5313;167424;367260;368029;430592;530460;373342;598016;;;;;;
31259,626;166081;3771;167936;368029;369234;430592;534110;373005;598528;;;;;;
31271,611;164539;3379;167936;369234;370045;430592;533773;373424;598528;;;;;;
31278,669;164147;2960;167936;370045;370709;430592;534192;373669;598528;;;;;;
31281,006;163728;3491;168448;370709;371405;430592;534437;374896;599040;;;;;;
31287,613;165283;6128;167936;371405;372277;430592;536688;378405;598528;;;;;;
31311,131;167920;2863;167936;372277;373616;430592;540197;376479;598528;;;;;;
31322,493;163631;3811;167936;373616;374000;430592;537247;377811;598528;;;;;;
31358,686;164579;4127;168448;374000;374840;430592;538579;378967;599040;;;;;;
31384,981;165919;928;168448;374840;375959;430592;540759;376887;599040;;;;;;
31388,679;162720;3452;168448;375959;376368;430592;538679;379820;599040;;;;;;
31409,783;165244;1781;168448;376368;376959;430592;541612;378740;599040;;;;;;
31446,553;163573;6018;167424;376959;377447;430592;540532;383465;598016;;;;;;
31462,561;166786;4083;167936;377447;378389;430592;544233;382472;598528;;;;;;
31473,549;164851;6344;165888;378389;379156;430592;543240;385500;596480;;;;;;
31482,310;165064;5637;166912;379156;380346;430592;544220;385983;597504;;;;;;
31493,275;164278;1424;166912;380345;381953;430592;544623;383377;597504;;;;;;
31523,622;160144;3665;166912;381953;382617;430592;542097;386282;597504;;;;;;
31530,229;162385;4180;167424;382617;383049;430592;545002;387229;598016;;;;;;
31539,670;163924;6598;166400;383049;383929;430592;546973;390527;596992;;;;;;
31563,523;166342;832;165888;383929;385001;430592;550271;385833;596480;;;;;;
31580,650;158528;3088;166400;385001;385250;430592;543529;388338;596992;;;;;;
31604,438;160784;2160;166912;385250;385890;430592;546034;388050;597504;;;;;;
31644,046;160880;6855;165888;385890;386503;430592;546770;393358;596480;;;;;;
31652,735;165575;5577;166400;386503;387840;430592;552078;393417;596992;;;;;;
31663,434;163273;2513;166400;387840;389432;430592;551113;391945;596992;;;;;;
31666,515;160209;1058;166400;389432;390504;430592;549641;391562;596992;;;;;;
31680,480;158754;960;166400;390504;390744;430592;549258;391704;596992;;;;;;
31705,815;158656;914;166400;390744;391142;430592;549400;392056;596992;;;;;;
31734,763;158610;2495;166400;391142;391318;430592;549752;393813;596992;;;;;;
31740,320;160191;848;166912;391318;392134;430592;551509;392982;597504;;;;;;
31746,567;159568;1280;166912;392134;392366;430592;551702;393646;597504;;;;;;
31823,371;160000;3253;167424;392366;393146;430592;552366;396399;598016;;;;;;
31840,079;162997;1799;167424;393146;394222;430592;556143;396021;598016;;;;;;
31852,122;161543;4825;166912;394222;394454;430592;555765;399279;597504;;;;;;
31888,245;164569;4116;167424;394454;395788;430592;559023;399904;598016;;;;;;
31943,866;163860;1184;167424;395788;397271;430592;559648;398455;598016;;;;;;
31969,134;160928;1185;167424;397271;397791;430592;558199;398976;598016;;;;;;
31984,094;160929;5156;166912;397791;398224;430592;558720;403380;597504;;;;;;
32001,065;164900;3028;167424;398224;399562;430592;563124;402590;598016;;;;;;
32015,235;162772;1504;167936;399562;400674;430592;562334;402178;598528;;;;;;
32022,206;162139;6301;167424;400674;401074;430592;562813;407375;598016;;;;;;
32027,197;167068;7678;164352;401074;403958;430592;568142;411636;594944;;;;;;
32043,180;164350;5399;162304;403958;405276;430592;568308;410675;592896;;;;;;
32072,976;162071;1634;164864;405276;406872;430592;567347;408506;595456;;;;;;
32091,240;156258;1136;164864;406872;407239;430592;563130;408375;595456;;;;;;
32118,779;155760;3764;165888;407239;407609;430592;562999;411373;596480;;;;;;
32130,993;159924;2679;165376;407609;408461;430592;567533;411140;595968;;;;;;
32152,930;158839;1268;166400;408461;409191;430592;567300;410459;596992;;;;;;
32257,926;158424;4298;165888;409190;409527;430592;567614;413825;596480;;;;;;
32270,614;161482;7204;164352;409527;410448;430592;571009;417652;594944;;;;;;
32294,861;162852;2645;165376;410448;411439;430592;573300;414084;595968;;;;;;
32485,916;158293;3412;166400;411439;412194;430592;569732;415606;596992;;;;;;
32504,434;160596;2997;165888;412194;413179;430592;572790;416176;596480;;;;;;
32546,931;160181;5778;165888;413179;413730;430592;573360;419508;596480;;;;;;
32564,359;163474;3125;166400;413730;414722;430592;577204;417847;596992;;;;;;
32585,165;160821;960;166912;414722;415393;430592;575543;416353;597504;;;;;;
32633,978;159680;5794;164864;415393;415625;430592;575073;421419;595456;;;;;;
32699,905;164514;800;166400;415625;416770;430592;580139;417570;596992;;;;;;
32704,341;158496;3785;166400;416770;417123;430592;575266;420908;596992;;;;;;
32709,683;161481;1056;166912;417123;418129;430592;578604;419185;597504;;;;;;
32713,611;159776;8169;162816;418129;425309;430592;577905;433478;593408;;;;;;
32752,258;162793;6923;158720;425309;426786;430592;588102;433709;589312;;;;;;
32776,756;157451;3268;162816;426786;428479;430592;584237;431747;593408;;;;;;
32776,779;3268;0;162816;428479;332691;463360;431747;332691;626176;190737;182761;786432;622484;515452;1412608
32833,080;150528;1384;163328;332691;332691;463360;483219;334075;626688;;;;;;
32867,702;152936;4916;163328;332691;333036;463360;485627;337952;626688;;;;;;
32891,799;156468;1107;163840;333036;334066;463360;489504;335173;627200;;;;;;
32936,616;153683;5320;163840;334066;334250;463360;487749;339570;627200;;;;;;
32952,275;157896;1115;164352;334250;335529;463360;492146;336644;627712;;;;;;
32987,887;154715;2708;164352;335529;336025;463360;490244;338733;627712;;;;;;
33041,871;156308;2879;165376;336025;336441;463360;492333;339320;628736;;;;;;
33109,984;158015;3756;164864;336441;336946;463360;494456;340702;628224;;;;;;
33124,686;158892;864;165888;336946;337761;463360;495838;338625;629248;;;;;;
33238,694;157536;5979;162816;337761;337992;463360;495297;343971;626176;;;;;;
33278,574;162651;544;165376;337992;339066;463360;500643;339610;628736;;;;;;
33388,276;156192;4808;165376;339066;339331;463360;495258;344139;628736;;;;;;
33429,539;160456;1056;165888;339331;340562;463360;499787;341618;629248;;;;;;
33451,204;157216;3635;165376;340562;341003;463360;497778;344638;628736;;;;;;
33465,698;159795;3078;166912;341003;341818;463360;500798;344896;630272;;;;;;
33480,766;161286;1072;166400;341818;342610;463360;503104;343682;629760;;;;;;
33506,443;159280;4637;166912;342610;343106;463360;501890;347743;630272;;;;;;
33523,267;163357;2785;166912;343106;344035;463360;506463;346820;630272;;;;;;
33533,858;161505;1136;167424;344035;344355;463360;505540;345491;630784;;;;;;
33543,508;160368;1260;166912;344355;344763;463360;504723;346023;630272;;;;;;
33558,953;160492;2304;167936;344763;345106;463360;505255;347410;631296;;;;;;
33574,608;162560;3500;167424;345106;345812;463360;507666;349312;630784;;;;;;
33622,874;163756;4086;167936;345812;346523;463360;509568;350609;631296;;;;;;
33644,539;164854;1219;167936;346523;347206;463360;511377;348425;631296;;;;;;
33659,421;161987;1332;167936;347206;347806;463360;509193;349138;631296;;;;;;
33692,698;162100;3444;167936;347806;348102;463360;509906;351546;631296;;;;;;
33737,950;164212;4157;167424;348102;348902;463360;512314;353059;630784;;;;;;
33760,561;164925;1271;167936;348902;349318;463360;513827;350589;631296;;;;;;
33774,265;162039;1190;168448;349318;349510;463360;511357;350700;631808;;;;;;
33809,425;162982;3844;168448;349510;349838;463360;512492;353682;631808;;;;;;
33856,478;165636;3452;168448;349838;350342;463360;515474;353794;631808;;;;;;
33874,420;165244;1442;168448;350342;351158;463360;515586;352600;631808;;;;;;
33888,976;163234;960;168448;351158;351430;463360;514392;352390;631808;;;;;;
33907,369;162752;3888;168448;351430;351671;463360;514182;355559;631808;;;;;;
33914,255;165680;1969;168960;351671;352982;463360;517351;354951;632320;;;;;;
33919,802;164273;1249;168448;352982;353246;463360;517255;354495;631808;;;;;;
33928,415;163553;2336;169472;353246;353678;463360;516799;356014;632832;;;;;;
33952,634;165664;1056;168960;353678;355186;463360;519342;356242;632320;;;;;;
33984,333;164384;4467;168448;355186;355530;463360;519570;359997;631808;;;;;;
34023,557;167283;896;168960;355530;356913;463360;522813;357809;632320;;;;;;
34070,831;163712;1024;168960;356913;357249;463360;520625;358273;632320;;;;;;
34146,949;163840;2128;168960;357249;357441;463360;521089;359569;632320;;;;;;
34215,072;164944;4398;168448;357441;358173;463360;522385;362571;631808;;;;;;
34225,053;167214;1184;168960;358173;359140;463360;525387;360324;632320;;;;;;
34241,106;164000;800;168960;359140;359452;463360;523140;360252;632320;;;;;;
34250,697;163616;2337;168960;359452;359612;463360;523068;361949;632320;;;;;;
34273,485;165153;1647;169472;359612;360540;463360;524765;362187;632832;;;;;;
34332,127;165487;832;169472;360540;360676;463360;526027;361508;632832;;;;;;
34418,200;164672;3396;168960;360676;360805;463360;525348;364201;632320;;;;;;
34658,575;167236;1182;169472;360805;361461;463360;528041;362643;632832;;;;;;
34677,003;165022;5614;167424;361461;362207;463360;526483;367821;630784;;;;;;
34705,048;167406;1344;168448;362207;363512;463360;529613;364856;631808;;;;;;
34745,547;163136;2388;168960;363512;363859;463360;526648;366247;632320;;;;;;
34761,877;164692;2389;168448;363859;364539;463360;528551;366928;631808;;;;;;
34780,650;164693;1216;169472;364539;365336;463360;529232;366552;632832;;;;;;
34806,563;165056;2304;169472;365336;365676;463360;530392;367980;632832;;;;;;
34826,303;166144;3268;168960;365676;366404;463360;531820;369672;632320;;;;;;
34858,020;167108;928;169472;366404;367396;463360;533512;368324;632832;;;;;;
34915,072;164579;2696;169984;367396;367757;463360;531975;370453;633344;;;;;;
34941,598;167048;2836;169472;367757;368430;463360;534805;371266;632832;;;;;;
34955,913;167188;2080;169984;368430;369119;463360;535618;371199;633344;;;;;;
34980,325;166944;976;169984;369119;369901;463360;536063;370877;633344;;;;;;
34989,394;165840;2048;170496;369901;370309;463360;535741;372357;633856;;;;;;
35026,821;167424;3013;169984;370309;370901;463360;537733;373914;633344;;;;;;
35056,271;168389;1440;170496;370901;371541;463360;539290;372981;633856;;;;;;
35114,381;167328;3173;169472;371541;372214;463360;538869;375387;632832;;;;;;
35124,966;169061;5096;167936;372214;373820;463360;541275;378916;631296;;;;;;
35181,357;167912;3236;168960;373820;375005;463360;541732;378241;632320;;;;;;
35196,546;166052;1308;168960;375005;375806;463360;541057;377114;632320;;;;;;
35223,654;164124;992;168960;375806;376245;463360;539930;377237;632320;;;;;;
35242,425;163808;3076;168960;376245;376597;463360;540053;379673;632320;;;;;;
35254,070;165892;1024;168960;376597;377173;463360;542489;378197;632320;;;;;;
35263,582;163840;1904;169472;377173;377709;463360;541013;379613;632832;;;;;;
35274,059;165744;807;169472;377709;378539;463360;543453;379346;632832;;;;;;
35305,570;164647;5608;166400;378539;380440;463360;543186;386048;629760;;;;;;
35314,876;166376;1024;167936;380440;381599;463360;546816;382623;631296;;;;;;
35322,404;161742;1073;168448;381600;382088;463360;543342;383161;631808;;;;;;
35332,129;162353;2868;167936;382088;382503;463360;544441;385371;631296;;;;;;
35422,248;164148;2598;168960;382503;383182;463360;546651;385780;632320;;;;;;
35438,095;164902;640;168448;383182;383896;463360;548084;384536;631808;;;;;;
35503,308;162944;752;168960;383896;384136;463360;546840;384888;632320;;;;;;
35537,608;163568;3278;168960;384136;384425;463360;547704;387703;632320;;;;;;
35564,972;166094;5615;166912;384425;385487;463360;550519;391102;630272;;;;;;
35582,528;166383;1056;167936;385487;387092;463360;551870;388148;631296;;;;;;
35604,191;161771;4403;167936;387093;387941;463360;548864;392344;631296;;;;;;
35654,147;165171;2868;167936;387941;389724;463360;553112;392592;631296;;;;;;
35693,611;163636;2018;168448;389724;390488;463360;553360;392506;631808;;;;;;
35705,563;163810;992;168448;390488;390808;463360;554298;391800;631808;;;;;;
35728,794;162784;1477;168960;390808;391064;463360;553592;392541;632320;;;;;;
35754,390;163781;3500;168448;391064;391560;463360;554845;395060;631808;;;;;;
35848,213;165804;897;168960;391560;392376;463360;557364;393273;632320;;;;;;
35867,534;163713;1375;168960;392376;392705;463360;556089;394080;632320;;;;;;
35880,991;164191;768;168960;392705;392976;463360;556896;393744;632320;;;;;;
35939,650;163584;1293;168960;392976;393136;463360;556560;394429;632320;;;;;;
35959,894;164109;1744;169984;393136;393553;463360;557245;395297;633344;;;;;;
36016,917;166096;976;169472;393553;394034;463360;559649;395010;632832;;;;;;
36040,488;165328;1089;169984;394034;394411;463360;559362;395500;633344;;;;;;
36070,855;165953;4689;169984;394411;394642;463360;560364;399331;633344;;;;;;
36110,696;169553;1120;168960;394642;395858;463360;564195;396978;632320;;;;;;
36117,156;164960;992;169472;395858;396234;463360;560818;397226;632832;;;;;;
36126,329;164832;1558;169984;396234;396466;463360;561066;398024;633344;;;;;;
36159,389;165648;3568;169472;396466;396650;463360;562114;400218;632832;;;;;;
36171,567;167920;1318;169984;396650;397578;463360;564570;398896;633344;;;;;;
36175,829;165670;1184;169472;397578;397722;463360;563248;398906;632832;;;;;;
36207,941;165536;3110;169984;397722;398026;463360;563258;401136;633344;;;;;;
36229,621;167974;1310;169984;398026;398723;463360;566000;400033;633344;;;;;;
36254,971;166174;2451;169984;398885;399579;463360;565059;402030;633344;;;;;;
36270,067;167315;2599;169984;399583;400138;463360;566898;402737;633344;;;;;;
36288,224;167463;3917;168960;400138;400497;463360;567601;404414;632320;;;;;;
36313,135;167757;1280;169472;400497;401368;463360;568254;402648;632832;;;;;;
36350,786;165120;1216;169984;401368;402105;463360;566488;403321;633344;;;;;;
36377,683;78738;512;169984;402104;402496;463360;480842;403008;633344;;;;;;
36377,701;512;0;169984;402496;322118;463360;403008;322118;633344;186617;182017;786432;589625;504135;1419776
36423,114;164864;2932;169984;322118;322118;463360;486982;325050;633344;;;;;;
36456,966;167796;3092;169984;322118;322550;463360;489914;325642;633344;;;;;;
36464,802;167956;2146;169984;322550;323287;463360;490506;325433;633344;;;;;;
36484,655;167010;3200;169984;323287;323998;463360;490297;327198;633344;;;;;;
36503,099;168064;2900;169984;323998;324582;463360;492062;327482;633344;;;;;;
36528,915;167764;2388;169984;324582;325110;463360;492346;327498;633344;;;;;;
36546,096;167252;2086;170496;325110;325526;463360;492362;327612;633856;;;;;;
36549,943;167462;1344;169984;325526;326362;463360;492988;327706;633344;;;;;;
36557,445;166720;3155;170496;326362;326602;463360;493082;329757;633856;;;;;;
36568,234;169043;1356;170496;326602;327682;463360;495645;329038;633856;;;;;;
36574,502;167244;1120;170496;327682;328009;463360;494926;329129;633856;;;;;;
36593,407;167008;1312;170496;328009;328565;463360;495017;329877;633856;;;;;;
36610,022;167200;4559;169472;328565;329570;463360;495765;334129;632832;;;;;;
36644,855;169423;3167;169984;329570;330562;463360;498993;333729;633344;;;;;;
36665,338;168031;1184;169984;330562;331434;463360;498593;332618;633344;;;;;;
36688,852;165963;4508;169472;331434;331890;463360;497397;336398;632832;;;;;;
36704,284;169372;2900;169472;331890;333082;463360;501262;335982;632832;;;;;;
36734,493;166740;3087;169472;333082;333738;463360;499822;336825;632832;;;;;;
36748,443;166927;1163;169472;333738;334618;463360;500665;335781;632832;;;;;;
36766,368;165003;5076;168960;334618;335066;463360;499621;340142;632320;;;;;;
36794,155;168916;6132;165888;335066;336634;463360;503982;342766;629248;;;;;;
36832,235;165876;1297;167424;336634;337482;463360;502510;338779;630784;;;;;;
36850,496;161041;5691;166400;337482;337810;463360;498523;343501;629760;;;;;;
36859,942;164411;1024;166912;337810;338724;463360;502221;339748;630272;;;;;;
36907,087;159744;800;166912;338724;339252;463360;498468;340052;630272;;;;;;
36966,850;159520;6040;164864;339252;339637;463360;498772;345677;628224;;;;;;
37021,664;164760;880;166400;339637;340768;463360;504397;341648;629760;;;;;;
37080,201;158576;2163;166400;340768;341200;463360;499344;343363;629760;;;;;;
37087,380;159859;896;166912;341200;341465;463360;501059;342361;630272;;;;;;
37109,859;159616;3731;166912;341465;341640;463360;501081;345371;630272;;;;;;
37139,385;162451;1699;167424;341640;342329;463360;504091;344028;630784;;;;;;
37166,046;161443;2612;167424;342329;342840;463360;503772;345452;630784;;;;;;
37178,259;162356;6367;165888;342840;343424;463360;505196;349791;629248;;;;;;
37191,484;165087;2064;166912;343424;344287;463360;508511;346351;630272;;;;;;
37199,078;160784;896;167424;344287;345150;463360;505071;346046;630784;;;;;;
37229,973;160640;3411;167424;345150;345415;463360;505790;348826;630784;;;;;;
37238,472;163155;2919;167936;345415;346143;463360;508570;349062;631296;;;;;;
37256,965;163175;3362;167424;346143;347055;463360;509318;350417;630784;;;;;;
37298,383;163618;976;168448;347055;347950;463360;510673;348926;631808;;;;;;
37314,363;162768;2692;168448;347950;348215;463360;510718;350907;631808;;;;;;
37326,852;164484;1707;168960;348215;348862;463360;512699;350569;632320;;;;;;
37344,910;164011;1057;168448;348862;349375;463360;512873;350432;631808;;;;;;
37369,635;163361;752;168960;349375;349534;463360;512736;350286;632320;;;;;;
37382,752;163568;2852;168960;349534;349943;463360;513102;352795;632320;;;;;;
37386,770;165668;932;169472;349943;350671;463360;515611;351603;632832;;;;;;
37409,371;164260;640;168960;350671;350822;463360;514931;351462;632320;;;;;;
37453,794;163968;5080;167424;350822;351199;463360;514790;356279;630784;;;;;;
37519,716;166872;3012;168448;351199;352127;463360;518071;355139;631808;;;;;;
37584,808;164804;2077;168960;352127;352855;463360;516931;354932;632320;;;;;;
37607,886;164381;1056;168448;352855;353550;463360;517236;354606;631808;;;;;;
37654,638;163360;2614;169472;353550;354023;463360;516910;356637;632832;;;;;;
37674,029;165942;2848;168960;354023;354454;463360;519965;357302;632320;;;;;;
37682,660;166176;2016;169472;354454;355543;463360;520630;357559;632832;;;;;;
37690,872;165856;3206;169472;355543;355952;463360;521399;359158;632832;;;;;;
37711,981;167046;2766;169984;355952;356695;463360;522998;359461;633344;;;;;;
37722,001;167118;5105;169472;356695;357474;463360;523813;362579;632832;;;;;;
37732,963;169457;1568;168448;357474;358922;463360;526931;360490;631808;;;;;;
37742,974;164384;1408;168960;358922;359458;463360;523306;360866;632320;;;;;;
37773,071;164224;2997;169472;359458;359879;463360;523682;362876;632832;;;;;;
37791,708;166837;928;169472;359879;361812;463360;526716;362740;632832;;;;;;
37798,699;164768;1220;169472;361812;362460;463360;526580;363680;632832;;;;;;
37816,686;165060;3698;169472;362460;362620;463360;527520;366318;632832;;;;;;
37837,276;167340;1441;169472;362620;363212;463360;529960;364653;632832;;;;;;
37857,938;165281;2964;169472;363212;363652;463360;528493;366616;632832;;;;;;
37866,992;166804;896;169472;363652;364512;463360;530456;365408;632832;;;;;;
37938,340;164736;1556;169472;364512;364752;463360;529248;366308;632832;;;;;;
37952,833;165396;2291;169984;364752;365168;463360;530148;367459;633344;;;;;;
37963,359;167155;944;169984;365168;365905;463360;532323;366849;633344;;;;;;
38012,180;165808;2740;169984;365905;366136;463360;531713;368876;633344;;;;;;
38016,758;167604;951;169984;366136;366824;463360;533740;367775;633344;;;;;;
38078,932;165815;3299;169984;366824;367064;463360;532639;370363;633344;;;;;;
38099,544;168163;968;169984;367064;368239;463360;535227;369207;633344;;;;;;
38143,116;165832;3119;169984;368239;368391;463360;534071;371510;633344;;;;;;
38166,696;167983;4592;169472;368391;369070;463360;536374;373662;632832;;;;;;
38172,385;169456;768;169472;369070;370014;463360;538526;370782;632832;;;;;;
38227,339;164608;3957;167936;370014;370278;463360;534622;374235;631296;;;;;;
38260,184;167648;5250;167936;370278;370895;463360;537926;376145;631296;;;;;;
38272,184;167042;4713;166912;370895;371710;463360;537937;376423;630272;;;;;;
38282,553;166505;1522;167936;371710;372695;463360;538215;374217;631296;;;;;;
38343,507;162290;2210;167936;372695;373143;463360;534985;375353;631296;;;;;;
38356,745;162978;3027;168448;373143;373447;463360;536121;376474;631808;;;;;;
38395,582;164819;1024;168448;373447;374270;463360;538266;375294;631808;;;;;;
38409,065;162816;3200;168960;374270;374743;463360;537086;377943;632320;;;;;;
38415,723;166016;2034;168960;374743;375367;463360;540759;377401;632320;;;;;;
38469,264;164751;1595;169472;375366;376006;463360;540117;377601;632832;;;;;;
38492,501;164923;2868;168960;376006;376407;463360;540929;379275;632320;;;;;;
38527,130;166196;1524;169472;376407;377063;463360;542603;378587;632832;;;;;;
38583,070;165364;4368;168448;377063;377415;463360;542427;381783;631808;;;;;;
38600,625;168208;2816;169472;377415;378262;463360;545623;381078;632832;;;;;;
38622,843;166144;2391;168960;378262;378887;463360;544406;381278;632320;;;;;;
38651,803;165719;2916;169472;378887;379801;463360;544606;382717;632832;;;;;;
38662,666;166756;1088;169472;379801;380537;463360;546557;381625;632832;;;;;;
38692,636;164928;4262;169472;380537;380985;463360;545465;385247;632832;;;;;;
38701,356;168087;1424;169472;380986;381649;463360;549073;383073;632832;;;;;;
38733,902;165264;2592;169472;381649;382097;463360;546913;384689;632832;;;;;;
38923,242;166432;1555;169472;382097;382714;463360;548529;384269;632832;;;;;;
38948,164;165395;2461;169984;382714;383256;463360;548109;385717;633344;;;;;;
38953,129;167325;1056;169984;383256;383929;463360;550581;384985;633344;;;;;;
38966,911;165920;832;169984;383929;384337;463360;549849;385169;633344;;;;;;
39005,946;165696;4037;168960;384337;384569;463360;550033;388606;632320;;;;;;
39022,064;168901;4727;168448;384569;385184;463360;553470;389911;631808;;;;;;
39028,073;167543;960;168960;385184;386081;463360;552727;387041;632320;;;;;;
39033,331;163776;992;168960;386081;386369;463360;549857;387361;632320;;;;;;
39073,169;163808;1056;168960;386369;386457;463360;550177;387513;632320;;;;;;
39120,388;163872;912;169472;386457;386872;463360;550329;387784;632832;;;;;;
39143,650;164752;1301;169472;386872;387265;463360;551624;388566;632832;;;;;;
39218,415;165141;3685;169472;387265;387425;463360;552406;391110;632832;;;;;;
39266,455;167525;3590;167936;387425;387968;463360;554950;391558;631296;;;;;;
39273,543;167430;992;169472;387968;388897;463360;555398;389889;632832;;;;;;
39309,970;164320;3140;168960;388897;389377;463360;553217;392517;632320;;;;;;
39332,039;166468;1347;169472;389377;389921;463360;555845;391268;632832;;;;;;
39364,727;165187;3795;167936;389921;390353;463360;555108;394148;631296;;;;;;
39382,990;167484;4035;168960;390516;391315;463360;558000;395350;632320;;;;;;
39389,085;166851;2946;168960;391319;392193;463360;558170;395139;632320;;;;;;
39402,891;165762;3851;168960;392193;393049;463360;557955;396900;632320;;;;;;
39421,216;166667;2497;168960;393049;393949;463360;559716;396446;632320;;;;;;
39444,551;165313;800;168960;393949;394572;463360;559262;395372;632320;;;;;;
39455,126;163616;1756;168960;394572;394717;463360;558188;396473;632320;;;;;;
39471,377;164572;3012;169472;394717;395085;463360;559289;398097;632832;;;;;;
39486,443;166852;4685;168960;395085;395477;463360;561937;400162;632320;;;;;;
39507,283;168525;1505;168960;395477;396141;463360;564002;397646;632320;;;;;;
39560,277;164321;5658;168960;396141;396990;463360;560462;402648;632320;;;;;;
39600,097;168474;5547;165888;396990;397640;463360;565464;403187;629248;;;;;;
39623,727;165291;1249;167424;397640;398517;463360;562931;399766;630784;;;;;;
39705,969;160993;2051;167936;398517;398677;463360;559510;400728;631296;;;;;;
39729,572;162819;3236;167936;398677;399117;463360;561496;402353;631296;;;;;;
39752,505;164004;3375;168448;399117;399757;463360;563121;403132;631808;;;;;;
39767,553;165167;1008;168448;399757;400412;463360;564924;401420;631808;;;;;;
39814,958;162800;5309;167424;400412;400861;463360;563212;406170;630784;;;;;;
39825,882;166077;2446;167936;400861;401749;463360;566938;404195;631296;;;;;;
39909,310;163214;6715;165888;401749;402572;463360;564963;409287;629248;;;;;;
39949,262;165435;2164;166912;402572;403580;463360;568007;405744;630272;;;;;;
39979,220;80950;2210;167424;403579;404091;463360;484529;406301;630784;;;;;;
39979,232;2210;0;167424;404091;333185;463360;406301;333185;630784;182677;182160;786432;588978;515345;1417216
40031,569;159744;2132;167424;333185;333185;463360;492929;335317;630784;;;;;;
40046,738;161876;1729;167936;333185;333689;463360;495061;335418;631296;;;;;;
40074,092;162497;2452;167936;333689;334234;463360;496186;336686;631296;;;;;;
40114,612;163220;6649;165376;334234;335467;463360;497454;342116;628736;;;;;;
40160,616;165369;3585;166912;335467;336379;463360;500836;339964;630272;;;;;;
40205,388;162305;3656;167424;336379;337074;463360;498684;340730;630784;;;;;;
40265,903;163400;2032;167424;337074;337794;463360;500474;339826;630784;;;;;;
40322,721;161776;4209;167936;337794;338906;463360;499570;343115;631296;;;;;;
40381,298;164977;1748;167936;338906;339226;463360;503883;340974;631296;;;;;;
40403,482;162516;3640;167936;339226;339742;463360;501742;343382;631296;;;;;;
40427,416;164408;4811;167936;339742;340157;463360;504150;344968;631296;;;;;;
40450,251;165579;4322;167936;340157;340845;463360;505736;345167;631296;;;;;;
40459,328;165090;1056;167936;340845;341630;463360;505935;342686;631296;;;;;;
40470,051;161824;3428;167936;341630;341845;463360;503454;345273;631296;;;;;;
40495,053;164196;3300;167936;341845;342646;463360;506041;345946;631296;;;;;;
40513,838;164068;3854;168448;342646;343334;463360;506714;347188;631808;;;;;;
40524,654;165646;3814;168448;343334;344093;463360;508980;347907;631808;;;;;;
40539,883;165606;6485;167424;344093;345333;463360;509699;351818;630784;;;;;;
40569,542;167253;3188;167936;345333;346077;463360;512586;349265;631296;;;;;;
40587,760;163956;1599;167936;346077;346901;463360;510033;348500;631296;;;;;;
40609,090;162367;7145;167936;346901;347858;463360;509268;355003;631296;;;;;;
40631,810;167913;3761;165888;347858;348978;463360;515771;352739;629248;;;;;;
40643,039;162481;4886;166912;348978;349458;463360;511459;354344;630272;;;;;;
40643,842;163606;7432;165888;349458;350809;463360;513064;358241;629248;;;;;;
40654,854;165128;832;158720;350809;355337;463360;515937;356169;622080;;;;;;
40682,825;158528;6082;165888;355337;355553;463360;513865;361635;629248;;;;;;
40700,100;162754;2916;165888;355553;356516;463360;518307;359432;629248;;;;;;
40721,651;159588;1119;165888;356516;357640;463360;516104;358759;629248;;;;;;
40781,154;157791;3924;165888;357640;358143;463360;515431;362067;629248;;;;;;
40817,385;160596;2980;166912;358143;359079;463360;518739;362059;630272;;;;;;
40837,605;161188;896;166400;359079;359863;463360;520267;360759;629760;;;;;;
40904,085;159104;3231;166912;359863;360343;463360;518967;363574;630272;;;;;;
41049,260;161951;3175;166912;360343;360983;463360;522294;364158;630272;;;;;;
41074,167;161895;3259;167936;360983;361703;463360;522878;364962;631296;;;;;;
41157,273;163515;3169;167424;361703;362311;463360;525218;365480;630784;;;;;;
41206,390;163425;6643;165376;362311;364010;463360;525736;370653;628736;;;;;;
41220,938;165363;4270;166912;364010;365529;463360;529373;369799;630272;;;;;;
41231,956;162990;992;166912;365529;365969;463360;528519;366961;630272;;;;;;
41246,086;159712;2639;166912;365969;366617;463360;525681;369256;630272;;;;;;
41284,103;161359;2048;167424;366617;366977;463360;527976;369025;630784;;;;;;
41350,869;161280;1104;166912;366977;367649;463360;528257;368753;630272;;;;;;
41375,812;160336;1504;167424;367649;368105;463360;527985;369609;630784;;;;;;
41428,139;161248;5943;165888;368105;368907;463360;529353;374850;629248;;;;;;
41444,968;165687;2964;167424;368907;369887;463360;534594;372851;630784;;;;;;
41461,350;162196;2008;166912;369887;370876;463360;532083;372884;630272;;;;;;
41716,914;161240;879;167424;370876;371399;463360;532116;372278;630784;;;;;;
41729,074;160623;576;167424;371399;371934;463360;532022;372510;630784;;;;;;
41751,598;160162;4778;167424;371935;372038;463360;532097;376816;630784;;;;;;
41795,257;164522;1264;167424;372038;372838;463360;536560;374102;630784;;;;;;
41821,696;161008;768;167424;372838;373422;463360;533846;374190;630784;;;;;;
41896,515;160512;944;167424;373422;373750;463360;533934;374694;630784;;;;;;
41936,322;160688;2830;167936;373750;374006;463360;534438;376836;631296;;;;;;
42028,286;163598;2080;167936;374006;374493;463360;537604;376573;631296;;;;;;
42049,960;162848;4968;167424;374493;374949;463360;537341;379917;630784;;;;;;
42084,577;165736;1394;167936;374949;376352;463360;540685;377746;631296;;;;;;
42114,600;162162;4017;167936;376352;376856;463360;538514;380873;631296;;;;;;
42140,539;164785;4816;165888;376856;377920;463360;541641;382736;629248;;;;;;
42160,198;165584;1441;167936;377920;378616;463360;543504;380057;631296;;;;;;
42192,857;161697;2480;167424;378616;379376;463360;540313;381856;630784;;;;;;
42298,459;162193;2382;168448;379376;379649;463360;541569;382031;631808;;;;;;
42332,681;164174;5137;167424;379649;380240;463360;543823;385377;630784;;;;;;
42358,919;166929;1308;167936;380240;381491;463360;547169;382799;631296;;;;;;
42380,120;162076;2867;167936;381491;381867;463360;543567;384734;631296;;;;;;
42401,173;163635;4276;168448;381867;383211;463360;545502;387487;631808;;;;;;
42404,408;166068;832;168448;383211;384914;463360;549279;385746;631808;;;;;;
42516,907;162624;2049;168448;384914;385235;463360;547538;387284;631808;;;;;;
42532,769;163841;1483;168448;385235;385835;463360;549076;387318;631808;;;;;;
42563,518;163275;2480;168960;385835;386394;463360;549110;388874;632320;;;;;;
42605,336;165296;899;168960;386394;387322;463360;551690;388221;632320;;;;;;
42615,275;163715;2788;169472;387322;387426;463360;551037;390214;632832;;;;;;
42633,531;166116;1680;168960;387426;387914;463360;553542;389594;632320;;;;;;
42651,315;165008;704;169472;387914;388410;463360;552922;389114;632832;;;;;;
42679,779;164544;1232;169472;388410;388698;463360;552954;389930;632832;;;;;;
42721,581;165072;1127;169984;388698;388842;463360;553770;389969;633344;;;;;;
42744,991;165479;3658;169472;388842;389082;463360;554321;392740;632832;;;;;;
42778,720;168010;3296;169472;389082;389602;463360;557092;392898;632832;;;;;;
42801,169;167136;1504;169472;389602;390811;463360;556738;392315;632832;;;;;;
42953,389;165344;1205;169984;390811;391092;463360;556155;392297;633344;;;;;;
42980,051;165557;2079;169472;391092;391412;463360;556649;393491;632832;;;;;;
43005,561;166431;3716;168960;391412;392041;463360;557843;395757;632320;;;;;;
43020,674;167556;1735;169472;392041;393044;463360;559597;394779;632832;;;;;;
43120,721;165575;752;169984;393044;393864;463360;558619;394616;633344;;;;;;
43154,108;165616;4772;169984;393864;394168;463360;559480;398940;633344;;;;;;
43196,694;169593;4009;167936;394168;395080;463360;563761;399089;631296;;;;;;
43205,483;166825;1345;168960;395080;395927;463360;561905;397272;632320;;;;;;
43221,953;164161;4372;167936;395927;396376;463360;560088;400748;631296;;;;;;
43243,463;166164;1191;168448;396376;397019;463360;562540;398210;631808;;;;;;
43261,633;162983;6128;165888;397019;398301;463360;560002;404429;629248;;;;;;
43272,083;165872;1551;167424;398301;399382;463360;564173;400933;630784;;;;;;
43287,535;161295;3316;167936;399382;399767;463360;560677;403083;631296;;;;;;
43315,827;163572;2380;167424;399767;400335;463360;563339;402715;630784;;;;;;
43335,966;162636;1268;168448;400335;401047;463360;562971;402315;631808;;;;;;
43360,427;162548;2624;167936;401047;401527;463360;563595;404151;631296;;;;;;
43396,239;163904;3108;168960;401527;401927;463360;565431;405035;632320;;;;;;
43403,055;165412;1152;168448;401927;402735;463360;567339;403887;631808;;;;;;
43426,836;163456;1779;168960;402735;403327;463360;566191;405106;632320;;;;;;
43448,940;164595;2604;168960;403327;403846;463360;567922;406450;632320;;;;;;
43465,738;165420;896;169472;403846;404421;463360;569266;405317;632832;;;;;;
43506,111;164736;2676;169472;404421;404886;463360;569157;407562;632832;;;;;;
43532,795;166516;1328;169472;404886;405510;463360;571402;406838;632832;;;;;;
43550,856;165168;928;169472;405510;406006;463360;570678;406934;632832;;;;;;
43580,340;41232;384;169984;406006;406478;463360;447238;406862;633344;;;;;;
43580,356;384;0;169984;406478;341409;463360;406862;341409;633344;183902;182226;786432;590764;523635;1419776
43617,480;164864;2606;169984;341409;341410;463360;506273;344016;633344;;;;;;
43634,949;167470;3943;168960;341410;341960;463360;508880;345903;632320;;;;;;
43664,401;167783;1228;169472;341960;343073;463360;509743;344301;632832;;;;;;
43702,252;165068;3186;169472;343073;343465;463360;508141;346651;632832;;;;;;
43703,740;167026;5616;164864;343465;348173;463360;510491;353789;628224;;;;;;
43723,726;164848;721;164352;348173;351466;463360;513021;352187;627712;;;;;;
43739,363;159441;962;166912;351466;351553;463360;510907;352515;630272;;;;;;
43750,273;159682;1026;167424;351553;351793;463360;511235;352819;630784;;;;;;
43859,882;160258;5794;165376;351793;352065;463360;512051;357859;628736;;;;;;
43893,335;165026;993;166912;352065;352711;463360;517091;353704;630272;;;;;;
43961,396;159201;2846;166400;352711;352967;463360;511912;355813;629760;;;;;;
43987,030;161054;4165;167424;352967;353585;463360;514021;357750;630784;;;;;;
44058,113;163909;3289;167424;353585;354345;463360;517494;357634;630784;;;;;;
44174,431;163033;3050;167936;354345;354857;463360;517378;357907;631296;;;;;;
44195,968;163306;880;167424;354857;355617;463360;518163;356497;630784;;;;;;
44212,501;161136;704;167936;355617;356089;463360;516753;356793;631296;;;;;;
44275,484;161472;3932;167936;356089;356185;463360;517561;360117;631296;;;;;;
44290,248;164700;1532;168448;356185;357389;463360;520885;358921;631808;;;;;;
44350,906;162812;1104;167936;357389;357854;463360;520201;358958;631296;;;;;;
44397,490;162384;2909;168448;357854;358150;463360;520238;361059;631808;;;;;;
44456,171;164701;3376;168448;358150;358776;463360;522851;362152;631808;;;;;;
44472,250;165168;1184;168960;358776;359480;463360;523944;360664;632320;;;;;;
44491,573;163488;800;168448;359480;359920;463360;522968;360720;631808;;;;;;
44521,325;163104;864;168960;359920;360200;463360;523024;361064;632320;;;;;;
44559,237;163680;864;168960;360200;360536;463360;523880;361400;632320;;;;;;
44592,295;163680;864;169472;360536;360728;463360;524216;361592;632832;;;;;;
44652,002;164192;1136;168960;360728;360976;463360;524920;362112;632320;;;;;;
44659,403;164464;768;169984;360976;361440;463360;525440;362208;633344;;;;;;
44665,476;165120;544;169472;361440;361792;463360;526560;362336;632832;;;;;;
44703,443;164896;1088;169984;361792;361960;463360;526688;363048;633344;;;;;;
44722,164;165952;800;169984;361960;362376;463360;527912;363176;633344;;;;;;
44743,694;165664;1939;170496;362376;362577;463360;528040;364516;633856;;;;;;
44765,615;167827;2241;170496;362577;363176;463360;530404;365417;633856;;;;;;
44805,006;168129;1328;170496;363176;364058;463360;531305;365386;633856;;;;;;
44819,078;167216;736;170496;364058;364314;463360;531274;365050;633856;;;;;;
44861,155;166624;672;171008;364314;364578;463360;530938;365250;634368;;;;;;
44907,460;167584;2256;171008;364578;364762;463360;532162;367018;634368;;;;;;
44936,521;169168;1184;171008;364762;365115;463360;533930;366299;634368;;;;;;
44940,186;168096;1232;171008;365115;365458;463360;533211;366690;634368;;;;;;
44946,633;168144;1075;171520;365458;365642;463360;533602;366717;634880;;;;;;
44972,440;169011;1248;171520;365642;365987;463360;534653;367235;634880;;;;;;
44997,966;169184;928;171520;365987;366434;463360;535171;367362;634880;;;;;;
45047,389;168864;1136;171520;366434;366698;463360;535298;367834;634880;;;;;;
45067,041;169072;768;172032;366698;367082;463360;535770;367850;635392;;;;;;
45106,539;169728;912;172032;367082;367354;463360;536810;368266;635392;;;;;;
45116,909;169872;784;172032;367354;367650;463360;537226;368434;635392;;;;;;
45153,677;169744;896;172032;367650;367834;463360;537394;368730;635392;;;;;;
45168,971;169856;2513;172032;367834;368195;463360;537690;370708;635392;;;;;;
45179,256;171473;896;172032;368195;368554;463360;539668;369450;635392;;;;;;
45198,811;169856;1056;172032;368554;368882;463360;538410;369938;635392;;;;;;
45234,572;170016;3047;172032;368882;369281;463360;538898;372328;635392;;;;;;
45245,156;172007;3061;168960;369281;371185;463360;541288;374246;632320;;;;;;
45265,513;168949;1504;170496;371185;372049;463360;540134;373553;633856;;;;;;
45284,661;167392;960;170496;372049;372648;463360;539441;373608;633856;;;;;;
45323,270;166848;4600;170496;372648;373949;463360;539496;378549;633856;;;;;;
45336,253;170488;1568;168448;373949;374957;463360;544437;376525;631808;;;;;;
45352,810;165408;1104;169472;374957;375524;463360;540365;376628;632832;;;;;;
45391,302;164944;1856;169984;375524;376020;463360;540468;377876;633344;;;;;;
45408,027;166720;1120;169984;376020;376284;463360;542740;377404;633344;;;;;;
45476,432;165984;1152;170496;376284;376596;463360;542268;377748;633856;;;;;;
45498,332;166528;1585;169984;376596;376853;463360;543124;378438;633344;;;;;;
45504,639;166961;3294;170496;376853;377325;463360;543814;380619;633856;;;;;;
45524,232;169182;1344;170496;377325;378304;463360;546507;379648;633856;;;;;;
45581,709;167232;1238;170496;378304;378800;463360;545536;380038;633856;;;;;;
45611,924;167126;3002;170496;378800;379080;463360;545926;382082;633856;;;;;;
45633,795;168890;2964;170496;379080;379384;463360;547970;382348;633856;;;;;;
45654,521;168852;2144;170496;379384;380207;463360;548236;382351;633856;;;;;;
45673,179;168032;2352;170496;380207;381363;463360;548239;383715;633856;;;;;;
45701,217;168240;1636;170496;381363;382361;463360;549603;383997;633856;;;;;;
45760,099;167524;2044;171008;382361;382713;463360;549885;384757;634368;;;;;;
45786,756;168444;1040;170496;382713;383281;463360;551157;384321;633856;;;;;;
45797,424;167440;961;171008;383281;383769;463360;550721;384730;634368;;;;;;
45828,591;167873;3266;170496;383769;384105;463360;551642;387371;633856;;;;;;
45847,225;170178;992;170496;384105;385056;463360;554283;386048;633856;;;;;;
45875,238;166880;864;170496;385056;385616;463360;551936;386480;633856;;;;;;
45952,277;166752;4084;168960;385616;386496;463360;552368;390580;632320;;;;;;
45965,067;168948;1520;169984;386496;387599;463360;555444;389119;633344;;;;;;
45982,906;166384;1025;169984;387599;387959;463360;553983;388984;633344;;;;;;
45996,270;165889;1250;169984;387959;388352;463360;553848;389602;633344;;;;;;
46001,995;166114;1719;170496;388352;388487;463360;554466;390206;633856;;;;;;
46039,630;167607;4593;170496;388487;391717;463360;556094;396310;633856;;;;;;
46046,466;170481;1388;167424;391717;392910;463360;562198;394298;630784;;;;;;
46061,253;164204;1903;168960;393458;393834;463360;557662;395737;632320;;;;;;
46075,281;164719;2831;169472;393838;394312;463360;558557;397143;632832;;;;;;
46116,563;166159;1248;168960;394312;395332;463360;560471;396580;632320;;;;;;
46132,753;164576;863;169472;395332;395748;463360;559908;396611;632832;;;;;;
46141,023;164340;1373;169472;395749;396076;463360;560089;397449;632832;;;;;;
46151,073;165213;1056;169984;396076;396244;463360;561289;397300;633344;;;;;;
46196,742;165408;4316;169472;396244;396508;463360;561652;400824;632832;;;;;;
46210,162;168605;1803;169472;396508;397364;463360;565113;399167;632832;;;;;;
46227,908;165643;944;169472;397364;397564;463360;563007;398508;632832;;;;;;
46254,334;164784;688;169472;397564;397940;463360;562348;398628;632832;;;;;;
46290,750;164528;848;169472;397940;398244;463360;562468;399092;632832;;;;;;
46299,596;164688;1025;169984;398244;398476;463360;562932;399501;633344;;;;;;
46313,346;165889;3548;168448;398476;398741;463360;564365;402289;631808;;;;;;
46375,515;168412;3844;169472;398741;399438;463360;567153;403282;632832;;;;;;
46405,985;167684;1705;169472;399438;400248;463360;567122;401953;632832;;;;;;
46420,074;165545;4044;168448;400248;400544;463360;565793;404588;631808;;;;;;
46427,366;166860;736;168960;400544;401327;463360;567404;402063;632320;;;;;;
46440,010;163552;896;169472;401327;401791;463360;564879;402687;632832;;;;;;
46453,566;164736;1216;169472;401791;402055;463360;566527;403271;632832;;;;;;
46465,573;165056;5003;168448;402055;402343;463360;567111;407346;631808;;;;;;
46519,389;167819;2580;168960;402343;403462;463360;570162;406042;632320;;;;;;
46542,379;165396;1808;169472;403462;404085;463360;568858;405893;632832;;;;;;
46561,297;165136;1729;168960;404085;405022;463360;569221;406751;632320;;;;;;
46566,801;165057;3471;169472;405022;405270;463360;570079;408741;632832;;;;;;
46576,980;167311;752;169472;405270;406489;463360;572581;407241;632832;;;;;;
46596,068;164592;992;169472;406489;406817;463360;571081;407809;632832;;;;;;
46620,519;164832;2784;169472;406817;407345;463360;571649;410129;632832;;;;;;
46645,831;166624;800;169472;407345;408073;463360;573969;408873;632832;;;;;;
46696,974;164640;2948;169472;408073;408409;463360;572713;411357;632832;;;;;;
46738,990;166788;2756;169984;408409;409249;463360;575197;412005;633344;;;;;;
46755,655;167108;2429;169472;409249;409330;463360;576357;411759;632832;;;;;;
46763,455;166781;4630;168960;409330;410021;463360;576111;414651;632320;;;;;;
46772,018;168470;3596;167936;410021;411124;463360;578491;414720;631296;;;;;;
46793,382;167436;3015;169472;411124;411789;463360;578560;414804;632832;;;;;;
46818,932;166343;3762;168960;411789;412700;463360;578132;416462;632320;;;;;;
46835,749;166970;3135;169472;412701;413357;463360;579671;416492;632832;;;;;;
46854,912;166463;1409;168960;413357;414100;463360;579820;415509;632320;;;;;;
46860,115;164737;5608;167424;414100;414792;463360;578837;420400;630784;;;;;;
46881,098;167400;2785;168448;414792;416835;463360;582192;419620;631808;;;;;;
46891,426;164577;2355;168960;416835;417591;463360;581412;419946;632320;;;;;;
46901,292;164659;1664;168448;417591;418855;463360;582250;420519;631808;;;;;;
46923,818;163968;922;168960;418855;419952;463360;582823;420874;632320;;;;;;
46941,357;163738;1504;168960;419952;420151;463360;583690;421655;632320;;;;;;
46951,157;164320;960;168960;420151;420703;463360;584471;421663;632320;;;;;;
46957,108;163776;1136;168960;420703;420824;463360;584479;421960;632320;;;;;;
46963,901;163952;1315;169472;420824;420984;463360;584776;422299;632832;;;;;;
46979,638;165155;1104;169472;420984;421264;463360;586139;422368;632832;;;;;;
46989,095;164944;3630;169472;421264;421792;463360;586208;425422;632832;;;;;;
47016,933;167397;3324;169472;421792;422560;463360;589189;425884;632832;;;;;;
47024,540;167164;1747;169472;422560;423513;463360;589724;425260;632832;;;;;;
47053,197;165587;969;169472;423513;424046;463360;589100;425015;632832;;;;;;
47067,598;164809;2064;169984;424046;424253;463360;588855;426317;633344;;;;;;
47071,368;166416;1311;169472;424253;424967;463360;590669;426278;632832;;;;;;
47089,749;165663;800;169984;424967;425127;463360;590630;425927;633344;;;;;;
47108,084;165664;832;169984;425127;425327;463360;590791;426159;633344;;;;;;
47119,648;165696;1408;170496;425327;425431;463360;591023;426839;633856;;;;;;
47143,962;166784;1568;169984;425431;426184;463360;592215;427752;633344;;;;;;
47182,434;123200;749;170496;426185;427096;463360;549385;427845;633856;;;;;;
47182,448;749;0;170496;427096;350467;463360;427845;350467;633856;185490;182640;786432;613335;533107;1420288
47200,066;165888;4512;170496;350467;350468;463360;516355;354980;633856;;;;;;
47209,030;170400;2352;169472;350468;351238;463360;520868;353590;632832;;;;;;
47241,936;167216;1058;169984;351238;352104;463360;518454;353162;633344;;;;;;
47274,911;165922;1168;170496;352104;352207;463360;518026;353375;633856;;;;;;
47314,444;166544;992;169984;352207;352760;463360;518751;353752;633344;;;;;;
47369,166;166368;912;170496;352760;353111;463360;519128;354023;633856;;;;;;
47397,658;166800;768;170496;353111;353359;463360;519911;354127;633856;;;;;;
47402,763;166656;874;171008;353359;353480;463360;520015;354354;634368;;;;;;
47467,215;167274;992;170496;353480;353736;463360;520754;354728;633856;;;;;;
47484,455;167392;800;171008;353736;354111;463360;521128;354911;634368;;;;;;
47495,363;167712;977;171008;354111;354248;463360;521823;355225;634368;;;;;;
47507,883;167889;1056;171520;354248;354616;463360;522137;355672;634880;;;;;;
47561,918;168992;800;171520;354616;355048;463360;523608;355848;634880;;;;;;
47581,030;168736;2145;171520;355048;355296;463360;523784;357441;634880;;;;;;
47595,127;170081;1107;171520;355296;355439;463360;525377;356546;634880;;;;;;
47621,875;169043;1058;172032;355439;355616;463360;524482;356674;635392;;;;;;
47651,023;169506;3043;171520;355616;357700;463360;525122;360743;634880;;;;;;
47681,094;171491;928;169472;357700;358555;463360;529191;359483;632832;;;;;;
47702,303;166816;672;170496;358555;358835;463360;525371;359507;633856;;;;;;
47740,571;166560;4092;167936;358835;360493;463360;525395;364585;631296;;;;;;
47768,740;167932;832;169472;360493;361714;463360;528425;362546;632832;;;;;;
47789,450;164672;3876;168448;361714;361979;463360;526386;365855;631808;;;;;;
47801,104;166692;1233;168960;361979;362818;463360;528671;364051;632320;;;;;;
47811,139;164049;3351;169472;362818;363386;463360;526867;366737;632832;;;;;;
47833,368;167191;1748;169472;363386;364002;463360;530577;365750;632832;;;;;;
47855,573;165588;2080;169984;364002;364401;463360;529590;366481;633344;;;;;;
47872,891;166432;1024;169472;364401;364929;463360;530833;365953;632832;;;;;;
47892,231;165376;3236;169984;364929;365289;463360;530305;368525;633344;;;;;;
47909,825;168100;1056;169984;365289;366345;463360;533389;367401;633344;;;;;;
47920,345;165920;1532;169984;366345;366489;463360;532265;368021;633344;;;;;;
47937,881;166396;1620;169984;366489;367113;463360;532885;368733;633344;;;;;;
47958,008;166484;1824;170496;367113;368009;463360;533597;369833;633856;;;;;;
48005,655;167712;2016;170496;368009;369217;463360;535721;371233;633856;;;;;;
48052,880;167903;560;171008;369218;369970;463360;537121;370530;634368;;;;;;
48073,852;167472;944;171008;369970;370346;463360;537442;371290;634368;;;;;;
48082,878;167856;672;171008;370346;370634;463360;538202;371306;634368;;;;;;
48100,700;167584;912;171008;370634;370907;463360;538218;371819;634368;;;;;;
48123,281;167824;608;171008;370907;371202;463360;538731;371810;634368;;;;;;
48168,860;167520;928;171008;371202;371330;463360;538722;372258;634368;;;;;;
48193,854;167840;3215;171008;371330;371571;463360;539170;374786;634368;;;;;;
48214,753;170127;4079;171008;371571;372243;463360;541698;376322;634368;;;;;;
48286,613;170991;896;169984;372243;373852;463360;543234;374748;633344;;;;;;
48347,291;166784;2292;170496;373852;374368;463360;540636;376660;633856;;;;;;
48384,909;168180;608;170496;374368;374688;463360;542548;375296;633856;;;;;;
48394,537;166496;640;170496;374688;374856;463360;541184;375496;633856;;;;;;
48433,040;166528;3299;169472;374856;375289;463360;541384;378588;632832;;;;;;
48442,503;168163;1961;169984;375289;375952;463360;543452;377913;633344;;;;;;
48453,300;166825;736;170496;375952;377019;463360;542777;377755;633856;;;;;;
48479,340;166573;3184;169472;377019;377108;463360;543592;380292;632832;;;;;;
48504,332;169072;960;170496;377108;377971;463360;546180;378931;633856;;;;;;
48520,028;166336;2204;169984;377971;378651;463360;544307;380855;633344;;;;;;
48584,139;167580;784;170496;378651;379187;463360;546231;379971;633856;;;;;;
48601,398;166672;4592;170496;379187;381441;463360;545859;386033;633856;;;;;;
48604,935;170480;4576;164352;381441;392939;463360;551921;397515;627712;;;;;;
48616,675;164320;2160;158208;392939;395500;463360;557259;397660;621568;;;;;;
48658,597;157808;5957;162304;395500;396724;463360;553308;402681;625664;;;;;;
48682,608;159557;2660;164352;396724;398155;463360;556281;400815;627712;;;;;;
48802,417;156260;1064;164864;398155;398467;463360;554415;399531;628224;;;;;;
48828,803;155688;2107;164864;398467;399100;463360;554155;401207;628224;;;;;;
48838,551;156528;2063;165888;399100;399675;463360;555628;401738;629248;;;;;;
48863,100;158223;1168;165376;399675;399834;463360;557898;401002;628736;;;;;;
48867,984;157328;960;166400;399834;400418;463360;557162;401378;629760;;;;;;
48909,979;158656;768;166400;400418;400858;463360;559074;401626;629760;;;;;;
48928,977;158464;880;166912;400858;401178;463360;559322;402058;630272;;;;;;
48937,608;159600;1680;166912;401178;401579;463360;560778;403259;630272;;;;;;
48962,880;160400;4867;166400;401579;401955;463360;561979;406822;629760;;;;;;
48981,522;163587;2448;166912;401955;402970;463360;565542;405418;630272;;;;;;
49010,069;161168;1372;167936;402970;403984;463360;564138;405356;631296;;;;;;
49026,925;161628;1152;167424;403984;404512;463360;565612;405664;630784;;;;;;
49050,339;161408;4820;166912;404512;405072;463360;565920;409892;630272;;;;;;
49091,453;164564;3025;167424;405072;405812;463360;569636;408837;630784;;;;;;
49116,043;162769;1088;167936;405812;406548;463360;568581;407636;631296;;;;;;
49137,121;161856;3407;167936;406548;406812;463360;568404;410219;631296;;;;;;
49149,719;164175;1136;168448;406812;407644;463360;570987;408780;631808;;;;;;
49205,389;162416;896;167936;407644;407996;463360;570060;408892;631296;;;;;;
49220,960;162176;800;168448;407996;408444;463360;570172;409244;631808;;;;;;
49314,294;162592;2660;168448;408444;408540;463360;571036;411200;631808;;;;;;
49350,235;164452;2911;168960;408540;409044;463360;572992;411955;632320;;;;;;
49373,696;165727;3220;168960;409044;409684;463360;574771;412904;632320;;;;;;
49456,814;166036;3027;168960;409684;409988;463360;575720;413015;632320;;;;;;
49486,246;165843;704;168960;409988;411079;463360;575831;411783;632320;;;;;;
49524,070;163520;2996;168960;411079;411448;463360;574599;414444;632320;;;;;;
49539,685;165812;1280;168960;411448;412607;463360;577260;413887;632320;;;;;;
49554,132;164096;1248;169472;412607;413143;463360;576703;414391;632832;;;;;;
49564,229;165088;2528;169472;413143;413515;463360;578231;416043;632832;;;;;;
49581,968;166368;1908;169984;413515;413952;463360;579883;415860;633344;;;;;;
49630,347;166260;1904;169472;413952;414588;463360;580212;416492;632832;;;;;;
49703,501;166256;3092;169984;414588;415133;463360;580844;418225;633344;;;;;;
49721,328;167956;1280;169984;415133;415941;463360;583089;417221;633344;;;;;;
49767,388;166144;3416;169984;415941;416308;463360;582085;419724;633344;;;;;;
49776,121;168280;1496;169984;416308;417260;463360;584588;418756;633344;;;;;;
49836,124;166360;720;169984;417260;417356;463360;583620;418076;633344;;;;;;
49851,432;165584;811;169984;417356;417717;463360;582940;418528;633344;;;;;;
49873,014;165675;2804;169984;417717;417924;463360;583392;420728;633344;;;;;;
49879,895;167668;864;169984;417924;418644;463360;585592;419508;633344;;;;;;
49925,230;165728;1808;170496;418644;418804;463360;584372;420612;633856;;;;;;
49943,839;167184;2659;169984;418804;419117;463360;585988;421776;633344;;;;;;
49971,989;168035;992;170496;419117;419651;463360;587152;420643;633856;;;;;;
50048,446;166880;1232;170496;419651;420315;463360;586531;421547;633856;;;;;;
50123,303;167120;4581;168448;420315;421755;463360;587435;426336;631808;;;;;;
50168,195;168421;5615;169472;421755;423157;463360;590176;428772;632832;;;;;;
50206,110;169455;832;166400;423157;423988;463360;592612;424820;629760;;;;;;
50234,194;161600;960;167936;423988;424452;463360;585588;425412;631296;;;;;;
50252,513;161728;4851;166912;424452;424644;463360;586180;429495;630272;;;;;;
50261,447;164595;1898;167424;424644;425548;463360;589239;427446;630784;;;;;;
50271,038;161642;1152;168448;425548;426100;463360;587190;427252;631808;;;;;;
50282,102;162432;864;167936;426100;426796;463360;588532;427660;631296;;;;;;
50310,336;162144;800;168448;426796;427157;463360;588940;427957;631808;;;;;;
50353,430;162592;3263;168448;427157;427316;463360;589749;430579;631808;;;;;;
50372,299;165055;1057;168960;427316;428076;463360;592371;429133;632320;;;;;;
50442,881;163361;1501;168448;428076;428468;463360;591437;429969;631808;;;;;;
50485,752;163805;850;169472;428468;429044;463360;592273;429894;632832;;;;;;
50504,754;164178;4256;168960;429044;429292;463360;593222;433548;632320;;;;;;
50527,691;167584;768;168960;429292;430276;463360;596876;431044;632320;;;;;;
50712,465;163584;1449;168960;430276;430588;463360;593860;432037;632320;;;;;;
50726,415;164114;5303;167936;430750;431157;463360;594864;436460;631296;;;;;;
50745,287;167095;3176;168448;431162;432482;463360;598257;435658;631808;;;;;;
50751,325;164968;1520;168448;432482;433274;463360;597450;434794;631808;;;;;;
50759,536;163312;1020;168448;433274;433594;463360;596586;434614;631808;;;;;;
50780,750;162812;2368;168960;433594;433706;463360;596406;436074;632320;;;;;;
50783,894;39919;352;168960;433707;434610;463360;473626;434962;632320;;;;;;
50783,905;352;0;168960;434610;355939;463360;434962;355939;632320;183839;182496;786432;618801;538435;1418752
50822,052;162816;1072;169472;355939;355940;463360;518755;357012;632832;;;;;;
50837,879;164400;936;168960;355940;356380;463360;520340;357316;632320;;;;;;
50854,732;164264;2771;169472;356380;356484;463360;520644;359255;632832;;;;;;
50868,883;166611;2297;169472;356484;357363;463360;523095;359660;632832;;;;;;
50876,874;166137;1584;169984;357363;357923;463360;523500;359507;633344;;;;;;
50881,602;166448;1531;169984;357923;358955;463360;524371;360486;633344;;;;;;
50887,305;166395;1635;170496;358955;359604;463360;525350;361239;633856;;;;;;
50892,897;167523;2616;170496;359604;360116;463360;527127;362732;633856;;;;;;
50919,629;168504;1984;170496;360116;360675;463360;528620;362659;633856;;;;;;
50939,172;163594;955;170496;360676;367063;463360;524270;368018;633856;;;;;;
50939,185;955;0;170496;367063;361525;463360;368018;361525;633856;182668;182449;786432;550686;543974;1420288
50955,318;165888;2962;170496;361525;361526;463360;527413;364488;633856;;;;;;
50975,540;168850;1132;170496;361526;362268;463360;530376;363400;633856;;;;;;
50985,934;167020;945;170496;362268;362532;463360;529288;363477;633856;;;;;;
51012,132;166833;1018;170496;362532;362812;463360;529365;363830;633856;;;;;;
51058,292;166906;2836;169984;362812;362932;463360;529718;365768;633344;;;;;;
51088,664;168724;3958;169984;362932;363556;463360;531656;367514;633344;;;;;;
51111,160;169846;2229;170496;363556;364284;463360;533402;366513;633856;;;;;;
51128,921;167605;1056;169984;364284;364708;463360;531889;365764;633344;;;;;;
51144,269;166432;1036;170496;364708;364940;463360;531140;365976;633856;;;;;;
51155,121;166924;640;170496;364940;365052;463360;531864;365692;633856;;;;;;
51170,855;166528;1810;170496;365052;365220;463360;531580;367030;633856;;;;;;
51192,205;167698;800;170496;365220;365436;463360;532918;366236;633856;;;;;;
51209,966;166688;1715;171008;365436;365620;463360;532124;367335;634368;;;;;;
51232,478;168627;672;171008;365620;365940;463360;534247;366612;634368;;;;;;
51248,152;167584;3381;169984;365940;366116;463360;533524;369497;633344;;;;;;
51257,279;169269;2288;170496;366116;366620;463360;535385;368908;633856;;;;;;
51275,646;168176;960;171008;366620;367100;463360;534796;368060;634368;;;;;;
51288,875;167360;704;170496;367100;367508;463360;534460;368212;633856;;;;;;
51306,495;167104;480;171008;367508;367676;463360;534612;368156;634368;;;;;;
51322,685;167392;1603;171008;367676;367812;463360;535068;369415;634368;;;;;;
51339,698;168515;784;171008;367812;367924;463360;536327;368708;634368;;;;;;
51351,925;167696;1920;171008;367924;368116;463360;535620;370036;634368;;;;;;
51361,317;168832;929;171520;368116;368597;463360;536948;369526;634880;;;;;;
51376,516;168353;3553;171008;368597;370394;463360;536950;373947;634368;;;;;;
51392,424;170977;1634;169984;370394;370890;463360;541371;372524;633344;;;;;;
51408,362;167522;944;170496;370890;371418;463360;538412;372362;633856;;;;;;
51428,348;166832;2323;170496;371418;371715;463360;538250;374038;633856;;;;;;
51451,123;168211;2259;170496;371715;371771;463360;539926;374030;633856;;;;;;
51471,478;168147;2836;170496;371771;372090;463360;539918;374926;633856;;;;;;
51483,238;168724;2269;170496;372090;372507;463360;540814;374776;633856;;;;;;
51491,847;168157;2085;171008;372507;372955;463360;540664;375040;634368;;;;;;
51503,478;168485;1357;170496;372955;373459;463360;541440;374816;633856;;;;;;
51516,037;167757;1536;171008;373459;373636;463360;541216;375172;634368;;;;;;
51539,727;168353;3155;170496;373636;373931;463360;541989;377086;633856;;;;;;
51564,254;170067;3503;170496;373931;374434;463360;543998;377937;633856;;;;;;
51590,052;169391;1425;170496;374434;375594;463360;543825;377019;633856;;;;;;
51625,020;167313;3093;170496;375594;376282;463360;542907;379375;633856;;;;;;
51640,666;168981;1040;170496;376282;377043;463360;545263;378083;633856;;;;;;
51696,105;166928;3604;169472;377043;377306;463360;543971;380910;632832;;;;;;
51803,218;168468;4231;169472;377306;378091;463360;545774;382322;632832;;;;;;
51822,027;169095;899;169472;378091;379531;463360;547186;380430;632832;;;;;;
51897,017;164739;3279;169472;379531;379803;463360;544270;383082;632832;;;;;;
52045,163;167116;1702;169472;379803;380691;463360;546919;382393;632832;;;;;;
52068,518;165542;5623;169472;380691;383412;463360;546233;389035;632832;;;;;;
52098,841;169463;2212;166400;383412;384421;463360;552875;386633;629760;;;;;;
52112,149;162980;768;167936;384421;384913;463360;547401;385681;631296;;;;;;
52128,862;161536;864;168448;384913;385265;463360;546449;386129;631808;;;;;;
52157,053;162144;1344;167936;385265;385425;463360;547409;386769;631296;;;;;;
52200,636;162624;960;168448;385425;386042;463360;548049;387002;631808;;;;;;
52224,814;162752;608;168448;386042;386345;463360;548794;386953;631808;;;;;;
52255,256;162400;917;168960;386345;386538;463360;548745;387455;632320;;;;;;
52310,121;163733;2691;168960;386538;386738;463360;550271;389429;632320;;;;;;
52340,560;165507;1705;169472;386738;387537;463360;552245;389242;632832;;;;;;
52356,736;165033;1160;168960;387537;387921;463360;552570;389081;632320;;;;;;
52380,716;164488;1146;169984;387921;388161;463360;552409;389307;633344;;;;;;
52396,145;165498;1040;169472;388161;388657;463360;553659;389697;632832;;;;;;
52462,329;165392;1182;169984;388657;388817;463360;554049;389999;633344;;;;;;
52473,649;166046;929;169984;388817;389344;463360;554863;390273;633344;;;;;;
52537,998;165793;1489;170496;389344;389624;463360;555137;391113;633856;;;;;;
52550,949;167377;832;170496;389624;389864;463360;557001;390696;633856;;;;;;
52647,607;166720;1168;171008;389864;390064;463360;556584;391232;634368;;;;;;
52674,582;168080;834;171008;390064;390464;463360;558144;391298;634368;;;;;;
52734,553;167746;2685;171008;391778;391993;463360;559524;394678;634368;;;;;;
52748,755;169597;4067;171008;391998;392940;463360;561595;397007;634368;;;;;;
52777,687;170979;3788;167936;392940;393955;463360;563919;397743;631296;;;;;;
52800,214;167628;1164;169472;393955;395099;463360;561583;396263;632832;;;;;;
52822,508;165004;960;169984;395099;395450;463360;560103;396410;633344;;;;;;
52842,471;165312;1919;169472;395450;395562;463360;560762;397481;632832;;;;;;
52849,917;166271;2418;169984;395562;396423;463360;561833;398841;633344;;;;;;
52857,424;167282;4320;169472;396423;396632;463360;563705;400952;632832;;;;;;
52879,836;169184;4804;168448;396632;397554;463360;565816;402358;631808;;;;;;
52896,685;167620;2397;168960;397554;398378;463360;565174;400775;632320;;;;;;
52908,199;165213;928;169472;398378;398935;463360;563591;399863;632832;;;;;;
52924,252;164768;4431;168448;398935;399479;463360;563703;403910;631808;;;;;;
52943,634;168271;1377;168960;399479;400153;463360;567750;401530;632320;;;;;;
52975,850;164193;480;168960;400153;400601;463360;564346;401081;632320;;;;;;
53010,393;163296;480;168960;400601;400769;463360;563897;401249;632320;;;;;;
53034,934;163296;3558;168960;400769;400866;463360;564065;404424;632320;;;;;;
53042,978;166374;4865;167936;400866;401468;463360;567240;406333;631296;;;;;;
53051,428;166657;2480;168448;401468;402284;463360;568125;404764;631808;;;;;;
53074,907;164272;1247;168960;402284;402820;463360;566556;404067;632320;;;;;;
53091,990;163551;5734;168448;402820;403348;463360;566371;409082;631808;;;;;;
53113,516;168038;1682;168448;403348;404700;463360;571386;406382;631808;;;;;;
53131,962;163474;2965;168448;404700;405060;463360;568174;408025;631808;;;;;;
53142,196;164757;1216;168448;405060;406034;463360;569817;407250;631808;;;;;;
53152,747;163008;3364;168448;406034;406426;463360;569042;409790;631808;;;;;;
53169,306;165156;1088;168960;406426;407578;463360;571582;408666;632320;;;;;;
53182,516;163392;992;168448;407578;407794;463360;570970;408786;631808;;;;;;
53209,452;163296;544;168960;407794;408202;463360;571090;408746;632320;;;;;;
53228,007;163360;1857;168960;408202;408410;463360;571562;410267;632320;;;;;;
53243,908;164673;913;169472;408410;408594;463360;573083;409507;632832;;;;;;
53261,967;164753;949;169472;408594;408691;463360;573347;409640;632832;;;;;;
53309,529;164789;2054;169984;408691;408794;463360;573480;410848;633344;;;;;;
53323,978;166406;1195;169472;408794;409043;463360;575200;410238;632832;;;;;;
53343,806;165547;2002;170496;409043;409570;463360;574590;411572;633856;;;;;;
53369,048;167378;2099;169984;409570;409858;463360;576948;411957;633344;;;;;;
53389,203;167475;4223;169472;409858;409977;463360;577333;414200;632832;;;;;;
53411,374;169087;3781;168960;409977;410593;463360;579064;414374;632320;;;;;;
53464,769;168645;2737;169472;410593;411514;463360;579238;414251;632832;;;;;;
53501,171;166577;3751;169472;411514;412066;463360;578091;415817;632832;;;;;;
53586,921;167591;880;169472;412066;413225;463360;579657;414105;632832;;;;;;
53748,554;164720;5620;169472;413225;413835;463360;577945;419455;632832;;;;;;
53802,488;169460;1281;167424;413835;414618;463360;583295;415899;630784;;;;;;
53820,155;163073;3168;168448;414618;414866;463360;577691;418034;631808;;;;;;
53912,090;164922;1260;168960;414866;415634;463360;579788;416894;632320;;;;;;
53933,246;163564;917;168448;415634;416170;463360;579198;417087;631808;;;;;;
54038,814;163221;800;168960;416170;416511;463360;579391;417311;632320;;;;;;
54088,389;163616;6134;168960;416511;418814;463360;580127;424948;632320;;;;;;
54107,822;168950;1845;165888;418814;419493;463360;587764;421338;629248;;;;;;
54119,897;161589;1248;167424;419493;419965;463360;581082;421213;630784;;;;;;
54185,189;160992;3300;167936;419965;420487;463360;580957;423787;631296;;;;;;
54237,039;163556;3331;167424;420487;421423;463360;584043;424754;630784;;;;;;
54366,712;163587;2060;168448;421423;422478;463360;585010;424538;631808;;;;;;
54396,276;163340;4873;167936;422478;423045;463360;585818;427918;631296;;;;;;
54420,153;166153;2385;167936;423045;424017;463360;589198;426402;631296;;;;;;
54440,840;163153;5092;167936;424017;424272;463360;587170;429364;631296;;;;;;
54455,700;165860;1884;167936;424272;424992;463360;590132;426876;631296;;;;;;
54492,772;162652;1654;167936;424992;425296;463360;587644;426950;631296;;;;;;
54527,513;162119;7005;165888;425296;425711;463360;587415;432716;629248;;;;;;
54540,137;67231;384;166912;425712;426802;463360;492943;427186;630272;;;;;;
54540,147;384;0;166912;426802;361968;463360;427186;361968;630272;183157;182484;786432;610343;544452;1416704
54586,307;158720;6988;164864;361968;361969;463360;520688;368957;628224;;;;;;
54613,994;163660;928;165888;361969;363440;463360;525629;364368;629248;;;;;;
54655,214;157600;4501;165888;363488;363671;463360;521088;368172;629248;;;;;;
54688,926;161173;2783;165888;363674;364820;463360;524847;367603;629248;;;;;;
54699,059;159455;1122;166912;364820;365569;463360;524275;366691;630272;;;;;;
54706,472;159292;4262;166400;365569;365969;463360;524861;370231;629760;;;;;;
54726,227;162470;3825;166912;365969;366963;463360;528439;370788;630272;;;;;;
54775,040;162545;1666;166912;366963;368140;463360;529508;369806;630272;;;;;;
54789,195;160386;6030;165376;368140;368532;463360;528526;374562;628736;;;;;;
54813,933;163726;5673;166400;368532;369231;463360;532258;374904;629760;;;;;;
54822,468;163326;5973;165376;369231;369847;463360;532557;375820;628736;;;;;;
54823,720;162645;7952;164864;369847;373238;463360;532492;381190;628224;;;;;;
54832,892;164624;4247;165376;373238;375974;463360;537862;380221;628736;;;;;;
54840,636;159383;6296;164864;375974;376975;463360;535357;383271;628224;;;;;;
54846,218;161432;2932;165376;376975;378214;463360;538407;381146;628736;;;;;;
54859,748;158580;4003;165376;378214;379474;463360;536794;383477;628736;;;;;;
54890,293;159651;3796;166400;379474;380625;463360;539125;384421;629760;;;;;;
54917,604;160980;3012;165888;380625;381707;463360;541605;384719;629248;;;;;;
54988,288;160196;880;166400;381707;382402;463360;541903;383282;629760;;;;;;
55027,228;158576;2549;166400;382402;382899;463360;540978;385448;629760;;;;;;
55414,832;160237;3632;166912;382898;383083;463360;543135;386715;630272;;;;;;
55445,633;161840;1215;166400;383083;384251;463360;544923;385466;629760;;;;;;
55485,177;159423;5738;166912;384251;384666;463360;543674;390404;630272;;;;;;
55525,088;164458;3348;166912;384666;385658;463360;549124;389006;630272;;;;;;
55590,259;161757;2661;167424;386145;386952;463360;547902;389613;630784;;;;;;
55675,845;161893;2912;166912;386955;387799;463360;548848;390711;630272;;;;;;
55708,275;162144;1244;167424;387799;388479;463360;549943;389723;630784;;;;;;
55719,911;160988;7678;167424;388479;389513;463360;549467;397191;630784;;;;;;
55772,445;167422;1608;164352;389513;390996;463360;556935;392604;627712;;;;;;
55828,487;158280;3962;165888;390996;391639;463360;549276;395601;629248;;;;;;
55929,820;160634;1004;166400;391639;392375;463360;552273;393379;629760;;;;;;
55974,815;158700;6000;163840;392375;392719;463360;551075;398719;627200;;;;;;
56053,261;163696;1283;166400;392719;393335;463360;556415;394618;629760;;;;;;
56106,029;158467;2352;165888;393335;393854;463360;551802;396206;629248;;;;;;
56201,305;159536;2820;166912;393854;394326;463360;553390;397146;630272;;;;;;
56402,265;161028;5539;166400;394326;394326;463360;555354;399865;629760;;;;;;
56425,738;163747;4052;166912;394326;394326;463360;558073;398378;630272;;;;;;
56436,405;162260;2320;166400;394326;395030;463360;556586;397350;629760;;;;;;
56466,753;160528;3268;167424;395030;396214;463360;555558;399482;630784;;;;;;
56494,722;162500;4198;166912;396214;397102;463360;558714;401300;630272;;;;;;
56515,944;163430;1056;167424;397102;397985;463360;560532;399041;630784;;;;;;
56521,169;160800;928;167424;397985;398506;463360;558785;399434;630784;;;;;;
56594,252;160672;1154;167936;398506;398722;463360;559178;399876;631296;;;;;;
56614,625;161410;832;167424;398722;399082;463360;560132;399914;630784;;;;;;
56696,601;161088;799;167936;399082;399330;463360;560170;400129;631296;;;;;;
56745,290;161567;2612;167936;399330;399649;463360;560897;402261;631296;;;;;;
56754,905;163380;944;168448;399649;400522;463360;563029;401466;631808;;;;;;
56794,220;162736;2512;168448;400522;400657;463360;563258;403169;631808;;;;;;
56814,871;164304;6125;165888;400657;401333;463360;564961;407458;629248;;;;;;
56980,172;165869;3523;167424;401333;402596;463360;567202;406119;630784;;;;;;
56993,206;163267;6023;165888;402596;403635;463360;565863;409658;629248;;;;;;
57266,523;164743;3816;166912;403635;404875;463360;568378;408691;630272;;;;;;
57331,321;162536;3110;167424;404875;405622;463360;567411;408732;630784;;;;;;
57353,503;162854;3388;167424;405622;406510;463360;568476;409898;630784;;;;;;
57402,173;163132;5885;166912;406510;407093;463360;569642;412978;630272;;;;;;
57455,435;165629;3220;167424;407093;408310;463360;572722;411530;630784;;;;;;
57493,090;162964;3182;167936;408310;409102;463360;571274;412284;631296;;;;;;
57508,538;163438;897;167424;409102;410053;463360;572540;410950;630784;;;;;;
57520,497;161153;818;167936;410053;410317;463360;571206;411135;631296;;;;;;
57545,656;161586;896;167936;410317;410493;463360;571903;411389;631296;;;;;;
57570,544;161664;5601;166912;410493;410757;463360;572157;416358;630272;;;;;;
57653,198;165345;5632;165888;410757;411769;463360;576102;417401;629248;;;;;;
57678,464;165376;2162;166912;411769;412928;463360;577145;415090;630272;;;;;;
57755,506;160882;3843;166912;412928;413417;463360;573810;417260;630272;;;;;;
57916,776;162545;5697;166400;413416;414148;463360;575961;419845;629760;;;;;;
57941,757;164417;6893;165888;414148;415410;463360;578565;422303;629248;;;;;;
57958,209;165613;2305;166400;415410;416612;463360;581023;418917;629760;;;;;;
57970,793;159489;960;165888;416612;417429;463360;576101;418389;629248;;;;;;
57997,874;158144;4935;166400;417429;417540;463360;575573;422475;629760;;;;;;
58014,247;162631;1826;166400;417540;418381;463360;580171;420207;629760;;;;;;
58055,918;159522;1120;166400;418381;418724;463360;577903;419844;629760;;;;;;
58141,409;99306;1464;166400;418725;418941;463360;518031;420405;629760;;;;;;
58141,422;1464;0;166400;418941;367351;463360;420405;367351;629760;182700;182398;786432;603105;549749;1416192
58206,775;157696;7470;163840;367351;367351;463360;525047;374821;627200;;;;;;
58272,093;163044;7987;163840;367351;368543;463360;530395;376530;627200;;;;;;
58290,909;163635;5626;164352;368543;369369;463360;532178;374995;627712;;;;;;
58310,931;159226;3424;164352;369369;370440;463360;528595;373864;627712;;;;;;
58322,424;157024;1284;165376;370440;371900;463360;527464;373184;628736;;;;;;
58327,041;156420;768;164864;371900;372648;463360;528320;373416;628224;;;;;;
58329,970;155904;2384;165888;372648;373033;463360;528552;375417;629248;;;;;;
58342,689;158544;4019;165376;373033;373762;463360;531577;377781;628736;;;;;;
58365,690;160179;5825;165888;373762;374586;463360;533941;380411;629248;;;;;;
58375,513;162497;1484;165888;374586;375695;463360;537083;377179;629248;;;;;;
58383,112;158156;1396;165888;375695;376383;463360;533851;377779;629248;;;;;;
58393,971;158068;1920;165888;376383;376871;463360;534451;378791;629248;;;;;;
58430,031;158592;3440;166912;376871;377646;463360;535463;381086;630272;;;;;;
58439,145;161648;1600;166400;377646;378758;463360;539294;380358;629760;;;;;;
58465,462;159808;1360;167424;378758;379086;463360;538566;380446;630784;;;;;;
58484,710;160592;4129;166912;379086;379798;463360;539678;383927;630272;;;;;;
58494,632;163361;1417;167424;379798;380694;463360;543159;382111;630784;;;;;;
58507,879;161161;4388;167424;380694;381246;463360;541855;385634;630784;;;;;;
58532,394;164132;4177;167424;381246;382236;463360;545378;386413;630784;;;;;;
58553,317;163921;2356;167424;382236;383173;463360;546157;385529;630784;;;;;;
58558,670;162100;3336;167936;383173;383825;463360;545273;387161;631296;;;;;;
58565,048;163592;3204;167424;383825;385103;463360;547417;388307;630784;;;;;;
58574,840;163460;1199;168448;385103;386352;463360;548563;387551;631808;;;;;;
58582,790;162991;2384;168448;386352;386807;463360;549343;389191;631808;;;;;;
58599,429;164176;3812;168448;386807;389024;463360;550983;392836;631808;;;;;;
58612,615;165604;4981;166912;389024;390296;463360;554628;395277;630272;;;;;;
58648,284;166773;5196;167936;390296;391231;463360;557069;396427;631296;;;;;;
58664,258;165964;2639;167936;391231;392094;463360;557195;394733;631296;;;;;;
58673,016;163407;2495;168448;392094;392726;463360;555501;395221;631808;;;;;;
58693,638;163775;2516;167936;392726;393537;463360;556501;396053;631296;;;;;;
58711,469;163796;4805;167424;393537;394033;463360;557333;398838;630784;;;;;;
58727,486;165573;1567;167936;394033;395008;463360;559606;396575;631296;;;;;;
58754,290;162335;4885;167424;395008;395920;463360;557343;400805;630784;;;;;;
58772,995;165653;1244;167936;395920;396600;463360;561573;397844;631296;;;;;;
58791,910;162012;6372;165888;396600;397144;463360;558612;403516;629248;;;;;;
58802,954;165092;1389;166912;397144;398379;463360;562236;399768;630272;;;;;;
58876,171;160109;2980;167424;398379;398627;463360;558488;401607;630784;;;;;;
58914,420;162724;2340;167424;398627;399211;463360;561351;401551;630784;;;;;;
58984,382;162084;1024;167936;399211;399555;463360;561295;400579;631296;;;;;;
59001,546;161792;704;167936;399555;399931;463360;561347;400635;631296;;;;;;
59074,489;161472;960;167936;399931;400195;463360;561403;401155;631296;;;;;;
59085,104;161728;801;167936;400195;400538;463360;561923;401339;631296;;;;;;
59115,086;161569;4716;167936;400538;400699;463360;562107;405415;631296;;;;;;
59150,343;165484;4083;164864;400699;401347;463360;566183;405430;628224;;;;;;
59167,839;164851;4897;167424;401347;402365;463360;566198;407262;630784;;;;;;
59190,577;164641;1104;167424;402365;403197;463360;567006;404301;630784;;;;;;
59212,001;160848;3620;167424;403197;403645;463360;564045;407265;630784;;;;;;
59250,978;163364;3348;167424;403645;404309;463360;567009;407657;630784;;;;;;
59266,038;163092;1121;167936;404309;405301;463360;567401;406422;631296;;;;;;
59317,706;161889;2740;167936;405301;405549;463360;567190;408289;631296;;;;;;
59361,596;163508;2804;168448;405549;406197;463360;569057;409001;631808;;;;;;
59380,066;164596;1652;168448;406197;407101;463360;570793;408753;631808;;;;;;
59457,182;163444;3092;168960;407101;407285;463360;570545;410377;632320;;;;;;
59485,137;165908;5805;168960;407285;408092;463360;573193;413897;632320;;;;;;
59505,305;168621;3907;167936;408092;408992;463360;576713;412899;631296;;;;;;
59520,390;165699;2080;168448;408992;409759;463360;574691;411839;631808;;;;;;
59526,066;163872;1172;168448;409759;410487;463360;573631;411659;631808;;;;;;
59602,400;162964;3819;168448;410487;410839;463360;573451;414658;631808;;;;;;
59629,973;165611;5233;167424;410839;411568;463360;576450;416801;630784;;;;;;
59636,630;166001;1921;167936;411568;412615;463360;577569;414536;631296;;;;;;
59652,760;162689;2903;168448;412615;413240;463360;575304;416143;631808;;;;;;
59675,112;164183;1624;167936;413240;413871;463360;577423;415495;631296;;;;;;
59742,128;162904;6649;165376;413871;415182;463360;576775;421831;628736;;;;;;
59779,231;165369;1821;166912;415182;416592;463360;580551;418413;630272;;;;;;
59787,616;160541;2582;167424;416592;417337;463360;577133;419919;630784;;;;;;
59809,011;162326;2916;167424;417337;418485;463360;579663;421401;630784;;;;;;
59837,802;162660;3503;167936;418485;418909;463360;581145;422412;631296;;;;;;
59871,063;164271;3627;167936;418909;419701;463360;583180;423328;631296;;;;;;
59905,609;164395;3463;168448;419701;420439;463360;584096;423902;631808;;;;;;
59924,635;165255;4360;168448;420439;421239;463360;585694;425599;631808;;;;;;
59981,086;166152;6493;166400;421239;421912;463360;587391;428405;629760;;;;;;
59996,187;166237;2340;167424;421912;423106;463360;588149;425446;630784;;;;;;
60029,299;162066;1015;166912;423106;423866;463360;585172;424881;630272;;;;;;
60190,040;160759;3008;167424;423866;424147;463360;584625;427155;630784;;;;;;
60228,181;162752;4328;167936;424147;424659;463360;586899;428987;631296;;;;;;
60238,875;165096;1248;167936;424659;425789;463360;589755;427037;631296;;;;;;
60274,175;162016;4341;167936;425789;426245;463360;587805;430586;631296;;;;;;
60287,994;165109;2692;167936;426245;427045;463360;591354;429737;631296;;;;;;
60353,336;163240;3550;168448;427045;427526;463360;590285;431076;631808;;;;;;
60388,938;164830;1120;167936;427526;428334;463360;592356;429454;631296;;;;;;
60430,555;162400;3361;168448;428334;428630;463360;590734;431991;631808;;;;;;
60472,960;165153;736;168448;428630;429614;463360;593783;430350;631808;;;;;;
60500,829;162528;4213;168448;429614;429975;463360;592142;434188;631808;;;;;;
60514,208;166005;1666;168448;429975;431031;463360;595980;432697;631808;;;;;;
60524,736;163458;1023;168448;431031;431327;463360;594489;432350;631808;;;;;;
60549,193;162815;3128;168448;431327;431623;463360;594142;434751;631808;;;;;;
60611,712;164920;4281;167936;431623;432098;463360;596543;436379;631296;;;;;;
60629,197;166073;2756;168448;432098;432993;463360;598171;435749;631808;;;;;;
60648,854;164548;1040;168960;432993;433833;463360;597541;434873;632320;;;;;;
60668,166;163856;4389;167424;433833;434377;463360;597689;438766;630784;;;;;;
60673,674;167205;1280;168448;434377;435073;463360;601582;436353;631808;;;;;;
60682,542;163072;832;168448;435073;435745;463360;598145;436577;631808;;;;;;
60687,572;162624;736;168960;435745;435905;463360;598369;436641;632320;;;;;;
60699,871;163040;2148;168448;435905;436146;463360;598945;438294;631808;;;;;;
60750,371;164452;3283;168960;436146;436594;463360;600598;439877;632320;;;;;;
60773,726;166099;4785;167936;436594;437377;463360;602693;442162;631296;;;;;;
60793,217;167601;1377;168448;437377;438177;463360;604978;439554;631808;;;;;;
60806,054;163169;1255;168448;438177;438354;463360;601346;439609;631808;;;;;;
60816,908;163047;3524;168960;438354;438833;463360;601401;442357;632320;;;;;;
60856,933;166340;2232;168960;438833;439589;463360;605173;441821;632320;;;;;;
60862,153;165048;5816;166912;439589;440304;463360;604637;446120;630272;;;;;;
60870,210;166584;2570;167936;440304;441808;463360;606888;444378;631296;;;;;;
60874,788;163338;2900;168960;441808;442393;463360;605146;445293;632320;;;;;;
60886,876;165204;2016;168448;442393;443401;463360;607597;445417;631808;;;;;;
60892,415;164320;1024;168960;443401;444109;463360;607721;445133;632320;;;;;;
60897,771;163840;896;168960;444109;444340;463360;607949;445236;632320;;;;;;
60901,409;163712;1412;169472;444340;444676;463360;608052;446088;632832;;;;;;
60930,636;164740;4079;168960;444676;444980;463360;609416;449059;632320;;;;;;
60957,695;167407;3749;168960;444980;445956;463360;612387;449705;632320;;;;;;
60977,552;166565;736;168960;445956;447055;463360;612521;447791;632320;;;;;;
61030,830;163552;1036;168960;447055;447128;463360;610607;448164;632320;;;;;;
61047,699;163852;816;168960;447128;447536;463360;610980;448352;632320;;;;;;
61067,798;163632;784;168960;447536;447712;463360;611168;448496;632320;;;;;;
61090,020;163600;5283;168448;447712;447880;463360;611312;453163;631808;;;;;;
61105,556;168099;993;168448;447880;449123;463360;615979;450116;631808;;;;;;
61112,671;162785;1104;168448;449123;449275;463360;611908;450379;631808;;;;;;
61116,328;162896;768;168960;449275;449707;463360;612171;450475;632320;;;;;;
61154,894;163584;3188;168960;449707;449795;463360;613291;452983;632320;;;;;;
61164,813;166004;4348;167936;449795;450428;463360;615799;454776;631296;;;;;;
61177,069;166140;2997;168448;450428;450971;463360;616568;453968;631808;;;;;;
61208,728;164789;6653;164352;450971;453088;463360;615760;459741;627712;;;;;;
61215,637;164349;1995;166400;453088;454624;463360;617437;456619;629760;;;;;;
61222,120;159691;2632;167424;454624;455371;463360;614315;458003;630784;;;;;;
61233,757;161864;1614;166912;455371;456163;463360;617235;457777;630272;;;;;;
61245,220;160846;2772;167936;456163;456555;463360;617009;459327;631296;;;;;;
61251,447;163028;2976;167424;456555;457203;463360;619583;460179;630784;;;;;;
61262,902;163232;4683;167424;457203;457835;463360;620435;462518;630784;;;;;;
61269,816;165451;4641;167936;457835;459036;463360;623286;463677;631296;;;;;;
61282,653;165409;1170;167936;459036;460112;463360;624445;461282;631296;;;;;;
61292,039;161938;928;167936;460112;460320;463360;622050;461248;631296;;;;;;
61302,615;161696;1040;167936;460320;460616;463360;622016;461656;631296;;;;;;
61338,533;161808;2096;167936;460616;460976;463360;622424;463072;631296;;;;;;
61364,261;162864;5745;166400;460976;461272;463360;623840;467017;629760;;;;;;
61372,005;165489;3119;167424;461272;462720;463360;626761;465839;630784;;;;;;
61372,019;3119;0;167424;462720;389314;515584;465839;389314;683008;183473;182461;786432;649312;571775;1469440
61379,568;159744;2224;168448;389314;389315;515584;549058;391539;684032;;;;;;
61421,262;163504;3251;167936;389315;390355;515584;552819;393606;683520;;;;;;
61443,116;164531;3726;168448;390355;391070;515584;554886;394796;684032;;;;;;
61450,262;165518;3934;168448;391070;392014;515584;556588;395948;684032;;;;;;
61464,688;165726;2612;168960;392014;392829;515584;557740;395441;684544;;;;;;
61480,263;164916;5973;168448;392829;393221;515584;557745;399194;684032;;;;;;
61493,679;168277;3904;167424;393221;394061;515584;561498;397965;683008;;;;;;
61509,451;164672;3348;167936;394061;394657;515584;558733;398005;683520;;;;;;
61533,100;164116;896;168448;394657;395753;515584;558773;396649;684032;;;;;;
61628,817;162688;3524;168448;395753;395929;515584;558441;399453;684032;;;;;;
61678,728;165316;2820;168960;395929;396489;515584;561245;399309;684544;;;;;;
61699,275;165124;1283;168448;396489;397217;515584;561613;398500;684032;;;;;;
61719,581;163587;6069;166912;397217;397656;515584;560804;403725;682496;;;;;;
61734,100;166837;3041;167936;397656;398744;515584;564493;401785;683520;;;;;;
61752,541;163809;1568;168448;398744;399032;515584;562553;400600;684032;;;;;;
61762,688;163360;864;168448;399032;399648;515584;562392;400512;684032;;;;;;
61765,418;162656;3375;168448;399648;399992;515584;562304;403367;684032;;;;;;
61799,369;165167;512;168448;399992;401144;515584;565159;401656;684032;;;;;;
61818,926;162304;3125;168448;401144;401385;515584;563448;404510;684032;;;;;;
61847,227;164917;3768;168448;401385;401905;515584;566302;405673;684032;;;;;;
61911,558;165560;2372;168960;401905;402723;515584;567465;405095;684544;;;;;;
61927,105;164676;1938;168448;402723;403387;515584;567399;405325;684032;;;;;;
61944,394;164242;1200;168960;403387;403979;515584;567629;405179;684544;;;;;;
62035,936;164016;3214;168960;403979;404508;515584;567995;407722;684544;;;;;;
62140,908;166030;1136;168960;404508;405626;515584;570538;406762;684544;;;;;;
62172,491;163952;6133;168960;405626;407997;515584;569578;414130;684544;;;;;;
62188,269;168949;1136;165888;407997;409381;515584;576946;410517;681472;;;;;;
62204,559;160880;896;167424;409381;410093;515584;570261;410989;683008;;;;;;
62352,850;160640;3316;167936;410093;410461;515584;570733;413777;683520;;;;;;
62403,221;163572;4294;167424;410461;411212;515584;574033;415506;683008;;;;;;
62412,553;164550;992;167936;411212;412132;515584;575762;413124;683520;;;;;;
62431,535;161248;3332;167424;412132;412348;515584;573380;415680;683008;;;;;;
62449,658;163588;3393;167936;412348;413524;515584;575936;416917;683520;;;;;;
62455,780;164161;1120;167936;413524;413885;515584;577685;415005;683520;;;;;;
62459,312;161888;881;168448;413885;414661;515584;575773;415542;684032;;;;;;
62476,758;162673;5109;166912;414661;414934;515584;577334;420043;682496;;;;;;
62498,928;166901;960;167936;414934;415933;515584;581835;416893;683520;;;;;;
62501,941;161728;704;167936;415933;416421;515584;577661;417125;683520;;;;;;
62504,010;161472;1377;168448;416421;416541;515584;577893;417918;684032;;;;;;
62509,615;162657;3536;167936;416541;416958;515584;579198;420494;683520;;;;;;
62558,254;164816;3460;168448;416958;417630;515584;581774;421090;684032;;;;;;
62572,932;165252;1988;168448;417630;418206;515584;582882;420194;684032;;;;;;
62601,520;163780;3411;168448;418206;418621;515584;581986;422032;684032;;;;;;
62617,369;165203;4403;168448;418621;419150;515584;583824;423553;684032;;;;;;
62634,567;166195;1984;168448;419150;420117;515584;585345;422101;684032;;;;;;
62640,657;163776;3488;168448;420117;420797;515584;583893;424285;684032;;;;;;
62682,106;165280;5151;167424;420797;421173;515584;586077;426324;683008;;;;;;
62692,006;165919;5363;166400;421173;422196;515584;587092;427559;681984;;;;;;
62717,382;166131;1420;167424;422196;423692;515584;588327;425112;683008;;;;;;
62729,900;161164;4372;167424;423692;423924;515584;584856;428296;683008;;;;;;
62735,837;164116;3427;167936;423924;424842;515584;588040;428269;683520;;;;;;
62747,027;163683;3425;167424;424842;426109;515584;588525;429534;683008;;;;;;
62759,603;163681;1278;168448;426303;427655;515584;589984;428933;684032;;;;;;
62774,701;163070;6275;168448;427660;428079;515584;590730;434354;684032;;;;;;
62788,295;168067;4292;166400;428079;429215;515584;596146;433507;681984;;;;;;
62800,571;164036;3677;167424;429215;431167;515584;593251;434844;683008;;;;;;
62816,651;163421;3636;167936;431167;431791;515584;594588;435427;683520;;;;;;
62834,666;164404;5747;166912;431791;432263;515584;596195;438010;682496;;;;;;
62858,451;166515;2723;167936;432263;433590;515584;598778;436313;683520;;;;;;
62872,880;162979;3276;167424;433590;434023;515584;596569;437299;683008;;;;;;
62891,225;163532;1072;167936;434023;434671;515584;597555;435743;683520;;;;;;
62897,185;161840;1700;167936;434671;435039;515584;596511;436739;683520;;;;;;
62937,091;162237;2703;168448;435039;435319;515584;597276;438022;684032;;;;;;
62956,820;163840;4926;167936;435319;435671;515584;599159;440597;683520;;;;;;
62981,188;166206;1734;167936;435671;436805;515584;601877;438539;683520;;;;;;
63007,323;162502;2752;167936;436805;437392;515584;599307;440144;683520;;;;;;
63046,557;163520;3317;168448;437392;437959;515584;600912;441276;684032;;;;;;
63122,444;165109;6652;168448;437959;439582;515584;603068;446234;684032;;;;;;
63156,841;168444;1632;165376;439582;440487;515584;608026;442119;680960;;;;;;
63180,663;160352;1072;166912;440487;441038;515584;600839;442110;682496;;;;;;
63285,023;159792;2147;167424;441038;441054;515584;600830;443201;683008;;;;;;
63323,284;161379;2768;166912;441054;441982;515584;602433;444750;682496;;;;;;
63432,325;162000;6162;165888;441982;442390;515584;603982;448552;681472;;;;;;
63451,408;164882;3248;166912;442390;443433;515584;607272;446681;682496;;;;;;
63470,372;161968;1873;167424;443433;444297;515584;605401;446170;683008;;;;;;
63473,936;161617;2279;167424;444297;444649;515584;605914;446928;683008;;;;;;
63502,873;162023;6633;165888;444649;444905;515584;606672;451538;681472;;;;;;
63540,135;165353;5586;164352;444905;445779;515584;610258;451365;679936;;;;;;
63618,325;164306;864;166400;445779;446749;515584;610085;447613;681984;;;;;;
63678,069;158560;1024;166400;446749;447061;515584;605309;448085;681984;;;;;;
63777,312;158720;7218;164864;447061;447581;515584;605781;454799;680448;;;;;;
63796,246;163890;1722;165888;447581;448716;515584;611471;450438;681472;;;;;;
63829,114;158394;4779;165888;448716;449294;515584;607110;454073;681472;;;;;;
63853,784;161451;3203;165888;449294;449855;515584;610745;453058;681472;;;;;;
63868,175;159875;1057;166400;449855;450958;515584;609730;452015;681984;;;;;;
63897,443;158753;1860;166400;450958;451054;515584;609711;452914;681984;;;;;;
63903,049;159556;3290;167424;451054;451397;515584;610610;454687;683008;;;;;;
63926,386;162522;1943;166912;451397;452134;515584;613919;454077;682496;;;;;;
63943,774;161175;912;167424;452134;452920;515584;613309;453832;683008;;;;;;
63974,008;160656;5894;165888;452920;453088;515584;613576;458982;681472;;;;;;
64003,364;165638;1905;166912;453088;454224;515584;618726;456129;682496;;;;;;
64008,742;160625;976;166912;454224;454695;515584;614849;455671;682496;;;;;;
64016,321;159696;896;167424;454695;454895;515584;614391;455791;683008;;;;;;
64029,105;160640;608;167424;454895;455159;515584;615535;455767;683008;;;;;;
64036,062;160293;4037;167424;455159;455456;515584;615452;459493;683008;;;;;;
64046,766;163781;2966;167424;455456;456087;515584;619237;459053;683008;;;;;;
64124,259;162710;3582;167936;456087;456848;515584;618797;460430;683520;;;;;;
64145,489;164350;1059;167936;456848;457559;515584;621198;458618;683520;;;;;;
64215,773;161827;1184;168448;457559;457775;515584;619386;458959;684032;;;;;;
64236,550;162464;1056;167936;457775;458223;515584;620239;459279;683520;;;;;;
64261,147;162336;1601;168960;458223;458647;515584;620559;460248;684544;;;;;;
64274,855;163905;2755;168448;458647;459023;515584;622552;461778;684032;;;;;;
64314,672;165059;2926;168960;459023;459510;515584;624082;462436;684544;;;;;;
64325,469;165742;3012;168960;459510;460527;515584;625252;463539;684544;;;;;;
64383,862;165828;2354;169472;460527;461079;515584;626355;463433;685056;;;;;;
64459,097;165682;2097;168960;461079;461503;515584;626761;463600;684544;;;;;;
64474,682;165425;5609;167424;461503;462117;515584;626928;467726;683008;;;;;;
64488,892;167401;3988;168448;462117;463067;515584;629518;467055;684032;;;;;;
64511,111;165780;3908;168448;463067;463899;515584;628847;467807;684032;;;;;;
64527,224;165700;1472;168448;463899;464694;515584;629599;466166;684032;;;;;;
64542,462;163264;1024;168448;464694;465166;515584;627958;466190;684032;;;;;;
64552,154;162816;960;168448;465166;465486;515584;627982;466446;684032;;;;;;
64562,132;162752;3257;168960;465486;465766;515584;628238;469023;684544;;;;;;
64579,154;165475;1197;168448;465766;466574;515584;631241;467771;684032;;;;;;
64607,824;163501;5888;166912;466574;466822;515584;630075;472710;682496;;;;;;
64654,211;166656;4226;167936;466822;468001;515584;633478;472227;683520;;;;;;
64687,543;164994;3314;167936;468001;469145;515584;632995;472459;683520;;;;;;
64702,337;164082;3227;167936;469145;469489;515584;633227;472716;683520;;;;;;
64747,896;163995;960;168448;469489;470328;515584;633484;471288;684032;;;;;;
64771,388;162752;3556;168448;470328;470696;515584;633080;474252;684032;;;;;;
64784,566;165348;1353;168448;470696;471593;515584;636044;472946;684032;;;;;;
64800,431;163145;2125;168448;471593;471880;515584;634738;474005;684032;;;;;;
64812,812;163917;2314;168960;471880;472145;515584;635797;474459;684544;;;;;;
64821,402;165130;4171;168960;472145;472676;515584;637275;476847;684544;;;;;;
64832,941;166987;5052;167936;472676;473551;515584;639663;478603;683520;;;;;;
64838,088;166844;4548;166400;473551;474409;515584;640395;478957;681984;;;;;;
64847,393;166340;5407;166912;474409;476101;515584;640749;481508;682496;;;;;;
64855,942;165151;4253;167424;476101;477079;515584;641252;481332;683008;;;;;;
64871,224;163997;1758;167936;477079;478751;515584;641076;480509;683520;;;;;;
64887,956;162014;6517;166912;478751;479672;515584;640765;486189;682496;;;;;;
64916,522;166773;3050;167424;479672;482495;515584;646445;485545;683008;;;;;;
64920,966;162282;2272;166912;482495;483963;515584;644777;486235;682496;;;;;;
64972,997;75742;448;167424;483963;486047;515584;559705;486495;683008;;;;;;
64973,010;448;0;167424;486047;399146;515584;486495;399146;683008;183164;182494;786432;669659;581640;1469440
65052,533;159744;2766;167424;399146;399146;515584;558890;401912;683008;;;;;;
65075,873;162500;5486;166912;399147;399705;515584;561647;405191;682496;;;;;;
65091,494;165230;7607;167424;399705;400599;515584;564935;408206;683008;;;;;;
65126,722;167351;1698;165376;400599;401891;515584;567950;403589;680960;;;;;;
65141,278;159394;4572;166400;401891;402367;515584;561285;406939;681984;;;;;;
65175,696;162268;1601;166400;402367;403893;515584;564635;405494;681984;;;;;;
65181,751;159297;1489;166400;403893;404414;515584;563190;405903;681984;;;;;;
65195,650;159185;2428;166912;404414;404581;515584;563599;407009;682496;;;;;;
65204,200;160636;1404;166400;404581;405406;515584;565217;406810;681984;;;;;;
65213,877;159612;3872;167424;405406;406046;515584;565018;409918;683008;;;;;;
65220,638;163616;2128;167424;406046;409014;515584;569662;411142;683008;;;;;;
65286,320;161872;3965;167424;409014;409526;515584;570886;413491;683008;;;;;;
65319,225;163640;7224;167424;409526;410121;515584;573166;417345;683008;;;;;;
65341,313;166968;1428;166400;410121;411899;515584;577089;413327;681984;;;;;;
65380,085;160148;3850;166912;411899;412066;515584;572047;415916;682496;;;;;;
65387,884;162570;2477;167424;412066;413691;515584;574636;416168;683008;;;;;;
65396,045;161709;5720;166912;413691;414362;515584;575400;420082;682496;;;;;;
65407,582;164925;6268;165888;415917;418199;515584;580842;424467;681472;;;;;;
65417,148;163964;4728;166400;418202;420197;515584;582166;424925;681984;;;;;;
65427,893;162424;2897;166400;420197;422154;515584;582621;425051;681984;;;;;;
65445,270;160593;6016;166400;422154;422842;515584;582747;428858;681984;;;;;;
65461,488;163712;5528;166400;422842;425319;515584;586554;430847;681984;;;;;;
65490,399;163224;4268;166400;425319;428191;515584;588543;432459;681984;;;;;;
65502,504;161964;2919;166912;428191;429418;515584;590155;432337;682496;;;;;;
65509,829;161025;3699;166400;429418;429962;515584;590443;433661;681984;;;;;;
65525,879;161907;1024;166912;429962;430731;515584;591869;431755;682496;;;;;;
65536,906;159744;1072;166912;430731;431002;515584;590475;432074;682496;;;;;;
65553,053;159792;3640;167424;431002;431418;515584;590794;435058;683008;;;;;;
65569,848;162872;2894;166912;431418;432067;515584;594290;434961;682496;;;;;;
65578,495;162126;3796;167936;432067;433077;515584;594193;436873;683520;;;;;;
65608,252;164052;4227;167424;433077;433733;515584;597129;437960;683008;;;;;;
65622,767;164483;5860;166912;433733;434696;515584;598216;440556;682496;;;;;;
65642,729;165604;6016;165888;434696;436351;515584;600300;442367;681472;;;;;;
65653,501;165760;2405;166912;436351;439706;515584;602111;442111;682496;;;;;;
65659,045;161125;1200;166912;439706;441319;515584;600831;442519;682496;;;;;;
65687,572;159920;6073;165888;441319;441703;515584;601239;447776;681472;;;;;;
65727,521;163769;4983;166400;441703;442496;515584;605472;447479;681984;;;;;;
65734,094;162679;1522;166400;442496;443877;515584;605175;445399;681984;;;;;;
65751,315;159218;7766;165888;443877;444650;515584;603095;452416;681472;;;;;;
65772,955;165462;2646;165888;444650;446807;515584;610112;449453;681472;;;;;;
65782,387;159318;768;165888;446807;447222;515584;606125;447990;681472;;;;;;
65815,374;157440;2640;165888;447222;447574;515584;604662;450214;681472;;;;;;
65830,588;159312;800;165888;447574;448111;515584;606886;448911;681472;;;;;;
65912,881;157472;6132;165376;448111;448326;515584;605583;454458;680960;;;;;;
65925,884;162804;3954;165888;448326;449274;515584;611130;453228;681472;;;;;;
65939,338;160626;1584;166400;449274;450803;515584;609900;452387;681984;;;;;;
65943,459;158768;2895;165888;450803;451338;515584;609571;454233;681472;;;;;;
65960,349;160079;3907;166912;451338;452098;515584;611417;456005;682496;;;;;;
65970,634;162627;2516;166912;452098;452713;515584;614725;455229;682496;;;;;;
65985,105;161236;2544;167424;452713;453337;515584;613949;455881;683008;;;;;;
66018,180;162288;5787;165888;453337;454093;515584;615625;459880;681472;;;;;;
66030,119;165531;1056;166912;454093;455517;515584;619624;456573;682496;;;;;;
66041,354;159776;1542;166912;455517;455828;515584;615293;457370;682496;;;;;;
66134,410;160262;2547;167424;455828;455989;515584;616090;458536;683008;;;;;;
66148,730;162291;1088;167424;455989;456533;515584;618280;457621;683008;;;;;;
66200,045;160832;4280;167424;456533;456868;515584;617365;461148;683008;;;;;;
66237,353;164024;2095;167424;456868;457565;515584;620892;459660;683008;;;;;;
66254,423;161839;2579;168448;457565;458117;515584;619404;460696;684032;;;;;;
66264,034;163859;2819;167936;458117;458644;515584;621976;461463;683520;;;;;;
66289,555;164099;3641;168448;458644;459390;515584;622743;463031;684032;;;;;;
66307,052;165433;1364;168448;459390;460431;515584;624823;461795;684032;;;;;;
66350,877;163156;4464;168448;460431;460758;515584;623587;465222;684032;;;;;;
66371,503;166256;4005;168448;460758;461231;515584;627014;465236;684032;;;;;;
66382,845;165797;6626;165376;461231;462439;515584;627028;469065;680960;;;;;;
66389,828;165346;1936;166912;462439;463834;515584;627785;465770;682496;;;;;;
66405,150;160656;8185;163840;463834;465116;515584;624490;473301;679424;;;;;;
66411,583;163833;1953;165376;465116;466723;515584;628949;468676;680960;;;;;;
66418,166;157601;2730;165888;466723;467683;515584;624324;470413;681472;;;;;;
66431,145;158890;867;165376;467683;469862;515584;626573;470729;680960;;;;;;
66435,779;157027;4948;165888;469862;470006;515584;626889;474954;681472;;;;;;
66447,168;161620;3715;165888;470006;472242;515584;631626;475957;681472;;;;;;
66456,905;160387;3108;166912;472242;473081;515584;632629;476189;682496;;;;;;
66472,156;161316;3454;166400;473081;473640;515584;634397;477094;681984;;;;;;
66483,301;161662;2746;167424;473640;474985;515584;635302;477731;683008;;;;;;
66486,148;162490;2785;167424;474985;475889;515584;637475;478674;683008;;;;;;
66497,169;162529;4671;167936;475889;477296;515584;638418;481967;683520;;;;;;
66513,887;165439;2976;167936;477296;478280;515584;642735;481256;683520;;;;;;
66531,109;163523;1380;167936;478280;479128;515584;641803;480508;683520;;;;;;
66545,941;162148;4484;167936;479128;479593;515584;641276;484077;683520;;;;;;
66553,178;165252;3040;167936;479593;480272;515584;644845;483312;683520;;;;;;
66568,794;163808;3885;167936;480272;481012;515584;644080;484897;683520;;;;;;
66592,054;164653;6036;166400;481012;481666;515584;645665;487702;681984;;;;;;
66620,317;165780;1132;167424;481666;483045;515584;647446;484177;683008;;;;;;
66631,534;160876;4088;167936;483045;483413;515584;643921;487501;683520;;;;;;
66636,510;164344;1472;167424;483413;484332;515584;647757;485804;683008;;;;;;
66650,368;161728;3964;167936;484332;485105;515584;646060;489069;683520;;;;;;
66660,836;164732;2096;167936;485105;486261;515584;649837;488357;683520;;;;;;
66668,978;162864;1746;167936;486261;486561;515584;649125;488307;683520;;;;;;
66672,869;162514;1767;167936;486561;487281;515584;649075;489048;683520;;;;;;
66677,631;162535;3928;168448;487281;488056;515584;649816;491984;684032;;;;;;
66697,756;165720;4792;166912;488056;488800;515584;653776;493592;682496;;;;;;
66780,057;166584;1822;167936;488800;490104;515584;655384;491926;683520;;;;;;
66848,802;162590;7163;167936;490104;491500;515584;652694;498663;683520;;;;;;
66866,988;167931;7139;163840;491500;492595;515584;659431;499734;679424;;;;;;
66882,679;163811;5661;162816;492595;493506;515584;656406;499167;678400;;;;;;
66883,952;162333;8360;163328;493506;496201;515584;655839;504561;678912;;;;;;
66906,057;161960;2711;164352;496201;499889;515584;658161;502600;679936;;;;;;
66938,025;156311;3140;164864;499889;500980;515584;656200;504120;680448;;;;;;
66949,693;157764;768;164864;500980;501924;515584;658744;502692;680448;;;;;;
66971,670;155392;1872;165376;501924;502141;515584;657316;504013;680960;;;;;;
67038,812;157008;2658;164864;502141;502301;515584;659149;504959;680448;;;;;;
67076,583;157794;2788;165888;502301;503150;515584;660095;505938;681472;;;;;;
67098,586;159460;3843;165888;503150;503606;515584;662610;507449;681472;;;;;;
67112,952;160515;3961;166912;503606;504277;515584;664121;508238;682496;;;;;;
67123,937;162169;1229;166400;504277;505292;515584;666446;506521;681984;;;;;;
67129,046;159437;1766;166912;505292;505575;515584;664729;507341;682496;;;;;;
67136,300;160486;4868;166912;505575;506088;515584;666061;510956;682496;;;;;;
67157,114;163588;1955;166912;506088;506745;515584;669676;508700;682496;;;;;;
67191,762;160675;2560;166912;506745;507192;515584;667420;509752;682496;;;;;;
67234,005;161280;1315;167424;507192;508369;515584;668472;509684;683008;;;;;;
67265,046;161059;2752;167424;508369;508807;515584;669428;511559;683008;;;;;;
67348,293;162496;5176;166912;508807;509608;515584;671303;514784;682496;;;;;;
67403,821;164920;1008;167424;509608;510983;515584;674528;511991;683008;;;;;;
67433,383;160752;1296;167936;510983;511255;515584;671735;512551;683520;;;;;;
67499,436;161552;1617;167424;511255;511288;515584;672807;512905;683008;;;;;;
67531,900;161873;6404;165888;511288;511795;515584;673161;518199;681472;;;;;;
67542,001;165124;1276;166912;511795;513326;515584;676919;514602;682496;;;;;;
67557,356;159996;4419;166400;513326;513557;515584;673322;517976;681984;;;;;;
67557,369;4419;0;166400;513557;424095;548352;517976;424095;714752;183183;182511;786432;701159;606606;1501184
67572,365;158720;2192;166912;424095;424095;548352;582815;426287;715264;;;;;;
67588,227;160912;1313;167424;424095;425152;548352;585007;426465;715776;;;;;;
67613,068;161057;1328;167424;425152;425264;548352;586209;426592;715776;;;;;;
67636,200;161072;2234;167936;425264;425993;548352;586336;428227;716288;;;;;;
67640,107;163002;3730;167936;425993;426769;548352;588995;430499;716288;;;;;;
67647,340;101682;6120;166912;426769;428009;548352;528451;434129;715264;;;;;;
67647,352;6120;0;166912;428009;423476;548352;434129;423476;715264;182511;182511;786432;616640;605987;1501696
67668,618;159744;3805;167424;423476;423477;548352;583220;427282;715776;;;;;;
67679,391;163549;1280;167424;423477;424774;548352;587026;426054;715776;;;;;;
67690,333;161024;1232;167424;424774;425214;548352;585798;426446;715776;;;;;;
67696,295;160976;896;167936;425214;425606;548352;586190;426502;716288;;;;;;
67728,487;161664;4642;165888;425606;426087;548352;587270;430729;714240;;;;;;
67737,543;165410;3996;167424;426087;427227;548352;591497;431223;715776;;;;;;
67780,551;163740;3699;167424;427227;428023;548352;590967;431722;715776;;;;;;
67801,918;163443;2064;167936;428023;429199;548352;591466;431263;716288;;;;;;
67827,904;162320;4618;167424;429199;429954;548352;591519;434572;715776;;;;;;
67834,130;164874;4014;167936;429954;430834;548352;594828;434848;716288;;;;;;
67856,252;164782;1360;167936;430834;433646;548352;595616;435006;716288;;;;;;
67871,496;162128;6951;165888;433646;434202;548352;595774;441153;714240;;;;;;
67883,130;165671;1588;166912;434202;436098;548352;599873;437686;715264;;;;;;
67891,164;160308;5478;165888;436098;436562;548352;596406;442040;714240;;;;;;
67904,999;163174;4265;166400;436562;439506;548352;599736;443771;714752;;;;;;
67925,104;161961;2301;166912;439506;440225;548352;601467;442526;715264;;;;;;
67958,855;161021;4727;166912;440225;440841;548352;601246;445568;715264;;;;;;
67996,318;163447;1495;166912;440841;441852;548352;604288;443347;715264;;;;;;
68008,703;160215;1519;166912;441852;442459;548352;602067;443978;715264;;;;;;
68041,548;160239;5791;165376;442459;442980;548352;602698;448771;713728;;;;;;
68053,484;163487;3696;166400;442980;444054;548352;606467;447750;714752;;;;;;
68057,400;161392;2416;167424;444054;445294;548352;605446;447710;715776;;;;;;
68066,184;161596;1578;166912;445294;445846;548352;606890;447424;715264;;;;;;
68098,878;160810;5821;166400;445846;446294;548352;606656;452115;714752;;;;;;
68120,001;164541;4237;166912;446294;447350;548352;610835;451587;715264;;;;;;
68141,215;162957;3703;167424;447350;450162;548352;610307;453865;715776;;;;;;
68167,673;162935;2125;166912;450162;452973;548352;613097;455098;715264;;;;;;
68189,827;161357;7648;165376;452973;453419;548352;614330;461067;713728;;;;;;
68199,970;165344;1186;166400;453419;454949;548352;618763;456135;714752;;;;;;
68206,737;158882;1072;166400;454949;455341;548352;613831;456413;714752;;;;;;
68249,923;158768;3400;166400;455341;455629;548352;614109;459029;714752;;;;;;
68267,032;161096;7576;164864;455629;456169;548352;616725;463745;713216;;;;;;
68290,420;164248;3182;165888;456169;457752;548352;620417;460934;714240;;;;;;
68308,530;159854;2070;166400;457752;458208;548352;617606;460278;714752;;;;;;
68354,002;159254;704;165888;458208;458784;548352;617462;459488;714240;;;;;;
68379,838;157888;5791;165376;458784;459057;548352;616672;464848;713728;;;;;;
68405,956;162463;1248;165888;459057;460319;548352;621520;461567;714240;;;;;;
68428,224;157920;7019;164864;460319;461079;548352;618239;468098;713216;;;;;;
68449,643;162667;2350;165376;461079;462503;548352;623746;464853;713728;;;;;;
68462,410;157998;2186;165888;462503;463311;548352;620501;465497;714240;;;;;;
68476,524;158858;672;165888;463311;465078;548352;622169;465750;714240;;;;;;
68490,891;157344;3297;166400;465078;465318;548352;622422;468615;714752;;;;;;
68515,268;160481;2217;165888;465318;465886;548352;625799;468103;714240;;;;;;
68547,250;159401;2176;167424;465886;466755;548352;625287;468931;715776;;;;;;
68587,871;161408;2205;166912;466755;467724;548352;628163;469929;715264;;;;;;
68601,987;161437;1024;167936;467724;468059;548352;629161;469083;716288;;;;;;
68625,636;161280;4092;167424;468059;468828;548352;629339;472920;715776;;;;;;
68639,486;164348;2130;167936;468828;470249;548352;633176;472379;716288;;;;;;
68648,156;162386;3971;167424;470249;470696;548352;632635;474667;715776;;;;;;
68679,991;164227;2910;168448;470696;472440;548352;634923;475350;716800;;;;;;
68696,441;164181;3499;167936;472440;473256;548352;636621;476755;716288;;;;;;
68713,525;164779;2786;168960;473256;474063;548352;638035;476849;717312;;;;;;
68733,082;165090;960;168448;474063;474575;548352;639153;475535;716800;;;;;;
68739,707;163264;896;168960;474575;475031;548352;637839;475927;717312;;;;;;
68767,204;163712;1759;168960;475031;475296;548352;638743;477055;717312;;;;;;
68889,151;164575;2976;168960;475296;475967;548352;639871;478943;717312;;;;;;
68971,799;165792;960;168960;475967;476324;548352;641759;477284;717312;;;;;;
69035,899;163776;6072;166912;476324;476651;548352;640100;482723;715264;;;;;;
69052,583;166840;992;167936;476651;478147;548352;643491;479139;716288;;;;;;
69066,658;161327;1231;168448;478147;478355;548352;639474;479586;716800;;;;;;
69099,210;163023;5098;166912;478355;478811;548352;641378;483909;715264;;;;;;
69165,492;166890;4862;166912;478811;479807;548352;645701;484669;715264;;;;;;
69212,120;164606;2733;167424;479807;480279;548352;644413;483012;715776;;;;;;
69225,094;162477;2667;168448;480279;480743;548352;642756;483410;716800;;;;;;
69251,406;163947;5285;167936;480743;481326;548352;644690;486611;716288;;;;;;
69268,008;166534;2623;167936;481326;482095;548352;647860;484718;716288;;;;;;
69290,555;163391;2403;167936;482095;482527;548352;645486;484930;716288;;;;;;
69335,844;163171;5985;166400;482527;483258;548352;645698;489243;714752;;;;;;
69361,677;165729;7188;167424;483258;484502;548352;648987;491690;715776;;;;;;
69380,030;166932;2150;166400;484502;486963;548352;651434;489113;714752;;;;;;
69384,632;160870;3108;166912;486963;487331;548352;647833;490439;715264;;;;;;
69403,340;161828;4760;166912;487331;489155;548352;649159;493915;715264;;;;;;
69416,810;163480;1132;166912;489155;490635;548352;652635;491767;715264;;;;;;
69423,075;159852;1365;166912;490635;490955;548352;650487;492320;715264;;;;;;
69436,330;160085;1024;166912;490955;491376;548352;651040;492400;715264;;;;;;
69463,481;159744;4001;167424;491376;491680;548352;651120;495681;715776;;;;;;
69474,082;163745;3395;167424;491680;492265;548352;655425;495660;715776;;;;;;
69484,558;163139;1342;167936;492265;493513;548352;655404;494855;716288;;;;;;
69502,867;161598;1344;167424;493513;494064;548352;655111;495408;715776;;;;;;
69531,444;161600;2484;168448;494064;494488;548352;655664;496972;716800;;;;;;
69573,158;163764;3268;167936;494488;495000;548352;658252;498268;716288;;;;;;
69629,925;164548;904;168448;495000;495927;548352;659548;496831;716800;;;;;;
69667,167;162696;896;168448;495927;496215;548352;658623;497111;716800;;;;;;
69689,333;162688;6650;165376;496215;496953;548352;658903;503603;713728;;;;;;
69703,628;165370;1248;166912;496953;497825;548352;662323;499073;715264;;;;;;
69723,210;159968;784;167424;497825;498393;548352;657793;499177;715776;;;;;;
69728,070;160528;3875;167424;498393;498546;548352;658921;502421;715776;;;;;;
69734,659;163619;2166;167936;498546;499784;548352;662165;501950;716288;;;;;;
69744,171;162422;1810;167424;499784;500176;548352;662206;501986;715776;;;;;;
69769,993;162066;3188;168448;500176;500560;548352;662242;503748;716800;;;;;;
69777,049;164468;1891;167936;500560;501640;548352;665028;503531;716288;;;;;;
69786,895;163171;3796;168448;501640;501832;548352;664811;505628;716800;;;;;;
69816,416;165588;2180;168448;501832;502632;548352;667420;504812;716800;;;;;;
69847,174;163972;608;168960;502632;502736;548352;666604;503344;717312;;;;;;
69884,326;163424;1436;168960;502736;502913;548352;666160;504349;717312;;;;;;
69906,679;164252;832;168960;502913;503797;548352;667165;504629;717312;;;;;;
69941,787;163648;3226;168960;503797;503909;548352;667445;507135;717312;;;;;;
69968,822;166042;3732;168960;503909;504182;548352;669951;507914;717312;;;;;;
69977,206;166548;1329;168960;504182;504437;548352;670730;505766;717312;;;;;;
69977,709;164145;4816;167936;504437;504717;548352;668582;509533;716288;;;;;;
69998,762;166608;1198;168448;504717;509457;548352;671325;510655;716800;;;;;;
70082,364;162990;1522;168960;509457;509809;548352;672447;511331;717312;;;;;;
70100,900;163826;3155;168448;509809;510194;548352;673635;513349;716800;;;;;;
70158,127;165459;2316;169472;510194;511185;548352;675653;513501;717824;;;;;;
70180,459;165644;448;168960;511185;513017;548352;676829;513465;717312;;;;;;
70207,770;163776;1603;169472;513017;513209;548352;676793;514812;717824;;;;;;
70213,284;165443;5600;164864;513209;518322;548352;678652;523922;713216;;;;;;
70250,439;164832;4915;163328;518322;523482;548352;683154;528397;711680;;;;;;
70281,777;162611;928;166400;523482;525945;548352;686093;526873;714752;;;;;;
70325,428;158624;4411;166400;525945;526113;548352;684569;530524;714752;;;;;;
70339,225;162107;3889;166400;526113;526988;548352;688220;530877;714752;;;;;;
70352,280;161585;4024;166912;526988;527796;548352;688573;531820;715264;;;;;;
70364,018;162744;4083;166912;527796;528285;548352;690540;532368;715264;;;;;;
70370,681;162803;5044;166912;528285;529380;548352;691088;534424;715264;;;;;;
70382,437;163764;3873;166912;529380;531168;548352;693144;535041;715264;;;;;;
70392,153;162593;1376;167424;531168;531936;548352;693761;533312;715776;;;;;;
70399,897;161120;1376;167424;531936;532536;548352;693056;533912;715776;;;;;;
70413,524;161120;1120;167424;532536;532824;548352;693656;533944;715776;;;;;;
70426,812;160864;1539;167424;532824;533424;548352;693688;534963;715776;;;;;;
70451,936;161283;4036;167424;533424;534000;548352;694707;538036;715776;;;;;;
70488,151;163780;2692;167424;534000;534666;548352;697780;537358;715776;;;;;;
70615,871;162436;5334;166912;534666;535218;548352;697102;540552;715264;;;;;;
70634,616;165078;2156;167424;535218;536385;548352;700296;538541;715776;;;;;;
70671,419;161900;1746;167936;536385;536860;548352;698285;538606;716288;;;;;;
70725,465;162514;1976;167936;536860;537373;548352;699374;539349;716288;;;;;;
70737,538;162744;5697;166400;537373;537893;548352;700117;543590;714752;;;;;;
70776,685;165441;848;167424;537893;542612;548352;703334;543460;715776;;;;;;
70817,162;160592;3440;167936;542612;542932;548352;703204;546372;716288;;;;;;
70853,654;163696;4682;167424;542932;543428;548352;706628;548110;715776;;;;;;
70861,280;164938;896;167424;543428;544388;548352;708366;545284;715776;;;;;;
70897,592;160640;896;167424;544388;544940;548352;705028;545836;715776;;;;;;
70922,978;160640;961;167936;544940;545220;548352;705580;546181;716288;;;;;;
70937,106;161729;3393;167936;545220;545444;548352;706949;548837;716288;;;;;;
70937,120;3393;0;167936;545444;420824;543232;548837;420824;711168;183233;182728;786432;732070;603552;1497600
70985,996;160768;4996;166912;420824;420824;543232;581592;425820;710144;;;;;;
71017,736;164740;1095;167424;420824;422992;543232;585564;424087;710656;;;;;;
71109,354;160839;7297;165376;422992;423393;543232;583831;430690;708608;;;;;;
71121,523;164993;4847;166400;423393;424539;543232;588386;429386;709632;;;;;;
71127,721;162543;1088;166400;424539;425656;543232;587082;426744;709632;;;;;;
71138,408;158784;2190;166400;425656;426336;543232;584440;428526;709632;;;;;;
71149,961;159886;1712;166912;426336;427232;543232;586222;428944;710144;;;;;;
71215,358;160432;3235;166912;427232;427585;543232;587664;430820;710144;;;;;;
71268,878;161955;2337;167936;427585;428592;543232;589540;430929;711168;;;;;;
71334,142;162593;1775;167424;428592;428992;543232;591185;430767;710656;;;;;;
71403,395;162031;6370;165888;428992;429440;543232;591023;435810;709120;;;;;;
71421,106;165090;3461;166912;429440;430355;543232;594530;433816;710144;;;;;;
71437,453;162181;3316;167936;430355;430947;543232;592536;434263;711168;;;;;;
71444,597;163572;1837;167424;430947;431619;543232;594519;433456;710656;;;;;;
71461,954;162093;992;167936;431619;432291;543232;593712;433283;711168;;;;;;
71482,370;161760;3653;167936;432291;432515;543232;594051;436168;711168;;;;;;
71489,099;164421;992;167936;432515;433578;543232;596936;434570;711168;;;;;;
71543,311;161760;1315;167936;433578;433938;543232;595338;435253;711168;;;;;;
71597,797;162083;4420;167424;433938;434447;543232;596021;438867;710656;;;;;;
71674,547;165188;4450;167936;434447;435463;543232;599635;439913;711168;;;;;;
71708,107;165218;1645;167936;435463;436661;543232;600681;438306;711168;;;;;;
71717,055;162413;864;167936;436661;436980;543232;599074;437844;711168;;;;;;
71740,274;161632;2200;168448;436980;437269;543232;598612;439469;711680;;;;;;
71771,178;163480;800;167936;437269;438098;543232;600749;438898;711168;;;;;;
71793,804;162080;2413;168960;438098;438330;543232;600178;440743;712192;;;;;;
71828,399;164717;5749;168448;438330;438938;543232;603047;444687;711680;;;;;;
71843,085;168053;880;167424;438938;440250;543232;606991;441130;710656;;;;;;
71952,070;161648;3953;167936;440250;440491;543232;601898;444444;711168;;;;;;
71980,944;164721;2834;168448;440491;441275;543232;605212;444109;711680;;;;;;
72009,917;164114;1788;167936;441275;442325;543232;605389;444113;711168;;;;;;
72019,817;163068;1408;168960;442325;442652;543232;605393;444060;712192;;;;;;
72066,971;163712;1701;168448;442652;443913;543232;606364;445614;711680;;;;;;
72094,083;164005;1036;168960;443913;445035;543232;607918;446071;712192;;;;;;
72112,894;163852;4436;167424;445035;445603;543232;608887;450039;710656;;;;;;
72122,611;167252;1293;168960;445603;446907;543232;612855;448200;712192;;;;;;
72130,249;163597;960;168448;446907;447428;543232;610504;448388;711680;;;;;;
72171,507;163264;4376;167936;447428;447756;543232;610692;452132;711168;;;;;;
72186,972;166168;1681;168448;447756;449549;543232;613924;451230;711680;;;;;;
72207,203;163473;2899;168960;449549;449990;543232;613022;452889;712192;;;;;;
72235,477;165715;6143;168960;449990;453004;543232;615705;459147;712192;;;;;;
72236,785;168959;6128;163840;453004;459181;543232;621963;465309;707072;;;;;;
72247,924;163824;6368;160256;459181;465285;543232;623005;471653;703488;;;;;;
72266,896;159968;4429;163840;465285;471462;543232;625253;475891;707072;;;;;;
72280,554;158029;1248;164352;471462;473014;543232;629491;474262;707584;;;;;;
72283,779;154848;2880;164864;473014;473158;543232;627862;476038;708096;;;;;;
72316,861;156992;2192;164352;473158;473942;543232;630150;476134;707584;;;;;;
72327,366;156304;1875;165376;473942;475107;543232;630246;476982;708608;;;;;;
72344,519;157523;2588;165376;475107;475650;543232;632630;478238;708608;;;;;;
72398,131;158236;4329;166400;475650;478018;543232;633886;482347;709632;;;;;;
72409,091;161513;1281;165888;478018;479189;543232;639531;480470;709120;;;;;;
72444,070;158465;5398;165376;479189;479388;543232;637654;484786;708608;;;;;;
72453,670;162070;8280;165376;479388;479685;543232;641458;487965;708608;;;;;;
72456,961;164952;9664;162304;479685;485176;543232;644637;494840;705536;;;;;;
72670,456;162240;2352;155136;485176;485440;543232;647416;487792;698368;;;;;;
72696,376;154919;2321;163840;485440;485801;543232;640359;488122;707072;;;;;;
72773,584;154897;1121;163840;485801;486253;543232;640698;487374;707072;;;;;;
72818,165;153697;6329;163328;486253;486596;543232;639950;492925;706560;;;;;;
72833,381;158905;4764;163840;486596;487592;543232;645501;492356;707072;;;;;;
72893,154;157340;2083;164864;487592;488140;543232;644932;490223;708096;;;;;;
72921,448;156195;3313;164352;488140;488874;543232;644335;492187;707584;;;;;;
72950,726;157425;3220;165376;488874;489419;543232;646299;492639;708608;;;;;;
73059,355;158868;912;165376;489419;490354;543232;648287;491266;708608;;;;;;
73066,409;156560;704;165888;490354;490762;543232;646914;491466;709120;;;;;;
73146,256;157376;3187;165888;490762;490851;543232;648138;494038;709120;;;;;;
73181,795;159859;3912;166400;490851;491506;543232;650710;495418;709632;;;;;;
73205,854;161608;960;166400;491506;492530;543232;653114;493490;709632;;;;;;
73275,930;158656;3107;167424;492530;492826;543232;651186;495933;710656;;;;;;
73532,878;162339;1348;166912;492826;493778;543232;655165;495126;710144;;;;;;
73706,393;160580;896;167424;493778;494225;543232;654358;495121;710656;;;;;;
73758,037;160640;4184;167424;494225;494561;543232;654865;498745;710656;;;;;;
73789,604;163928;1456;167424;494561;495556;543232;658489;497012;710656;;;;;;
73816,013;161200;3012;167424;495556;496116;543232;656756;499128;710656;;;;;;
73843,499;162756;1315;167936;496116;496885;543232;658872;498200;711168;;;;;;
73857,137;162083;1088;167936;496885;497300;543232;658968;498388;711168;;;;;;
73894,081;161856;4057;167424;497300;497756;543232;659156;501813;710656;;;;;;
73928,272;164825;2253;167936;497756;498485;543232;662581;500738;711168;;;;;;
74000,259;163021;2577;168960;498485;499071;543232;661506;501648;712192;;;;;;
74077,518;164881;5185;168448;499071;499320;543232;663952;504505;711680;;;;;;
74108,602;167489;1600;168448;499320;500650;543232;666809;502250;711680;;;;;;
74113,974;163392;992;168448;500650;501265;543232;664042;502257;711680;;;;;;
74204,571;162784;6442;166400;501265;501514;543232;664049;507956;709632;;;;;;
74248,691;166128;5825;165888;501513;502363;543232;667641;508188;709120;;;;;;
74274,449;165569;1597;166912;502363;503515;543232;667932;505112;710144;;;;;;
74280,342;160317;2692;166912;503515;504044;543232;663832;506736;710144;;;;;;
74314,664;161412;6889;165376;504044;504365;543232;665456;511254;708608;;;;;;
74346,250;164585;1890;166400;504365;506016;543232;668950;507906;709632;;;;;;
74358,280;159586;2683;166912;506016;506487;543232;665602;509170;710144;;;;;;
74411,167;161403;4769;166912;506487;507465;543232;667890;512234;710144;;;;;;
74431,175;163489;1506;166912;507465;509410;543232;670954;510916;710144;;;;;;
74462,053;160226;3449;166912;509410;509619;543232;669636;513068;710144;;;;;;
74496,525;161987;3120;167936;509618;510575;543232;671605;513695;711168;;;;;;
74514,931;163376;3384;167424;510575;511530;543232;673951;514914;710656;;;;;;
74538,367;163640;3846;168448;511530;512105;543232;675170;515951;711680;;;;;;
74538,411;7069;224;167936;512105;513853;543232;519174;514077;711168;;;;;;
74538,424;224;0;167936;513853;423963;543232;514077;423963;711168;184149;182724;786432;698226;606687;1497600
74587,427;161280;3362;168448;423963;423963;543232;585243;427325;711680;;;;;;
74606,065;164642;4260;167936;423963;425203;543232;588605;429463;711168;;;;;;
74654,317;165540;4312;167424;425203;425755;543232;590743;430067;710656;;;;;;
74887,017;165080;7163;167936;425755;427062;543232;590835;434225;711168;;;;;;
74985,696;167931;4964;164864;427062;430331;543232;594993;435295;708096;;;;;;
74998,483;162660;4808;166400;430331;431317;543232;592991;436125;709632;;;;;;
75012,482;162504;1888;166912;431317;432656;543232;593821;434544;710144;;;;;;
75039,636;160096;912;166400;432656;433056;543232;592752;433968;709632;;;;;;
75067,054;159120;2788;166912;433056;433304;543232;592176;436092;710144;;;;;;
75087,068;161508;780;166912;433304;434393;543232;594812;435173;710144;;;;;;
75208,824;159500;3690;167424;434393;434729;543232;593893;438419;710656;;;;;;
75302,943;162922;4311;166912;434729;435524;543232;597651;439835;710144;;;;;;
75367,606;163543;1908;167424;435524;436325;543232;599067;438233;710656;;;;;;
75419,216;161652;7165;166912;436325;436664;543232;597977;443829;710144;;;;;;
75454,341;166909;5750;164864;436664;437467;543232;603573;443217;708096;;;;;;
75480,477;162422;3573;165888;437467;438395;543232;599889;441968;709120;;;;;;
75495,129;160245;3396;166912;438395;438909;543232;598640;442305;710144;;;;;;
75526,959;161604;4086;166400;438909;439765;543232;600513;443851;709632;;;;;;
75536,173;162294;5413;166400;439765;440318;543232;602059;445731;709632;;;;;;
75541,849;164133;1440;166912;440318;442248;543232;604451;443688;710144;;;;;;
75555,125;160160;3113;167424;442248;443081;543232;602408;446194;710656;;;;;;
75578,954;162345;3204;166912;443081;443667;543232;605426;446871;710144;;;;;;
75586,976;162436;768;167424;443667;444858;543232;606103;445626;710656;;;;;;
75597,987;160512;6256;166400;444858;445019;543232;605370;451275;709632;;;;;;
75615,551;166000;2549;166912;445019;446381;543232;611019;448930;710144;;;;;;
75624,480;161269;4076;166912;446381;447244;543232;607650;451320;710144;;;;;;
75656,674;162796;3704;167424;447244;448328;543232;610040;452032;710656;;;;;;
75693,413;163448;1676;167424;448328;449328;543232;611776;451004;710656;;;;;;
75711,866;161420;1312;167936;449328;450359;543232;610748;451671;711168;;;;;;
75735,813;162080;3919;167936;450359;450904;543232;612439;454823;711168;;;;;;
75791,501;164687;3170;168448;450904;451856;543232;615591;455026;711680;;;;;;
75853,914;164450;6645;167936;451856;452674;543232;616306;459319;711168;;;;;;
75856,628;167925;7152;163840;452674;458188;543232;620599;465340;707072;;;;;;
76008,921;163824;6988;163840;458188;465317;543232;622012;472305;707072;;;;;;
76204,537;163660;8542;162816;465317;467876;543232;628977;476418;706048;;;;;;
76213,215;160094;5744;157696;467876;468773;543232;627970;474517;700928;;;;;;
76266,267;157296;1868;163328;468773;473665;543232;626069;475533;706560;;;;;;
76284,377;153420;7100;163328;473665;474039;543232;627085;481139;706560;;;;;;
76308,311;158652;1708;163328;474039;476090;543232;632691;477798;706560;;;;;;
76356,774;153260;3662;163328;476090;476970;543232;629350;480632;706560;;;;;;
76377,522;154867;1383;163840;476970;477489;543232;631837;478872;707072;;;;;;
76399,796;153959;7485;160256;477489;477921;543232;631448;485406;703488;;;;;;
76429,067;160061;6181;163328;477921;479072;543232;637982;485253;706560;;;;;;
76448,704;157733;2770;163328;479072;480183;543232;636805;482953;706560;;;;;;
76465,053;154322;3106;164352;480183;480303;543232;634505;483409;707584;;;;;;
76474,983;156194;5744;163840;480303;480799;543232;636497;486543;707072;;;;;;
76477,758;158832;10724;159744;480799;485995;543232;639631;496719;702976;;;;;;
76509,936;159716;4419;153600;485995;486532;543232;645711;490951;696832;;;;;;
76516,680;153411;1552;161280;486532;487682;543232;639943;489234;704512;;;;;;
76542,623;149008;1618;161280;487682;487875;543232;636690;489493;704512;;;;;;
76570,137;149074;832;161792;487875;488917;543232;636949;489749;705024;;;;;;
76721,917;149312;4016;161792;488917;489181;543232;638229;493197;705024;;;;;;
76772,489;152496;6085;162816;489181;490069;543232;641677;496154;706048;;;;;;
76773,324;156613;6003;162816;490069;490697;543232;646682;496700;706048;;;;;;
76985,298;156531;644;162816;490697;495924;543232;647228;496568;706048;;;;;;
77060,282;151172;2816;162816;495924;496036;543232;647096;498852;706048;;;;;;
77215,385;153344;784;163840;496036;496820;543232;649380;497604;707072;;;;;;
78070,957;152848;2732;163328;496820;497324;543232;649668;500056;706560;;;;;;
78139,622;118198;2720;164864;497324;498138;543232;615522;500858;708096;;;;;;
78139,639;2720;0;164864;498138;421656;543232;500858;421656;708096;184694;184392;786432;685552;606048;1494528
78457,904;154112;5419;164352;421656;421656;543232;575768;427075;707584;;;;;;
78549,003;159531;5543;164864;421656;422313;543232;581187;427856;708096;;;;;;
78789,008;160167;4520;164864;422313;422905;543232;582480;427425;708096;;;;;;
78811,484;159144;576;164352;422905;424155;543232;582049;424731;707584;;;;;;
78851,944;155200;6435;164864;424155;424459;543232;579355;430894;708096;;;;;;
78879,358;161059;1056;164864;424459;425642;543232;585518;426698;708096;;;;;;
79294,902;155680;4701;164864;425642;426018;543232;581322;430719;708096;;;;;;
79338,130;159325;5892;164864;426018;426943;543232;585343;432835;708096;;;;;;
79462,700;160516;1054;164864;426943;428111;543232;587459;429165;708096;;;;;;
79552,582;155678;3795;165376;428111;428694;543232;583789;432489;708608;;;;;;
79578,358;158931;3572;164864;428694;429253;543232;587625;432825;708096;;;;;;
79602,353;158708;3445;166400;429253;429885;543232;587961;433330;709632;;;;;;
79632,146;160629;3156;165888;429885;430373;543232;590514;433529;709120;;;;;;
79648,793;160340;864;166912;430373;431341;543232;590713;432205;710144;;;;;;
79682,069;159584;2836;166912;431341;431574;543232;590925;434410;710144;;;;;;
79706,610;161556;3528;167424;431574;432262;543232;593130;435790;710656;;;;;;
79729,971;163272;3264;167424;432262;432949;543232;595534;436213;710656;;;;;;
79754,268;163008;3380;168448;432949;433502;543232;595957;436882;711680;;;;;;
79853,076;164660;2804;167936;433502;434086;543232;598162;436890;711168;;;;;;
79889,301;164084;6206;167424;434086;434718;543232;598170;440924;710656;;;;;;
79909,783;166974;4068;167936;434718;435872;543232;601692;439940;711168;;;;;;
79932,213;164836;3009;167936;435872;436640;543232;600708;439649;711168;;;;;;
79966,406;163777;1440;167936;436640;437296;543232;600417;438736;711168;;;;;;
79985,241;162208;3988;168448;437296;437649;543232;599504;441637;711680;;;;;;
80029,427;165268;1394;167936;437649;438608;543232;602917;440002;711168;;;;;;
80062,923;162674;2740;168448;438608;439040;543232;601282;441780;711680;;;;;;
80287,898;164532;4474;168448;439040;439769;543232;603572;444243;711680;;;;;;
80341,235;166266;2883;168448;439769;440579;543232;606035;443462;711680;;;;;;
80517,234;164675;3379;168448;440579;441155;543232;605254;444534;711680;;;;;;
80579,663;165171;4042;168960;441155;441155;543232;606326;445197;712192;;;;;;
80656,127;166858;2015;168960;441155;441155;543232;608013;443170;712192;;;;;;
80693,352;164831;5012;167936;441155;441155;543232;605986;446167;711168;;;;;;
80716,313;166804;2623;168448;441155;441699;543232;607959;444322;711680;;;;;;
80874,233;164415;5384;167424;441699;442251;543232;606114;447635;710656;;;;;;
80968,303;166152;5881;166912;442251;442915;543232;608403;448796;710144;;;;;;
81066,343;166649;6752;166400;442915;442915;543232;609564;449667;709632;;;;;;
81077,963;165472;7220;166400;442915;442915;543232;608387;450135;709632;;;;;;
81081,414;165940;8687;162304;442915;450059;543232;608855;458746;705536;;;;;;
81095,642;162287;4624;158720;450059;451242;543232;612346;455866;701952;;;;;;
81126,025;158224;3892;163328;451242;453850;543232;609466;457742;706560;;;;;;
81161,041;154932;900;162816;453850;455722;543232;608782;456622;706048;;;;;;
81207,029;151940;4504;163840;455722;455834;543232;607662;460338;707072;;;;;;
81222,945;156568;1246;163328;455834;457078;543232;612402;458324;706560;;;;;;
81335,777;153310;816;163840;457078;457699;543232;610388;458515;707072;;;;;;
81741,795;65770;717;163840;457700;458316;543232;523470;459033;707072;;;;;;
81741,809;717;0;163840;458316;426989;543232;459033;426989;707072;184822;184487;786432;643855;611476;1493504
81885,907;152576;6197;163840;426989;426989;543232;579565;433186;707072;;;;;;
81925,797;158773;1200;163840;426989;428152;543232;585762;429352;707072;;;;;;
81944,876;153776;1008;164352;428152;428520;543232;581928;429528;707584;;;;;;
81964,793;154096;1552;163840;428520;428792;543232;582616;430344;707072;;;;;;
81985,942;154640;2416;165376;428792;429136;543232;583432;431552;708608;;;;;;
82023,600;157552;944;164864;429136;429424;543232;586688;430368;708096;;;;;;
82061,972;156080;672;165888;429424;429728;543232;585504;430400;709120;;;;;;
82081,482;156832;944;165376;429728;430112;543232;586560;431056;708608;;;;;;
82101,538;157104;672;166400;430112;430400;543232;587216;431072;709632;;;;;;
82129,931;157856;1136;165888;430400;430785;543232;588256;431921;709120;;;;;;
82150,152;158320;1344;167424;430785;431295;543232;589105;432639;710656;;;;;;
82171,034;160576;1363;166912;431295;431607;543232;591871;432970;710144;;;;;;
82542,881;160595;882;167936;431607;431895;543232;592202;432777;711168;;;;;;
82812,467;161138;5517;165888;431895;432351;543232;593033;437868;709120;;;;;;
82927,640;165773;4165;166912;432351;433334;543232;598124;437499;710144;;;;;;
83066,792;162885;5821;164864;433334;434134;543232;596219;439955;708096;;;;;;
83170,214;164541;3010;166912;434134;434134;543232;598675;437144;710144;;;;;;
83229,123;161218;3099;166400;434134;434134;543232;595352;437233;709632;;;;;;
83287,761;161307;3055;167424;434134;434134;543232;595441;437189;710656;;;;;;
83318,198;162799;3519;167424;434134;434134;543232;596933;437653;710656;;;;;;
83504,972;163263;3234;167936;434134;435137;543232;597397;438371;711168;;;;;;
83549,111;164002;3776;167936;435137;435137;543232;599139;438913;711168;;;;;;
83592,589;164544;3168;168448;435137;435137;543232;599681;438305;711680;;;;;;
83615,515;164960;3760;168448;435137;435137;543232;600097;438897;711680;;;;;;
83664,082;165552;3677;168448;435137;435897;543232;600689;439574;711680;;;;;;
83713,138;165469;3215;168448;435897;436257;543232;601366;439472;711680;;;;;;
83754,567;165007;3439;168960;436257;436553;543232;601264;439992;712192;;;;;;
83793,083;166255;4753;168960;436553;436873;543232;602808;441626;712192;;;;;;
84615,620;167569;4771;167936;436873;437249;543232;604442;442020;711168;;;;;;
84873,563;166563;6636;168448;437249;440108;543232;603812;446744;711680;;;;;;
84911,289;166635;6640;163840;440108;444323;543232;606743;450963;707072;;;;;;
84915,263;163220;10735;163840;444323;452336;543232;607543;463071;707072;;;;;;
85059,035;163823;12443;162304;452336;452959;543232;616159;465402;705536;;;;;;
85100,986;161435;9517;154624;452959;454111;543232;614394;463628;697856;;;;;;
85194,753;154413;11330;155648;454111;455134;543232;608524;466464;698880;;;;;;
85277,773;152642;4552;145920;455134;460750;543232;607776;465302;689152;;;;;;
85318,982;145864;2692;158208;460750;461857;543232;606614;464549;701440;;;;;;
85338,258;144004;1300;158208;461857;463179;543232;605861;464479;701440;;;;;;
85343,555;33453;384;158720;463179;463555;543232;496632;463939;701952;;;;;;
85343,568;384;0;158720;463555;426016;543232;463939;426016;701952;184666;184493;786432;648605;610509;1488384
85375,734;142336;4718;158720;426016;426017;543232;568352;430735;701952;;;;;;
85406,817;147021;3200;160256;426017;427203;543232;573038;430403;703488;;;;;;
85422,462;147584;1234;159232;427203;427836;543232;574787;429070;702464;;;;;;
85497,930;145618;3881;161280;427836;428031;543232;573454;431912;704512;;;;;;
85547,920;150313;1280;160256;428031;428770;543232;578344;430050;703488;;;;;;
85560,084;147712;929;161792;428770;429425;543232;576482;430354;705024;;;;;;
85601,221;148897;5430;161280;429425;429665;543232;578322;435095;704512;;;;;;
85630,535;153398;1088;162304;429665;430617;543232;583063;431705;705536;;;;;;
85655,898;150592;1600;162304;430617;430721;543232;581209;432321;705536;;;;;;
85683,131;151104;1626;163328;430721;430913;543232;581825;432539;706560;;;;;;
85710,068;152666;1303;162816;430913;431321;543232;583579;432624;706048;;;;;;
85744,218;152343;4869;163840;431321;431432;543232;583664;436301;707072;;;;;;
85769,971;157445;4150;163840;431432;432715;543232;588877;436865;707072;;;;;;
85785,658;156726;880;164864;432715;434027;543232;589441;434907;708096;;;;;;
85844,784;154992;1149;164352;434027;434243;543232;589019;435392;707584;;;;;;
85911,280;155261;996;165376;434243;434763;543232;589504;435759;708608;;;;;;
86002,882;156132;4241;164864;434763;434995;543232;590895;439236;708096;;;;;;
86120,536;159377;2704;165888;434995;436051;543232;594372;438755;709120;;;;;;
86122,797;158864;9200;161280;436051;438446;543232;594915;447646;704512;;;;;;
86290,903;161264;5306;162304;438446;441919;543232;599710;447225;705536;;;;;;
86346,097;157882;3096;163840;441919;444069;543232;599801;447165;707072;;;;;;
86376,367;155672;8579;162304;444069;444428;543232;599741;453007;705536;;;;;;
86405,142;160131;5762;163328;444428;445719;543232;604559;451481;706560;;;;;;
86407,741;157314;9440;161280;445719;448450;543232;603033;457890;704512;;;;;;
87168,263;158944;1951;162304;448450;450994;543232;607394;452945;705536;;;;;;
87763,951;151455;3891;163328;450994;451469;543232;602449;455360;706560;;;;;;
87858,589;154419;881;162304;451469;452492;543232;605888;453373;705536;;;;;;
87890,179;151409;752;163328;452492;452776;543232;603901;453528;706560;;;;;;
87990,532;152304;944;163328;452776;452960;543232;605080;453904;706560;;;;;;
88198,109;152496;3135;164352;452960;453209;543232;605456;456344;707584;;;;;;
88286,432;155988;5671;163840;453208;454081;543232;609196;459752;707072;;;;;;
88945,076;88679;527;164352;454081;455305;543232;542760;455832;707584;;;;;;
88945,091;527;0;164352;455305;427136;543232;455832;427136;707584;184832;184494;786432;640664;611630;1494016
89074,148;153600;4766;164352;427136;427137;543232;580736;431903;707584;;;;;;
89096,141;158366;1294;164864;427137;428452;543232;585503;429746;708096;;;;;;
89147,295;155406;784;164352;428452;429099;543232;583858;429883;707584;;;;;;
89245,458;154896;5501;164864;429099;429228;543232;583995;434729;708096;;;;;;
89418,830;160125;3285;164864;429228;430416;543232;589353;433701;708096;;;;;;
89455,449;157909;2448;165888;430416;431161;543232;588325;433609;709120;;;;;;
89555,016;158608;1843;165376;431161;431970;543232;589769;433813;708608;;;;;;
89605,946;158003;3609;166912;431970;431970;543232;589973;435579;710144;;;;;;
89624,443;161817;5860;166400;431970;431970;543232;593787;437830;709632;;;;;;
89635,316;164068;3026;166400;431970;432793;543232;596038;435819;709632;;;;;;
89669,390;160722;576;166400;432793;434473;543232;593515;435049;709632;;;;;;
89820,706;158272;2136;166912;434473;434801;543232;592745;436937;710144;;;;;;
89896,256;160344;3456;166400;434801;435439;543232;595145;438895;709632;;;;;;
89931,749;161664;872;167424;435439;436343;543232;597103;437215;710656;;;;;;
89941,821;160616;2249;167424;436343;436591;543232;596959;438840;710656;;;;;;
89952,960;161993;2944;167936;436591;437145;543232;598584;440089;711168;;;;;;
89968,773;163712;768;167936;437145;438097;543232;600857;438865;711168;;;;;;
89992,787;161536;1088;168448;438097;438250;543232;599633;439338;711680;;;;;;
90010,572;162368;704;167936;438250;438513;543232;600618;439217;711168;;;;;;
90240,944;161984;2459;168960;438513;438818;543232;600497;441277;712192;;;;;;
90543,208;164763;3605;168448;438818;439434;543232;603581;443039;711680;;;;;;
90732,221;165909;4657;168448;439434;439894;543232;605343;444551;711680;;;;;;
90810,830;166449;5328;167424;439894;440783;543232;606343;446111;710656;;;;;;
90871,993;167120;1041;167936;440783;442238;543232;607903;443279;711168;;;;;;
91113,462;161297;3877;167424;442238;442461;543232;603535;446338;710656;;;;;;
91150,890;164133;7141;164864;442461;443582;543232;606594;450723;708096;;;;;;
91675,756;164837;2119;166400;443582;445545;543232;608419;447664;709632;;;;;;
91742,903;159815;7087;164352;445545;445545;543232;605360;452632;707584;;;;;;
91777,534;162735;3859;165376;445545;445544;543232;608280;449403;708608;;;;;;
91878,496;159507;4612;166400;445544;446016;543232;605051;450628;709632;;;;;;
92018,299;161793;3745;165888;446016;446768;543232;607809;450513;709120;;;;;;
92547,150;120039;4288;166912;446768;446768;543232;566807;451056;710144;;;;;;
92547,167;4288;0;166912;446768;431748;543232;451056;431748;710144;185197;184512;786432;636253;616260;1496576
92788,326;158720;7326;166400;431748;431749;543232;590468;439075;709632;;;;;;
92897,169;166046;2595;166400;431749;431749;543232;597795;434344;709632;;;;;;
92985,030;160291;7552;165376;431749;431749;543232;592040;439301;708608;;;;;;
93016,753;165248;3616;165888;431749;431749;543232;596997;435365;709120;;;;;;
93087,830;159776;4209;165376;431749;431749;543232;591525;435958;708608;;;;;;
93120,908;160369;4287;166912;431749;431749;543232;592118;436036;710144;;;;;;
93190,338;162495;7539;165888;431749;431749;543232;594244;439288;709120;;;;;;
93191,083;165747;8521;163840;431749;431749;543232;597496;440270;707072;;;;;;
93191,536;163145;9538;164864;431749;432997;543232;594894;442535;708096;;;;;;
93192,064;164162;7905;196608;432997;433776;543232;597159;441681;739840;;;;;;
93192,644;193249;6828;197120;433776;434705;543232;627025;441533;740352;;;;;;
93218,929;192172;7700;234496;434705;435305;543232;626877;443005;777728;;;;;;
93388,477;230420;3446;234496;435305;435593;543232;665725;439039;777728;;;;;;
93469,351;226166;2962;278528;435593;436425;543232;661759;439387;821760;;;;;;
93560,899;269714;2352;278528;436425;437569;543232;706139;439921;821760;;;;;;
93618,906;269104;2752;329728;437569;438055;543232;706673;440807;872960;;;;;;
93923,943;321728;6406;314368;438055;438889;543232;759783;445295;857600;;;;;;
94050,434;314118;4188;301568;438889;440822;543232;753007;445010;844800;;;;;;
94281,115;301148;9179;295936;440822;441817;543232;741970;450996;839168;;;;;;
94354,655;295899;3620;281088;441817;443525;543232;737716;447145;824320;;;;;;
94519,072;280612;5228;273408;443525;444229;543232;724137;449457;816640;;;;;;
94572,300;273004;3236;262144;444229;445173;543232;717233;448409;805376;;;;;;
94630,202;261796;4081;253952;445173;445902;543232;706969;449983;797184;;;;;;
94887,599;253937;8631;250368;445902;447029;543232;699839;455660;793600;;;;;;
94923,571;250295;4183;238592;447029;448636;543232;697324;452819;781824;;;;;;
94943,056;238167;3492;229888;448636;449710;543232;686803;453202;773120;;;;;;
94954,318;229796;2724;222208;449710;450206;543232;679506;452930;765440;;;;;;
94979,306;221860;2320;215040;450206;451021;543232;672066;453341;758272;;;;;;
95002,021;214800;1136;207360;451021;452061;543232;665821;453197;750592;;;;;;
95046,345;206960;959;200704;452061;452590;543232;659021;453549;743936;;;;;;
95072,811;200639;3539;203776;452590;452774;543232;653229;456313;747008;;;;;;
95088,744;197075;2165;190464;452774;453660;543232;649849;455825;733696;;;;;;
95135,321;190069;3120;185856;453660;454212;543232;643729;457332;729088;;;;;;
95166,061;185392;2320;179712;454212;454620;543232;639604;456940;722944;;;;;;
95196,651;179472;4158;176640;454620;455306;543232;634092;459464;719872;;;;;;
95213,073;176190;5052;172544;455306;456093;543232;631496;461145;715776;;;;;;
95256,176;172476;4372;167424;456093;457358;543232;628569;461730;710656;;;;;;
95296,745;167188;3140;226304;457358;458190;543232;624546;461330;769536;;;;;;
95461,337;225860;6221;222208;458190;458982;543232;684050;465203;765440;;;;;;
95486,948;221766;5251;214528;459955;461328;543232;681721;466579;757760;;;;;;
95511,289;214147;2656;205824;461332;462830;543232;675479;465486;749056;;;;;;
95543,339;205408;3188;200192;462830;463374;543232;668238;466562;743424;;;;;;
95566,365;199796;4806;196096;463374;464231;543232;663170;469037;739328;;;;;;
95576,876;195782;5272;190976;464231;465179;543232;660013;470451;734208;;;;;;
95595,876;190572;5721;185856;465179;466396;543232;655751;472117;729088;;;;;;
95665,894;185433;4120;179200;466396;467580;543232;651829;471700;722432;;;;;;
95692,284;178712;6664;176640;467580;468444;543232;646292;475108;719872;;;;;;
95775,346;176136;3012;167936;468444;469371;543232;644580;472383;711168;;;;;;
95794,309;167876;2932;163328;469371;469931;543232;637247;472863;706560;;;;;;
95806,975;163182;3752;188928;469931;470572;543232;633113;474324;732160;;;;;;
95846,168;188584;5604;185344;470572;471299;543232;659156;476903;728576;;;;;;
95968,017;185316;5816;180736;471299;472715;543232;656615;478531;723968;;;;;;
95988,997;180408;3044;172544;472715;473618;543232;653123;476662;715776;;;;;;
96112,150;172516;3116;168448;473618;474186;543232;646134;477302;711680;;;;;;
96129,966;167980;4312;164864;474186;474995;543232;642166;479307;708096;;;;;;
96145,735;164568;1568;164864;474995;475954;543232;639563;477522;708096;;;;;;
96149,244;110336;2128;165376;475955;476602;543232;586291;478730;708608;;;;;;
96149,258;2128;0;165376;476602;456692;543232;478730;456692;708608;187855;185005;786432;666585;641697;1495040
96174,975;162816;7026;165376;456692;456692;543232;619508;463718;708608;;;;;;
96181,443;165234;5399;164352;456692;457572;543232;621926;462971;707584;;;;;;
96194,872;164119;1456;166400;457572;458877;543232;621691;460333;709632;;;;;;
96202,291;159152;4744;166400;458877;459332;543232;618029;464076;709632;;;;;;
96210,554;162440;2996;166912;459332;460989;543232;621772;463985;710144;;;;;;
96223,195;161204;3205;166400;460989;461612;543232;622193;464817;709632;;;;;;
96248,390;161413;3444;167424;461612;462176;543232;623025;465620;710656;;;;;;
96277,136;162676;4404;166912;462176;462816;543232;624852;467220;710144;;;;;;
96284,277;163636;2884;167936;462816;463536;543232;626452;466420;711168;;;;;;
96290,143;163140;2466;167424;463536;464256;543232;626676;466722;710656;;;;;;
96323,713;162722;3752;167936;464256;465042;543232;626978;468794;711168;;;;;;
96341,847;164520;4700;167936;465042;465610;543232;629562;470310;711168;;;;;;
96467,480;165468;2862;168448;465610;466426;543232;631078;469288;711680;;;;;;
96484,592;164142;834;167936;466426;467386;543232;630568;468220;711168;;;;;;
97045,431;162114;4426;167936;467386;467618;543232;629500;472044;711168;;;;;;
97387,238;165194;7138;167936;467618;468832;543232;632812;475970;711168;;;;;;
97897,533;167906;3701;166912;468832;469992;543232;636738;473693;710144;;;;;;
98023,641;163445;4291;167424;469992;470723;543232;633437;475014;710656;;;;;;
98375,808;164035;4841;167424;470723;471651;543232;634758;476492;710656;;;;;;
98423,922;164585;4377;167424;471651;471651;543232;636236;476028;710656;;;;;;
98452,869;164121;5405;166912;471651;471651;543232;635772;477056;710144;;;;;;
98502,752;165149;1936;167424;471651;472967;543232;636800;474903;710656;;;;;;
98526,640;161508;4045;167936;473292;473870;543232;634800;477915;711168;;;;;;
98546,247;164301;2914;167424;473873;474916;543232;638174;477830;710656;;;;;;
98566,549;163170;2464;167936;474916;475452;543232;638086;477916;711168;;;;;;
98578,184;163232;672;167936;475452;476306;543232;638684;476978;711168;;;;;;
98601,930;161440;864;167936;476306;476659;543232;637746;477523;711168;;;;;;
98636,249;161632;2224;167936;476659;476850;543232;638291;479074;711168;;;;;;
98674,892;162992;2352;168448;476850;477484;543232;639842;479836;711680;;;;;;
98711,957;163632;2336;167936;477484;477860;543232;641116;480196;711168;;;;;;
98788,325;163616;608;168448;477860;478645;543232;641476;479253;711680;;;;;;
98880,936;162400;4147;168448;478645;478878;543232;641045;483025;711680;;;;;;
98956,365;165939;4422;167424;478878;479888;543232;644817;484310;710656;;;;;;
99025,093;165176;1585;167936;479889;481267;543232;645065;482852;711168;;;;;;
99094,447;162353;3512;168448;481267;481902;543232;643620;485414;711680;;;;;;
99124,470;164792;1342;167936;481902;482901;543232;646694;484243;711168;;;;;;
99252,326;162622;4451;167424;482901;483133;543232;645523;487584;710656;;;;;;
99292,891;165219;3172;167936;483133;484404;543232;648352;487576;711168;;;;;;
99332,855;163919;5291;167424;484404;484892;543232;648323;490183;710656;;;;;;
99411,874;166059;2096;167936;484892;485596;543232;650951;487692;711168;;;;;;
99646,492;162864;3252;168448;485596;486615;543232;648460;489867;711680;;;;;;
99698,590;164532;4760;167936;486615;486614;543232;651147;491374;711168;;;;;;
99727,619;166040;3199;168448;486614;487627;543232;652654;490826;711680;;;;;;
99740,789;164479;2466;167936;487627;488874;543232;652106;491340;711168;;;;;;
99750,925;49157;288;168448;488874;489810;543232;538031;490098;711680;;;;;;
99750,937;288;0;168448;489810;449924;543232;490098;449924;711680;187197;184893;786432;677295;634817;1498112
99784,239;161792;4147;168448;449924;449924;543232;611716;454071;711680;;;;;;
99826,023;165939;6232;166400;449924;450564;543232;615863;456796;709632;;;;;;
99836,346;165976;4632;167424;450564;451994;543232;616540;456626;710656;;;;;;
99864,214;164376;5956;166400;451994;453046;543232;616370;459002;709632;;;;;;
99874,656;164676;3236;166912;453046;454165;543232;617722;457401;710144;;;;;;
99901,769;161956;3236;167424;454165;454921;543232;616121;458157;710656;;;;;;
99933,557;162980;4128;167424;454921;455624;543232;617901;459752;710656;;;;;;
99960,721;163872;2980;167936;455624;456562;543232;619496;459542;711168;;;;;;
99988,918;163748;736;167936;456562;457450;543232;620310;458186;711168;;;;;;
100009,815;161504;3344;167936;457450;457834;543232;618954;461178;711168;;;;;;
100028,176;164112;4516;167936;457834;458873;543232;621946;463389;711168;;;;;;
100053,508;165284;3907;168448;458873;459754;543232;624157;463661;711680;;;;;;
100067,664;165187;1104;167936;459754;461025;543232;624941;462129;711168;;;;;;
100096,907;162384;3072;168448;461025;461481;543232;623409;464553;711680;;;;;;
100111,368;164352;3684;167936;461481;462999;543232;625833;466683;711168;;;;;;
100123,352;164964;5670;167424;462999;463964;543232;627963;469634;710656;;;;;;
100133,144;166438;4520;167936;463964;465432;543232;630402;469952;711168;;;;;;
100142,880;165288;3460;168448;465432;466376;543232;630720;469836;711680;;;;;;
100151,391;164740;6168;167936;466376;467335;543232;631116;473503;711168;;;;;;
100163,089;167448;3076;167936;467335;468967;543232;634783;472043;711168;;;;;;
100171,947;163844;3519;167936;468967;469375;543232;632811;472894;711168;;;;;;
100180,028;164287;992;167936;469375;470679;543232;633662;471671;711168;;;;;;
100192,767;161760;2513;167936;470679;471039;543232;632439;473552;711168;;;;;;
100206,883;163281;5124;167936;471039;471688;543232;634320;476812;711168;;;;;;
100222,274;165892;3316;167936;471688;472847;543232;637580;476163;711168;;;;;;
100226,857;164084;1296;167936;472847;473969;543232;636931;475265;711168;;;;;;
100233,928;162064;3040;167936;473969;474545;543232;636033;477585;711168;;;;;;
100259,602;163808;2416;168448;474545;475626;543232;638353;478042;711680;;;;;;
100281,518;164208;3284;168448;475626;476193;543232;639834;479477;711680;;;;;;
100305,941;165076;2304;168960;476193;477080;543232;641269;479384;712192;;;;;;
100316,102;165120;2500;168960;477080;477746;543232;642200;480246;712192;;;;;;
100335,673;165316;2640;169472;477746;478210;543232;643062;480850;712704;;;;;;
100411,295;165968;3340;168960;478210;478945;543232;644178;482285;712192;;;;;;
100466,673;166668;3184;169472;478945;479670;543232;645613;482854;712704;;;;;;
100486,067;167024;3747;169472;479670;480103;543232;646694;483850;712704;;;;;;
100538,252;167587;3636;169472;480103;481495;543232;647690;485131;712704;;;;;;
100599,797;167476;2363;169472;481495;482679;543232;648971;485042;712704;;;;;;
100647,350;166203;3185;169984;482679;483410;543232;648882;486595;713216;;;;;;
100657,537;167537;4724;169472;483410;483826;543232;650947;488550;712704;;;;;;
100675,592;169076;3860;169472;483826;484870;543232;652902;488730;712704;;;;;;
100700,068;167700;2157;169472;484870;485646;543232;652570;487803;712704;;;;;;
100714,642;165997;4507;168448;485646;486214;543232;651643;490721;711680;;;;;;
100721,138;167323;3168;168960;486214;487008;543232;653537;490176;712192;;;;;;
100741,753;165984;1635;169472;487008;488530;543232;652992;490165;712704;;;;;;
100760,457;165475;1056;165376;488530;489205;543232;654005;490261;708608;;;;;;
100815,850;164896;2240;169472;489205;489653;543232;654101;491893;712704;;;;;;
100843,791;165568;1376;168960;489653;490260;543232;655221;491636;712192;;;;;;
100867,936;164704;3120;169472;490260;490520;543232;654964;493640;712704;;;;;;
101104,029;166960;3478;169472;490520;491194;543232;657480;494672;712704;;;;;;
101148,097;167318;5600;166400;491194;493824;543232;658512;499424;709632;;;;;;
101251,541;166368;1024;167936;493824;497400;543232;660192;498424;711168;;;;;;
101268,103;161792;5349;166912;497400;497864;543232;659192;503213;710144;;;;;;
101292,879;165093;7631;167424;497864;498452;543232;662957;506083;710656;;;;;;
101307,567;167375;4999;165376;498452;499683;543232;665827;504682;708608;;;;;;
101331,756;162695;3630;166400;499683;500395;543232;662378;504025;709632;;;;;;
101348,870;161326;1386;166400;500395;501176;543232;661721;502562;709632;;;;;;
101386,652;159082;3852;166400;501176;501361;543232;660258;505213;709632;;;;;;
101396,361;161548;4013;167424;501361;501792;543232;662909;505805;710656;;;;;;
101479,832;163245;2240;166912;501792;502302;543232;665037;504542;710144;;;;;;
101507,937;161472;1025;167424;502302;503144;543232;663774;504169;710656;;;;;;
101539,725;160769;2048;167424;503144;503415;543232;663913;505463;710656;;;;;;
101595,591;161792;2096;167936;503415;503957;543232;665207;506053;711168;;;;;;
101617,114;162352;1105;167424;503957;504695;543232;666309;505800;710656;;;;;;
101661,027;161361;2576;168448;504695;505022;543232;666056;507598;711680;;;;;;
101689,005;163856;768;167936;505022;505854;543232;668878;506622;711168;;;;;;
101722,232;162048;1536;168448;505854;506159;543232;667902;507695;711680;;;;;;
101900,596;163328;5973;167936;506159;506689;543232;669487;512662;711168;;;;;;
101956,106;167765;3315;167936;506689;508155;543232;674454;511470;711168;;;;;;
102021,299;164083;2205;167936;508155;509066;543232;672238;511271;711168;;;;;;
102099,567;162973;2768;168448;509066;509522;543232;672039;512290;711680;;;;;;
102137,548;164048;784;167936;509522;510660;543232;673570;511444;711168;;;;;;
102159,548;162064;3836;168448;510660;510869;543232;672724;514705;711680;;;;;;
102198,204;165628;3016;168448;510869;512090;543232;676497;515106;711680;;;;;;
102214,727;164808;4110;167936;512090;512541;543232;676898;516651;711168;;;;;;
102230,594;165902;1822;168448;512541;513446;543232;678443;515268;711680;;;;;;
102244,447;163614;2599;168960;513446;513677;543232;677060;516276;712192;;;;;;
102249,865;165415;2732;168960;513677;514237;543232;679092;516969;712192;;;;;;
102268,639;165548;2724;169472;514237;515045;543232;679785;517769;712704;;;;;;
102281,878;166564;4424;168448;515045;515405;543232;681609;519829;711680;;;;;;
102296,403;168264;3664;168960;515405;516448;543232;683669;520112;712192;;;;;;
102307,636;166480;1344;168960;516448;517794;543232;682928;519138;712192;;;;;;
102325,416;164160;1024;168960;517794;518396;543232;681954;519420;712192;;;;;;
102354,889;163840;576;168960;518396;518700;543232;682236;519276;712192;;;;;;
102385,331;163392;2900;169472;518700;518884;543232;682092;521784;712704;;;;;;
102429,763;166228;2045;168960;518884;518989;543232;685112;521034;712192;;;;;;
102455,993;165373;2331;169984;518989;519236;543232;684362;521567;713216;;;;;;
102492,886;166683;5091;169472;519236;521372;543232;685919;526463;712704;;;;;;
102517,235;169443;1728;167424;521372;522644;543232;690815;524372;710656;;;;;;
102537,943;163520;4189;168448;522644;522956;543232;686164;527145;711680;;;;;;
102559,483;165981;4371;167424;522956;523632;543232;688937;528003;710656;;;;;;
102571,997;165139;736;167936;523632;524858;543232;688771;525594;711168;;;;;;
102585,532;161504;1024;167936;524858;525114;543232;686362;526138;711168;;;;;;
102600,382;161792;4240;167936;525114;525299;543232;686906;529539;711168;;;;;;
102628,039;165008;3724;167936;525299;525916;543232;690307;529640;711168;;;;;;
102650,108;164492;3972;167936;525916;526476;543232;690408;530448;711168;;;;;;
102693,350;164740;4428;167936;526476;526868;543232;691216;531296;711168;;;;;;
102707,390;165196;3261;167936;526868;527674;543232;692064;530935;711168;;;;;;
102742,547;164029;3804;168448;527674;528410;543232;691703;532214;711680;;;;;;
102804,803;165596;6626;168448;528410;529204;543232;694006;535830;711680;;;;;;
102868,560;168418;1518;166400;529204;530253;543232;697622;531771;709632;;;;;;
102879,719;161262;2831;167424;530253;530828;543232;691515;533659;710656;;;;;;
102953,236;162575;4661;167424;530828;532223;543232;693403;536884;710656;;;;;;
103012,982;164352;2401;167424;532224;533542;543232;696576;535943;710656;;;;;;
103028,299;162145;3636;167936;533542;534386;543232;695687;538022;711168;;;;;;
103050,239;163892;880;167424;534386;535170;543232;698278;536050;710656;;;;;;
103087,760;161136;2432;167936;535170;535794;543232;696306;538226;711168;;;;;;
103099,902;163200;6399;167424;535794;536256;543232;698994;542655;710656;;;;;;
103114,779;167167;3441;167424;536256;537303;543232;703423;540744;710656;;;;;;
103161,426;163185;3446;167424;537303;538102;543232;700488;541548;710656;;;;;;
103183,562;163190;3740;168448;538102;538670;543232;701292;542410;711680;;;;;;
103252,714;165020;3414;167936;538670;539368;543232;703690;542782;711168;;;;;;
103275,718;164694;1709;168448;539368;540144;543232;704062;541853;711680;;;;;;
103299,692;163501;3898;168448;540144;540560;543232;703645;544458;711680;;;;;;
103311,315;94590;5735;167424;540560;541851;543232;635150;547586;710656;;;;;;
103311,330;5735;0;167424;541851;473669;543232;547586;473669;710656;193158;185737;786432;740744;659406;1497088
103338,456;160768;1229;167936;473669;473669;543232;634437;474898;711168;;;;;;
103365,905;161997;3941;167936;473669;474179;543232;635666;478120;711168;;;;;;
103411,454;164709;1264;167936;474179;475074;543232;638888;476338;711168;;;;;;
103553,309;162032;5624;166912;475074;475346;543232;637106;480970;710144;;;;;;
103586,797;165368;688;167424;475346;477038;543232;640714;477726;710656;;;;;;
103632,300;160432;640;167424;477038;477287;543232;637470;477927;710656;;;;;;
103674,666;160384;869;167424;477287;477527;543232;637671;478396;710656;;;;;;
103737,331;160613;1148;167936;477527;477574;543232;638140;478722;711168;;;;;;
103812,389;161404;2256;167424;477574;477878;543232;638978;480134;710656;;;;;;
103851,532;162512;4090;167936;477878;477879;543232;640390;481969;711168;;;;;;
103887,125;164858;4358;167936;477879;478086;543232;642737;482444;711168;;;;;;
103907,594;165126;2516;167936;478086;479393;543232;643212;481909;711168;;;;;;
103933,684;163284;3201;167936;479393;479857;543232;642677;483058;711168;;;;;;
103966,289;163969;1008;168448;479857;480617;543232;643826;481625;711680;;;;;;
103979,665;162800;2416;168448;480617;480913;543232;643417;483329;711680;;;;;;
103996,330;164208;3766;167936;480913;481448;543232;645121;485214;711168;;;;;;
104012,236;165558;1612;168448;481448;482448;543232;647006;484060;711680;;;;;;
104028,450;163404;4302;167936;482448;482703;543232;645852;487005;711168;;;;;;
104037,545;166094;3696;168448;482703;483409;543232;648797;487105;711680;;;;;;
104072,392;165488;962;168448;483409;484577;543232;648897;485539;711680;;;;;;
104110,597;162754;1104;168448;484577;484681;543232;647331;485785;711680;;;;;;
104138,876;162896;640;168960;484681;485025;543232;647577;485665;712192;;;;;;
104182,205;162944;2064;168448;485025;485097;543232;647969;487161;711680;;;;;;
104225,002;164368;864;168960;485097;485441;543232;649465;486305;712192;;;;;;
104286,343;163680;752;168960;485441;485905;543232;649121;486657;712192;;;;;;
104378,444;163568;960;169472;485905;486017;543232;649473;486977;712704;;;;;;
104527,690;164800;1056;169472;486017;486297;543232;650817;487353;712704;;;;;;
104566,193;164896;2880;169472;486297;486449;543232;651193;489329;712704;;;;;;
104692,437;166720;943;169472;486449;487489;543232;653169;488432;712704;;;;;;
104762,883;164783;1904;169984;487489;487924;543232;652272;489828;713216;;;;;;
104898,263;166768;3523;168448;487924;488380;543232;654692;491903;711680;;;;;;
104934,484;168387;5603;167424;488380;488814;543232;656767;494417;710656;;;;;;
104950,461;167395;4580;166400;488814;490525;543232;656209;495105;709632;;;;;;
104991,322;166372;3464;168448;490525;491439;543232;656897;494903;711680;;;;;;
105013,017;164744;5290;166912;491439;492080;543232;656183;497370;710144;;;;;;
105048,013;166570;4269;167424;492080;493031;543232;658650;497300;710656;;;;;;
105059,680;164013;1440;167424;493031;494065;543232;657044;495505;710656;;;;;;
105071,492;161184;2128;167936;494065;494785;543232;655249;496913;711168;;;;;;
105082,490;162896;1812;167936;494785;495397;543232;657681;497209;711168;;;;;;
105096,188;162580;3940;167424;495397;495751;543232;657977;499691;710656;;;;;;
105125,454;164708;4512;167936;495751;496722;543232;660459;501234;711168;;;;;;
105141,998;165280;3292;168448;496722;497570;543232;662002;500862;711680;;;;;;
105171,182;164572;2096;167936;497570;498249;543232;662142;500345;711168;;;;;;
105224,160;163376;2303;168448;498249;498923;543232;661625;501226;711680;;;;;;
105264,826;164095;5097;166912;498923;499339;543232;663018;504436;710144;;;;;;
105285,119;166606;5509;166912;499339;500508;543232;665945;506017;710144;;;;;;
105341,354;165253;4824;167424;500508;501524;543232;665761;506348;710656;;;;;;
105382,417;164568;1744;167424;501524;502531;543232;666092;504275;710656;;;;;;
105394,918;161488;4632;167424;502531;502939;543232;664019;507571;710656;;;;;;
105424,165;164376;1760;167424;502939;503771;543232;667315;505531;710656;;;;;;
105434,465;161504;4077;167424;503771;504364;543232;665275;508441;710656;;;;;;
105459,701;163821;5656;166912;504364;505197;543232;668185;510853;710144;;;;;;
105497,735;165400;4665;167424;505197;506020;543232;670597;510685;710656;;;;;;
105522,998;163977;3959;167424;506021;506844;543232;669998;510803;710656;;;;;;
105533,794;163703;1062;167424;506844;508020;543232;670547;509082;710656;;;;;;
105549,045;160806;1952;167424;508020;508323;543232;668826;510275;710656;;;;;;
105559,241;161696;2916;167424;508323;509407;543232;670019;512323;710656;;;;;;
105569,695;162660;4504;167936;509407;509890;543232;672067;514394;711168;;;;;;
105593,997;165272;5656;166912;509890;511090;543232;675162;516746;710144;;;;;;
105602,121;166424;3316;167424;511090;511954;543232;677514;515270;710656;;;;;;
105645,172;163060;3164;167424;511954;513246;543232;675014;516410;710656;;;;;;
105673,237;162908;6712;165888;513246;515757;543232;676154;522469;709120;;;;;;
105699,077;165432;5844;166912;515757;516853;543232;681189;522697;710144;;;;;;
105718,210;164564;5000;166912;516853;517833;543232;681417;522833;710144;;;;;;
105753,149;163720;3156;166912;517833;518632;543232;681553;521788;710144;;;;;;
105780,837;161876;1632;166912;518632;519392;543232;680508;521024;710144;;;;;;
105835,703;160352;4856;166912;519392;520140;543232;679744;524996;710144;;;;;;
105846,504;163576;3780;167424;520140;521583;543232;683716;525363;710656;;;;;;
105894,423;163012;3012;166912;521583;522287;543232;684595;525299;710144;;;;;;
105917,639;162244;2016;167424;522287;522863;543232;684531;524879;710656;;;;;;
105931,536;161760;5186;167424;522863;523536;543232;684623;528722;710656;;;;;;
105959,286;164900;6305;166400;523537;524682;543232;688437;530987;709632;;;;;;
105979,977;165025;5789;164864;524682;525962;543232;689707;531751;708096;;;;;;
105993,274;164509;2436;166912;525962;527090;543232;690471;529526;710144;;;;;;
106019,575;160644;2592;166400;527090;527581;543232;687734;530173;709632;;;;;;
106033,952;160800;2496;166912;527581;528109;543232;688381;530605;710144;;;;;;
106117,679;161216;5064;166912;528109;529105;543232;689325;534169;710144;;;;;;
106154,413;163784;6732;165888;529105;530285;543232;692889;537017;709120;;;;;;
106167,196;164428;5287;166400;530285;530837;543232;694713;536124;709632;;;;;;
106195,693;162983;3085;166400;530837;531605;543232;693820;534690;709632;;;;;;
106215,906;160781;4655;166400;531605;532280;543232;692386;536935;709632;;;;;;
106244,122;162351;2113;166912;532280;533375;543232;694631;535488;710144;;;;;;
106262,440;160833;2272;166912;533375;533888;543232;694208;536160;710144;;;;;;
106462,903;160992;5640;166912;533888;534502;543232;694880;540142;710144;;;;;;
106561,924;164360;1056;160256;534502;536013;543232;698862;537069;703488;;;;;;
106612,597;159776;3443;166912;536013;536542;543232;695789;539985;710144;;;;;;
106625,387;161651;897;166400;536542;537757;543232;698193;538654;709632;;;;;;
106731,527;159105;1780;166912;537757;537989;543232;696862;539769;710144;;;;;;
106899,347;160500;7229;166400;537989;538434;543232;698489;545663;709632;;;;;;
106913,214;71728;3678;166400;538434;539646;543232;610162;543324;709632;;;;;;
106913,231;3678;0;166400;539646;482278;543232;543324;482278;709632;189095;185189;786432;732419;667467;1496064
107456,555;157696;2851;166400;482278;482278;543232;639974;485129;709632;;;;;;
107632,038;160547;1823;166912;482278;482990;543232;642825;484813;710144;;;;;;
107658,644;160543;1820;166912;482990;482990;543232;643533;484810;710144;;;;;;
107752,416;160540;6402;165376;482990;483334;543232;643530;489736;708608;;;;;;
107811,138;164098;2611;166400;483334;483678;543232;647432;486289;709632;;;;;;
107898,565;160307;6848;164864;483678;483678;543232;643985;490526;708096;;;;;;
107936,508;163520;3154;165888;483678;483678;543232;647198;486832;709120;;;;;;
107973,121;159713;4232;166912;483678;484503;543232;643391;488735;710144;;;;;;
108265,215;162440;8068;166400;484503;484727;543232;646943;492795;709632;;;;;;
108616,100;166276;7046;163328;484727;484728;543232;651003;491774;706560;;;;;;
108682,923;161670;8741;163840;484728;484728;543232;646398;493469;707072;;;;;;
108690,104;163365;5698;164352;484728;484727;543232;648093;490425;707584;;;;;;
108732,174;158786;5903;163840;484727;485873;543232;643513;491776;707072;;;;;;
108815,276;158991;3567;164864;485873;487345;543232;644864;490912;708096;;;;;;
108859,421;157679;6366;164352;487345;488873;543232;645024;495239;707584;;;;;;
108912,054;160478;5212;165376;488873;489441;543232;649351;494653;708608;;;;;;
108927,104;160348;5946;164864;489441;490849;543232;649789;496795;708096;;;;;;
108988,259;161082;3204;165376;490849;492399;543232;651931;495603;708608;;;;;;
109022,173;158852;3670;165376;492399;493031;543232;651251;496701;708608;;;;;;
109043,238;159318;7846;163840;493031;493727;543232;652349;501573;707072;;;;;;
109049,137;162470;1280;164864;493727;495711;543232;656197;496991;708096;;;;;;
109052,496;155904;1062;164864;495711;496351;543232;651615;497413;708096;;;;;;
109060,802;155686;961;164864;496351;496567;543232;652037;497528;708096;;;;;;
109076,098;155585;929;164864;496567;496825;543232;652152;497754;708096;;;;;;
109083,277;155553;864;164864;496825;497072;543232;652378;497936;708096;;;;;;
109087,287;155488;961;165376;497072;497232;543232;652560;498193;708608;;;;;;
109151,473;156097;2623;164864;497232;497568;543232;653329;500191;708096;;;;;;
109194,024;157759;3283;166400;497568;498362;543232;655327;501645;709632;;;;;;
109221,829;160467;512;165888;498362;499472;543232;658829;499984;709120;;;;;;
109447,033;157696;4629;166400;499472;499737;543232;657168;504366;709632;;;;;;
109527,079;162325;944;166400;499737;500963;543232;662062;501907;709632;;;;;;
109545,202;158640;3523;166912;500963;501156;543232;659603;504679;710144;;;;;;
109562,921;161731;3443;166400;501156;501948;543232;662887;505391;709632;;;;;;
109571,446;161651;1247;167424;501948;503187;543232;663599;504434;710656;;;;;;
109578,876;160479;704;166912;503187;503459;543232;663666;504163;710144;;;;;;
109587,153;159936;1728;167936;503459;503763;543232;663395;505491;711168;;;;;;
109594,941;161976;2893;167424;503763;504524;543232;665739;507417;710656;;;;;;
109606,799;163149;7145;163840;504524;507561;543232;667673;514706;707072;;;;;;
109623,697;163817;2563;165888;507561;509281;543232;671378;511844;709120;;;;;;
109627,518;159235;1085;166400;509281;510426;543232;668516;511511;709632;;;;;;
109675,852;158269;2368;165888;510426;510641;543232;668695;513009;709120;;;;;;
109687,324;159552;833;166912;510641;511707;543232;670193;512540;710144;;;;;;
109741,919;159553;3939;166912;511707;511939;543232;671260;515878;710144;;;;;;
109867,413;162659;3437;167424;511939;512681;543232;674598;516118;710656;;;;;;
109903,209;162669;5243;166912;512681;513145;543232;675350;518388;710144;;;;;;
109963,359;164475;2701;167424;513145;514275;543232;677620;516976;710656;;;;;;
109982,833;161933;608;166912;514275;515315;543232;676208;515923;710144;;;;;;
109991,740;159840;4829;166400;515315;515347;543232;675155;520176;709632;;;;;;
110005,412;163373;4532;166912;515348;516781;543232;678721;521313;710144;;;;;;
110024,457;163252;1262;166912;516781;518109;543232;680033;519371;710144;;;;;;
110047,025;159982;833;166912;518109;518923;543232;678091;519756;710144;;;;;;
110059,060;159553;865;167424;518923;519107;543232;678476;519972;710656;;;;;;
110154,676;160609;2564;167424;519107;519339;543232;679716;521903;710656;;;;;;
110242,516;162308;2544;168448;519339;519667;543232;681647;522211;711680;;;;;;
110287,137;163824;979;167936;519667;520885;543232;683491;521864;711168;;;;;;
110314,004;162259;1146;168448;520885;520973;543232;683144;522119;711680;;;;;;
110329,533;162938;4074;168448;520973;521101;543232;683911;525175;711680;;;;;;
110378,250;165866;800;168448;521101;522207;543232;686967;523007;711680;;;;;;
110403,314;162592;1408;168448;522207;522567;543232;684799;523975;711680;;;;;;
110471,869;163200;2979;168960;522567;522672;543232;685767;525651;712192;;;;;;
110515,118;135730;2836;168448;522672;523191;543232;658402;526027;711680;;;;;;
110515,133;2836;0;168448;523191;482349;543232;526027;482349;711680;188065;185321;786432;714092;667670;1498112
110587,083;162304;3347;168960;482349;482350;543232;644653;485697;712192;;;;;;
110604,955;166163;1218;168960;482350;483381;543232;648513;484599;712192;;;;;;
110628,694;164034;896;168960;483381;483685;543232;647415;484581;712192;;;;;;
110649,632;163712;1664;168960;483685;483981;543232;647397;485645;712192;;;;;;
110679,790;164480;3656;169472;483981;484445;543232;648461;488101;712704;;;;;;
110695,843;167496;2546;169472;484445;485124;543232;651941;487670;712704;;;;;;
110715,729;166386;1233;169472;485124;485885;543232;651510;487118;712704;;;;;;
110734,360;165073;1117;169472;485885;486357;543232;650958;487474;712704;;;;;;
110744,012;164957;903;169984;486357;486829;543232;651314;487732;713216;;;;;;
110780,476;165255;2851;169472;486829;487101;543232;652084;489952;712704;;;;;;
110814,821;167203;5103;166912;487101;488624;543232;654304;493727;710144;;;;;;
110821,489;166895;928;168448;488624;490407;543232;655519;491335;711680;;;;;;
110830,892;162720;1328;168960;490407;490847;543232;653127;492175;712192;;;;;;
110844,996;163632;2871;168448;490847;491611;543232;654479;494482;711680;;;;;;
110853,190;165175;736;168960;491611;492756;543232;656786;493492;712192;;;;;;
110869,063;163552;2916;168960;492756;493045;543232;656308;495961;712192;;;;;;
110905,914;165732;2861;168960;493045;493459;543232;658777;496320;712192;;;;;;
110912,880;165677;608;168960;493459;494443;543232;659136;495051;712192;;;;;;
111012,881;163424;1611;169472;494443;494756;543232;657867;496367;712704;;;;;;
111052,946;165451;1825;169472;494756;495378;543232;660207;497203;712704;;;;;;
111099,894;165665;4675;167936;495378;496077;543232;661043;500752;711168;;;;;;
111155,947;167491;1152;168960;496077;497466;543232;663568;498618;712192;;;;;;
111181,031;163968;4427;168448;497466;497827;543232;661434;502254;711680;;;;;;
111186,957;167243;4748;167936;497827;498617;543232;665070;503365;711168;;;;;;
111211,808;167564;4099;167424;498617;499625;543232;666181;503724;710656;;;;;;
111229,789;164867;2276;167936;499625;500597;543232;664492;502873;711168;;;;;;
111258,759;163044;3594;168448;500597;500925;543232;663641;504519;711680;;;;;;
111264,422;165386;5225;167424;500925;501687;543232;666311;506912;710656;;;;;;
111286,876;167017;2640;168448;501687;502655;543232;668704;505295;711680;;;;;;
111308,732;163920;4353;167936;502655;503417;543232;666575;507770;711168;;;;;;
111313,272;165223;2035;168448;503416;504843;543232;668639;506878;711680;;;;;;
111321,773;163136;4528;167936;504844;505375;543232;667980;509903;711168;;;;;;
111331,230;165808;5797;166912;505375;507540;543232;671183;513337;710144;;;;;;
111391,182;165541;3841;167424;507540;508581;543232;673081;512422;710656;;;;;;
111444,773;163585;496;166912;508581;509528;543232;672166;510024;710144;;;;;;
111553,458;160240;2240;167424;509528;509640;543232;669768;511880;710656;;;;;;
111594,129;161984;4040;167936;509640;510190;543232;671624;514230;711168;;;;;;
111610,104;164808;1728;167936;510190;511523;543232;674998;513251;711168;;;;;;
111624,440;162496;3907;167936;511523;512043;543232;674019;515950;711168;;;;;;
111642,442;164675;3542;167936;512043;512786;543232;676718;516328;711168;;;;;;
111649,266;164310;768;168448;512786;513994;543232;677096;514762;711680;;;;;;
111663,090;162560;3475;168448;513994;514179;543232;676554;517654;711680;;;;;;
111672,964;165267;1373;168448;514179;515354;543232;679446;516727;711680;;;;;;
111685,432;163165;2560;168448;515354;515834;543232;678519;518394;711680;;;;;;
111704,948;164352;4292;167936;515834;516735;543232;680186;521027;711168;;;;;;
111822,473;166084;4293;168448;516735;517642;543232;682819;521935;711680;;;;;;
111872,304;166085;898;168448;517642;518921;543232;683727;519819;711680;;;;;;
111901,343;162690;1105;168448;518921;519235;543232;681611;520340;711680;;;;;;
112032,041;162897;5564;167424;519235;519649;543232;682132;525213;710656;;;;;;
112063,241;166332;688;167936;519649;521150;543232;685981;521838;711168;;;;;;
112160,904;161456;4643;166912;521150;521407;543232;682606;526050;710144;;;;;;
112177,953;164387;1026;167424;521407;522791;543232;685794;523817;710656;;;;;;
112195,487;160770;4993;167424;522791;523071;543232;683561;528064;710656;;;;;;
112282,586;164737;4517;164352;523071;523809;543232;687808;528326;707584;;;;;;
112318,263;164261;928;167424;523809;525368;543232;688070;526296;710656;;;;;;
112335,095;160160;4287;166912;525368;525736;543232;685528;530023;710144;;;;;;
112366,179;163519;3780;167424;525736;526661;543232;689255;530441;710656;;;;;;
112382,638;163012;3589;166912;526661;527438;543232;689673;531027;710144;;;;;;
112403,757;162821;3220;167936;527438;528046;543232;690259;531266;711168;;;;;;
112420,999;163476;2899;167424;528046;528750;543232;691522;531649;710656;;;;;;
112466,084;163155;2240;168448;528750;529675;543232;691905;531915;711680;;;;;;
112499,010;164032;4965;166912;529675;530173;543232;693707;535138;710144;;;;;;
112553,305;166757;3667;168448;530173;531047;543232;696930;534714;711680;;;;;;
112577,584;164947;944;167936;531047;532206;543232;695994;533150;711168;;;;;;
112624,424;162224;2320;168448;532206;532509;543232;694430;534829;711680;;;;;;
112672,370;164112;992;168448;532509;533541;543232;696621;534533;711680;;;;;;
112735,985;162784;2515;168960;533541;533630;543232;696325;536145;712192;;;;;;
112764,285;164819;768;168448;533630;533989;543232;698449;534757;711680;;;;;;
112786,845;163072;832;168960;533989;534165;543232;697061;534997;712192;;;;;;
112804,688;163648;5432;168448;534165;534310;543232;697813;539742;711680;;;;;;
112816,665;168248;6611;165376;534310;535101;543232;702558;541712;708608;;;;;;
112826,980;165331;4156;166912;535101;536332;543232;700432;540488;710144;;;;;;
112832,990;162876;2742;167424;536332;537108;543232;699208;539850;710656;;;;;;
112850,329;161974;1792;166912;537108;537732;543232;699082;539524;710144;;;;;;
112864,141;161024;2290;167936;537732;538188;543232;698756;540478;711168;;;;;;
112879,113;163058;3912;167936;538188;538835;543232;701246;542747;711168;;;;;;
112891,197;164680;2592;168448;538835;539514;543232;703515;542106;711680;;;;;;
112911,834;163872;1746;167936;539514;540522;543232;703386;542268;711168;;;;;;
112925,232;162994;994;168448;540523;541186;543232;703517;542180;711680;;;;;;
112929,350;162786;1704;168448;541186;541661;543232;703972;543365;711680;;;;;;
112941,032;163496;5105;167424;541661;542111;543232;705157;547216;710656;;;;;;
112941,048;5105;0;167424;542111;498877;617472;547216;498877;784896;189250;185231;786432;736466;684108;1571328
112952,117;160768;3570;167936;498877;498878;617472;659645;502448;785408;;;;;;
112961,443;164338;5854;166400;498878;500351;617472;663216;506205;783872;;;;;;
112982,296;165598;4281;167424;500351;501392;617472;665949;505673;784896;;;;;;
112993,740;164025;3790;167936;501392;502395;617472;665417;506185;785408;;;;;;
113011,202;164046;3311;167424;502395;503029;617472;666441;506340;784896;;;;;;
113048,242;163567;2896;168448;503029;503709;617472;666596;506605;785920;;;;;;
113167,732;164176;1083;167936;503709;504799;617472;667885;505882;785408;;;;;;
113197,337;162363;3028;168448;504799;505463;617472;667162;508491;785920;;;;;;
113218,860;164820;3555;168448;505463;505958;617472;670283;509513;785920;;;;;;
113381,123;165347;2530;168960;505958;506844;617472;671305;509374;786432;;;;;;
113388,066;165346;1568;168960;506844;507420;617472;672190;508988;786432;;;;;;
113440,267;164384;3683;168960;507420;508086;617472;671804;511769;786432;;;;;;
113451,870;166499;608;168960;508086;509816;617472;674585;510424;786432;;;;;;
113527,123;163424;3056;168960;509816;509976;617472;673240;513032;786432;;;;;;
113554,981;165872;624;168960;509976;511240;617472;675848;511864;786432;;;;;;
113562,383;163440;1568;168960;511240;511584;617472;674680;513152;786432;;;;;;
113709,515;164384;3763;168960;511584;512249;617472;675968;516012;786432;;;;;;
113740,547;166579;1162;168960;512249;514017;617472;678828;515179;786432;;;;;;
113751,930;163978;2320;168960;514017;514176;617472;677995;516496;786432;;;;;;
113860,167;165136;2368;169472;514176;514837;617472;679312;517205;786944;;;;;;
113908,148;166208;480;169472;514837;515989;617472;681045;516469;786944;;;;;;
113976,149;164320;4581;168448;515989;516189;617472;680309;520770;785920;;;;;;
114021,057;167397;3167;168960;516189;517197;617472;683586;520364;786432;;;;;;
114047,127;165983;4921;167936;517197;517790;617472;683180;522711;785408;;;;;;
114060,537;166713;6444;168448;517790;518630;617472;684503;525074;785920;;;;;;
114075,700;168236;2364;167424;518630;519585;617472;686866;521949;784896;;;;;;
114080,299;163132;1024;167936;519585;521128;617472;682717;522152;785408;;;;;;
114085,537;161792;3360;167936;521128;521537;617472;682920;524897;785408;;;;;;
114100,978;164128;2176;167936;521537;523190;617472;685665;525366;785408;;;;;;
114179,484;162944;4296;168448;523190;523884;617472;686134;528180;785920;;;;;;
114216,881;166088;1074;168448;523884;524999;617472;689972;526073;785920;;;;;;
114279,173;162866;6461;166400;524999;525383;617472;687865;531844;783872;;;;;;
114300,536;166205;3269;167424;525383;526506;617472;691588;529775;784896;;;;;;
114303,627;163013;2436;167936;526506;527210;617472;689519;529646;785408;;;;;;
114313,170;162676;3421;167424;527209;527497;617472;689885;530918;784896;;;;;;
114321,311;163677;4822;167424;527497;528284;617472;691174;533106;784896;;;;;;
114333,272;165590;1616;167936;528284;529437;617472;693874;531053;785408;;;;;;
114347,753;162384;2656;168448;529437;530093;617472;691821;532749;785920;;;;;;
114353,829;163936;1332;167936;530093;531190;617472;694029;532522;785408;;;;;;
114388,985;162612;4596;167424;531190;531445;617472;693802;536041;784896;;;;;;
114397,635;165364;3985;167936;531445;532519;617472;696809;536504;785408;;;;;;
114400,781;164753;1184;167936;532519;533966;617472;697272;535150;785408;;;;;;
114421,199;161952;2304;167936;533966;535026;617472;695918;537330;785408;;;;;;
114466,373;163072;5752;167424;535026;535720;617472;698098;541472;784896;;;;;;
114500,173;166520;4769;165888;535720;536424;617472;702240;541193;783360;;;;;;
114533,490;165537;4049;167424;536424;537035;617472;701961;541084;784896;;;;;;
114549,757;163793;2384;167424;537035;537781;617472;700828;540165;784896;;;;;;
114568,323;162128;4381;167936;537781;538382;617472;699909;542763;785408;;;;;;
114585,553;165149;672;167936;538382;539902;617472;703531;540574;785408;;;;;;
114595,007;161440;1680;167936;539902;540030;617472;701342;541710;785408;;;;;;
114628,432;162448;6560;167424;540030;540711;617472;702478;547271;784896;;;;;;
114637,248;167328;5176;166400;540711;541910;617472;708039;547086;783872;;;;;;
114658,942;163896;3508;166912;541910;542893;617472;705806;546401;784384;;;;;;
114670,742;162228;3876;167424;542893;543589;617472;705121;547465;784896;;;;;;
114686,852;163620;4950;167424;543589;544005;617472;707209;548955;784896;;;;;;
114692,593;164694;832;167424;544005;545237;617472;708699;546069;784896;;;;;;
114703,817;160576;2612;167424;545237;545733;617472;705813;548345;784896;;;;;;
114716,312;162356;1282;167424;545733;546573;617472;708089;547855;784896;;;;;;
114762,532;161026;6424;166400;546573;547213;617472;707599;553637;783872;;;;;;
114805,380;166168;5291;165888;547213;548287;617472;713381;553578;783360;;;;;;
114813,935;162987;2116;166400;548287;549773;617472;711274;551889;783872;;;;;;
114828,114;159812;1413;166912;549773;550213;617472;709585;551626;784384;;;;;;
114839,973;160133;1687;166912;550213;550439;617472;710346;552126;784384;;;;;;
114849,058;160407;1030;166912;550439;551052;617472;710846;552082;784384;;;;;;
114877,023;159750;6122;164864;551052;551284;617472;710802;557406;782336;;;;;;
114899,318;164842;4138;166400;551284;552134;617472;716126;556272;783872;;;;;;
114914,899;161834;2253;166400;552134;553225;617472;713968;555478;783872;;;;;;
114959,910;159949;4399;166912;553225;553897;617472;713174;558296;784384;;;;;;
114988,227;163119;6168;165376;553897;554807;617472;717016;560975;782848;;;;;;
115007,877;164888;3380;166912;554807;555673;617472;719695;559053;784384;;;;;;
115013,426;161588;1213;166400;555673;556805;617472;717261;558018;783872;;;;;;
115021,937;159421;6387;165888;556805;557349;617472;716226;563736;783360;;;;;;
115030,333;164083;4961;166400;557349;558746;617472;721432;563707;783872;;;;;;
115038,369;162657;992;166400;558746;560026;617472;721403;561018;783872;;;;;;
115051,254;158688;3024;166400;560026;560546;617472;718714;563570;783872;;;;;;
115056,800;160720;1040;166912;560546;561575;617472;721266;562615;784384;;;;;;
115065,279;159760;608;166912;561575;562023;617472;721335;562631;784384;;;;;;
115086,304;159328;1074;166912;562023;562528;617472;721351;563602;784384;;;;;;
115119,616;159794;4671;166912;562528;563080;617472;722322;567751;784384;;;;;;
115130,454;163391;4346;166912;563080;564185;617472;726471;568531;784384;;;;;;
115150,640;163066;2306;166912;564185;565136;617472;727251;567442;784384;;;;;;
115161,075;161026;2304;167424;565136;565604;617472;726162;567908;784896;;;;;;
115182,965;161536;2096;166912;565604;566201;617472;727140;568297;784384;;;;;;
115205,199;161328;3139;167936;566201;566850;617472;727529;569989;785408;;;;;;
115226,649;163907;3267;167936;566850;567426;617472;730757;570693;785408;;;;;;
115235,337;164035;948;168448;567426;568569;617472;731461;569517;785920;;;;;;
115270,062;162740;4612;166912;568569;568729;617472;731309;573341;784384;;;;;;
115295,333;166404;736;167936;568729;570134;617472;735133;570870;785408;;;;;;
115306,015;161504;3904;167936;570134;570350;617472;731638;574254;785408;;;;;;
115315,194;164672;1184;167936;570350;571614;617472;735022;572798;785408;;;;;;
115322,178;161952;1248;167936;571614;571822;617472;733566;573070;785408;;;;;;
115325,881;162016;2834;168448;571822;572398;617472;733838;575232;785920;;;;;;
115336,265;164626;6244;168448;572398;573231;617472;737024;579475;785920;;;;;;
115359,172;168036;5941;165376;573231;574608;617472;741267;580549;782848;;;;;;
115396,698;164661;1990;166912;574608;576154;617472;739269;578144;784384;;;;;;
115409,872;160710;3636;167424;576154;576721;617472;736864;580357;784896;;;;;;
115420,527;163380;5299;165376;576721;577192;617472;740101;582491;782848;;;;;;
115445,996;165043;1012;166912;577192;578739;617472;742235;579751;784384;;;;;;
115458,565;159732;4969;166912;578739;578971;617472;738471;583940;784384;;;;;;
115467,862;163689;4736;166912;578971;579941;617472;742660;584677;784384;;;;;;
115477,799;163456;2960;166912;579941;580901;617472;743397;583861;784384;;;;;;
115486,288;161680;1216;167424;580901;582107;617472;742581;583323;784896;;;;;;
115493,188;160960;1408;167424;582107;582451;617472;743067;583859;784896;;;;;;
115502,669;161152;736;167424;582451;583075;617472;743603;583811;784896;;;;;;
115511,022;160480;3622;167424;583075;583275;617472;743555;586897;784896;;;;;;
115524,073;163366;1248;167936;583275;584347;617472;746641;585595;785408;;;;;;
115535,173;161504;2539;167424;584347;585027;617472;745851;587566;784896;;;;;;
115564,210;162773;5397;166912;585027;585762;617472;747800;591159;784384;;;;;;
115629,602;165141;1600;167424;585762;587066;617472;750903;588666;784896;;;;;;
115657,261;161344;1200;167936;587066;587619;617472;748410;588819;785408;;;;;;
115673,860;161968;2609;167936;587619;588242;617472;749587;590851;785408;;;;;;
115708,544;163377;1828;168448;588242;589180;617472;751619;591008;785920;;;;;;
115757,422;163620;6646;168448;589180;590239;617472;752800;596885;785920;;;;;;
115778,957;168438;1718;166400;590239;591476;617472;758677;593194;783872;;;;;;
115864,827;161462;6032;165888;591476;591773;617472;752938;597805;783360;;;;;;
115881,458;165776;7060;165376;591773;592942;617472;757549;600002;782848;;;;;;
115889,649;163732;1201;165888;592942;594309;617472;756674;595510;783360;;;;;;
115896,243;157873;1024;165888;594309;594870;617472;752182;595894;783360;;;;;;
115907,544;157694;2217;165888;595843;596179;617472;753537;598396;783360;;;;;;
115912,967;158889;2848;166912;596182;596784;617472;755071;599632;784384;;;;;;
115921,751;161056;2352;166400;596784;597368;617472;757840;599720;783872;;;;;;
115931,475;160560;2416;167424;597368;597601;617472;757928;600017;784896;;;;;;
115938,876;162160;1600;167424;597601;598357;617472;759761;599957;784896;;;;;;
115946,809;161344;2977;168448;598357;599023;617472;759701;602000;785920;;;;;;
116060,789;164257;1185;167936;599023;600454;617472;763280;601639;785408;;;;;;
116113,614;162465;2986;168448;600454;600798;617472;762919;603784;785920;;;;;;
116137,684;164778;6116;167936;600798;601700;617472;765576;607816;785408;;;;;;
116153,304;167908;5568;165888;601700;602660;617472;769608;608228;783360;;;;;;
116169,031;164288;1472;166912;602660;604380;617472;766948;605852;784384;;;;;;
116189,939;160192;1664;167424;604380;605281;617472;764572;606945;784896;;;;;;
116198,575;161408;4236;167424;605281;605870;617472;766689;610106;784896;;;;;;
116210,985;163980;4148;167424;605870;606954;617472;769850;611102;784896;;;;;;
116215,662;163892;1152;167424;606954;608050;617472;770846;609202;784896;;;;;;
116230,198;160896;912;167424;608050;608313;617472;768946;609225;784896;;;;;;
116239,917;160656;2580;167424;608313;608673;617472;768969;611253;784896;;;;;;
116250,735;162324;2188;168448;608673;609164;617472;770997;611352;785920;;;;;;
116309,539;163468;5841;167424;609164;609869;617472;772632;615710;784896;;;;;;
116323,700;167121;1363;167936;609869;611722;617472;776990;613085;785408;;;;;;
116340,172;161619;3361;167424;611722;612281;617472;773341;615642;784896;;;;;;
116358,649;163617;3343;167936;612281;613010;617472;775898;616353;785408;;;;;;
116380,784;164111;4176;167936;613010;613912;617472;777121;618088;785408;;;;;;
116413,133;164944;4617;167936;613912;614353;617472;778856;618970;785408;;;;;;
116453,967;165385;640;167936;614353;615553;617472;779738;616193;785408;;;;;;
116494,878;161408;3008;168448;615553;615665;617472;776961;618673;785920;;;;;;
116532,333;164288;832;167936;615665;616145;617472;779953;616977;785408;;;;;;
116532,347;832;0;167936;616145;517214;634368;616977;517214;802304;193462;185406;786432;810439;702620;1588736
116573,104;161280;5425;166400;517214;517215;634368;678494;522640;800768;;;;;;
116592,141;165169;1410;167424;517215;518601;634368;682384;520011;801792;;;;;;
116618,618;161154;768;167936;518601;519049;634368;679755;519817;802304;;;;;;
116644,419;161536;5014;165888;519049;519352;634368;680585;524366;800256;;;;;;
116667,219;165782;2859;167936;519352;520039;634368;685134;522898;802304;;;;;;
116673,489;162464;4586;167424;520039;520651;634368;682503;525237;801792;;;;;;
116686,523;164842;4306;167424;520651;521594;634368;685493;525900;801792;;;;;;
116702,360;164050;4471;167424;521594;522708;634368;685644;527179;801792;;;;;;
116746,560;164215;608;167424;522708;523944;634368;686923;524552;801792;;;;;;
116756,073;160352;1504;167424;523944;524272;634368;684296;525776;801792;;;;;;
116912,854;161248;6774;165376;524272;524868;634368;685520;531642;799744;;;;;;
116939,485;164470;720;166400;524868;526863;634368;689338;527583;800768;;;;;;
116955,103;158416;832;166912;526863;527215;634368;685279;528047;801280;;;;;;
117118,328;159552;4065;166912;527215;527390;634368;686767;531455;801280;;;;;;
117129,631;162785;992;166912;527390;528586;634368;690175;529578;801280;;;;;;
117139,750;159712;1101;166912;528586;528978;634368;688298;530079;801280;;;;;;
117155,819;159821;4109;167424;528978;529202;634368;688799;533311;801792;;;;;;
117289,233;163853;3187;167424;529202;529722;634368;693055;532909;801792;;;;;;
117311,896;162931;3431;167936;529722;530801;634368;692653;534232;802304;;;;;;
117333,587;163687;1915;167424;530801;531377;634368;694488;533292;801792;;;;;;
117416,941;162171;7154;164864;532350;533339;634368;694521;540493;799232;;;;;;
117440,034;164850;8658;166400;533343;535563;634368;698193;544221;800768;;;;;;
117456,032;166354;2421;164352;535563;537422;634368;701917;539843;798720;;;;;;
117463,838;157994;4527;165376;537422;538387;634368;695416;542914;799744;;;;;;
117481,031;160175;1632;165888;538387;539514;634368;698562;541146;800256;;;;;;
117493,601;157792;7160;163328;539514;540090;634368;697306;547250;797696;;;;;;
117537,810;163320;976;164864;540090;542448;634368;703410;543424;799232;;;;;;
117576,729;155600;3619;164864;542448;542849;634368;698048;546468;799232;;;;;;
117609,765;158243;4175;165888;542849;543552;634368;701092;547727;800256;;;;;;
117624,315;160847;2304;165888;543552;543840;634368;704399;546144;800256;;;;;;
117639,144;158976;1152;166400;543840;544933;634368;702816;546085;800768;;;;;;
117665,726;158848;6195;164352;544933;545270;634368;703781;551465;798720;;;;;;
117687,379;163891;1177;165888;545270;546656;634368;709161;547833;800256;;;;;;
117714,929;157849;1120;165888;546656;546840;634368;704505;547960;800256;;;;;;
117719,728;157792;3719;166400;546840;547120;634368;704632;550839;800768;;;;;;
117734,228;161415;8404;166400;547120;547960;634368;708535;556364;800768;;;;;;
117753,220;166100;2000;164352;547960;549400;634368;714060;551400;798720;;;;;;
117771,641;157648;961;165376;549400;550368;634368;707048;551329;799744;;;;;;
117777,549;156609;5336;165376;550368;550688;634368;706977;556024;799744;;;;;;
117793,834;160984;2049;165376;550688;551903;634368;711672;553952;799744;;;;;;
117802,434;157697;802;165888;551903;552816;634368;709600;553618;800256;;;;;;
117818,569;157474;544;165888;552816;553047;634368;710290;553591;800256;;;;;;
117830,463;157216;4276;165888;553047;553215;634368;710263;557491;800256;;;;;;
117854,841;160948;2723;165888;553215;553903;634368;714163;556626;800256;;;;;;
117885,519;159395;672;166912;553903;554848;634368;713298;555520;801280;;;;;;
117916,618;158880;656;166400;554848;554952;634368;713728;555608;800768;;;;;;
117935,816;158864;768;167424;554952;555160;634368;713816;555928;801792;;;;;;
118008,382;160000;3717;166912;555160;555344;634368;715160;559061;801280;;;;;;
118018,178;162949;6337;165376;555344;555944;634368;718293;562281;799744;;;;;;
118028,563;164033;1732;166400;555944;557240;634368;719977;558972;800768;;;;;;
118038,949;159428;5502;165888;557240;557892;634368;716668;563394;800256;;;;;;
118058,583;163198;4160;166400;557892;558833;634368;721090;562993;800768;;;;;;
118065,580;161856;1186;166400;558833;560419;634368;720689;561605;800768;;;;;;
118071,939;158882;3719;166400;560419;560811;634368;719301;564530;800768;;;;;;
118075,651;161415;8131;163840;560811;561639;634368;722226;569770;798208;;;;;;
118088,582;163779;4071;165376;561639;563400;634368;725418;567471;799744;;;;;;
118095,721;159719;994;165888;563400;564608;634368;723119;565602;800256;;;;;;
118112,806;157666;848;165888;564608;564904;634368;722274;565752;800256;;;;;;
118123,173;157520;1651;166400;564904;565040;634368;722424;566691;800768;;;;;;
118127,748;158835;4829;165888;565040;565487;634368;723875;570316;800256;;;;;;
118152,619;162013;6604;164352;565487;566372;634368;727500;572976;798720;;;;;;
118201,078;162252;6121;161792;566372;567003;634368;728624;573124;796160;;;;;;
118211,276;161769;3817;165888;567003;568068;634368;728772;571885;800256;;;;;;
118221,191;159465;4754;164864;568068;568939;634368;727533;573693;799232;;;;;;
118228,474;160402;2007;165888;568939;569756;634368;729341;571763;800256;;;;;;
118246,507;158679;960;165888;569756;570294;634368;728435;571254;800256;;;;;;
118258,190;157632;1168;166400;570294;570438;634368;727926;571606;800768;;;;;;
118286,716;158352;4015;165888;570438;570998;634368;728790;575013;800256;;;;;;
118311,593;161199;2108;166912;570998;572239;634368;732197;574347;801280;;;;;;
118323,265;160316;5210;166400;572239;572608;634368;732555;577818;800768;;;;;;
118342,279;163418;4404;166400;572608;573418;634368;736026;577822;800768;;;;;;
118353,961;162100;2784;166400;573418;574388;634368;735518;577172;800768;;;;;;
118396,469;160480;992;166912;574388;574669;634368;734868;575661;801280;;;;;;
118411,108;159712;6940;165888;574669;575021;634368;734381;581961;800256;;;;;;
118419,734;165660;2098;166400;575021;576573;634368;740681;578671;800768;;;;;;
118436,890;159282;4528;165888;576573;577462;634368;735855;581990;800256;;;;;;
118453,036;161712;2365;166912;577462;578229;634368;739174;580594;801280;;;;;;
118463,816;160573;5808;166400;578229;578537;634368;738802;584345;800768;;;;;;
118469,455;164016;1632;166400;578537;580329;634368;742553;581961;800768;;;;;;
118471,488;159327;4493;166400;580329;580840;634368;739656;585333;800768;;;;;;
118477,128;162189;1596;166912;580840;582854;634368;743029;584450;801280;;;;;;
118490,151;159804;1521;166400;582854;583566;634368;742658;585087;800768;;;;;;
118493,870;159729;640;166912;583566;584013;634368;743295;584653;801280;;;;;;
118503,183;159360;1120;166912;584013;584285;634368;743373;585405;801280;;;;;;
118510,405;159840;3583;167424;584285;584790;634368;744125;588373;801792;;;;;;
118523,913;162815;960;166912;584790;586101;634368;747605;587061;801280;;;;;;
118532,090;160192;4895;166400;586101;586509;634368;746293;591404;800768;;;;;;
118549,704;163615;930;166912;586509;587417;634368;750124;588347;801280;;;;;;
118556,249;159650;6777;165376;587417;587593;634368;747067;594370;799744;;;;;;
118584,800;164473;3817;166400;587593;588665;634368;752066;592482;800768;;;;;;
118618,484;161513;2702;166912;588665;589766;634368;750178;592468;801280;;;;;;
118631,854;160910;5726;166400;589766;589990;634368;750676;595716;800768;;;;;;
118636,319;163934;6911;165376;589990;590943;634368;753924;597854;799744;;;;;;
118642,014;163583;7783;164864;590943;592482;634368;754526;600265;799232;;;;;;
118647,382;164455;7698;162816;592482;594075;634368;756937;601773;797184;;;;;;
118661,940;160274;3370;163840;594075;595880;634368;754349;599250;798208;;;;;;
118675,106;155946;416;164352;595880;597084;634368;751826;597500;798720;;;;;;
118765,537;154013;7020;160768;597084;597252;634368;751097;604272;795136;;;;;;
118779,570;160620;5516;164352;597252;598422;634368;757872;603938;798720;;;;;;
118791,016;158604;2929;163840;598422;599566;634368;757026;602495;798208;;;;;;
118802,036;156017;1280;164352;599566;600381;634368;755583;601661;798720;;;;;;
118808,761;154880;2176;164352;600381;600669;634368;755261;602845;798720;;;;;;
118818,796;155776;1296;164864;600669;601985;634368;756445;603281;799232;;;;;;
118844,785;155920;3348;164864;601985;602657;634368;757905;606005;799232;;;;;;
118854,544;157972;800;165888;602657;603704;634368;760629;604504;800256;;;;;;
118868,503;157472;816;165888;603704;603912;634368;761176;604728;800256;;;;;;
118899,797;157488;2804;166400;603912;604345;634368;761400;607149;800768;;;;;;
118906,030;159988;992;165888;604345;605432;634368;764333;606424;800256;;;;;;
118915,341;158176;2768;167424;605432;605704;634368;763608;608472;801792;;;;;;
119011,267;162000;1511;166912;605704;607338;634368;767704;608849;801280;;;;;;
119042,739;160743;1023;167936;607338;607898;634368;768081;608921;802304;;;;;;
119157,585;161279;4101;167424;607898;608266;634368;769177;612367;801792;;;;;;
119204,349;164357;2207;167936;608266;608994;634368;772623;611201;802304;;;;;;
119252,052;162463;5801;167424;608994;609675;634368;771457;615476;801792;;;;;;
119271,219;166057;3844;167424;609675;610507;634368;775732;614351;801792;;;;;;
119287,604;163588;1888;167424;610507;611310;634368;774095;613198;801792;;;;;;
119300,709;161632;5425;166400;611310;612128;634368;772942;617553;800768;;;;;;
119316,031;164145;2528;166912;612128;613144;634368;776273;615672;801280;;;;;;
119337,440;161248;903;167424;613144;614402;634368;774392;615305;801792;;;;;;
119396,299;160647;3220;167424;614402;614746;634368;775049;617966;801792;;;;;;
119426,939;162964;832;167936;614746;615653;634368;777710;616485;802304;;;;;;
119457,935;161600;2883;167936;615653;616118;634368;777253;619001;802304;;;;;;
119482,547;163651;5886;166400;616118;616797;634368;779769;622683;800768;;;;;;
119502,019;165630;1753;167424;616797;618428;634368;782427;620181;801792;;;;;;
119507,333;161497;4269;167424;618428;619045;634368;779925;623314;801792;;;;;;
119512,691;164013;1457;167424;619045;620642;634368;783058;622099;801792;;;;;;
119521,854;161201;2164;167936;620642;621381;634368;781843;623545;802304;;;;;;
119533,915;162932;4800;167936;621381;622056;634368;784313;626856;802304;;;;;;
119556,817;165568;1072;167936;622056;623760;634368;787624;624832;802304;;;;;;
119720,411;161840;3836;167936;623760;624112;634368;785600;627948;802304;;;;;;
119744,894;164604;4328;167936;624112;624666;634368;788716;628994;802304;;;;;;
119755,001;165096;1720;167936;624666;625525;634368;789762;627245;802304;;;;;;
119782,913;162488;3153;168448;625525;626205;634368;788013;629358;802816;;;;;;
119802,881;164433;2034;167936;626205;627333;634368;790638;629367;802304;;;;;;
119824,872;163314;3775;168448;627333;627468;634368;790647;631243;802816;;;;;;
119864,695;165567;3917;168448;627468;627975;634368;793035;631892;802816;;;;;;
119885,047;165709;5149;167424;627975;629287;634368;793684;634436;801792;;;;;;
119891,973;165917;896;167936;629287;631642;634368;795204;632538;802304;;;;;;
119906,389;161664;1060;167936;631642;632143;634368;793306;633203;802304;;;;;;
119906,402;1060;0;167936;632143;528518;644096;633203;528518;812032;194793;185981;786432;827996;714499;1598464
119937,693;160768;2066;167936;528518;528519;644096;689286;530585;812032;;;;;;
119982,446;162834;1844;168448;528519;529743;644096;691353;531587;812544;;;;;;
120017,729;163636;4445;168448;529743;530015;644096;693379;534460;812544;;;;;;
120041,743;166237;3608;168448;530015;530974;644096;696252;534582;812544;;;;;;
120078,835;165400;1185;168448;530974;532100;644096;696374;533285;812544;;;;;;
120107,589;162977;1600;168448;532100;532516;644096;695077;534116;812544;;;;;;
120121,110;163392;6333;168448;532516;532772;644096;695908;539105;812544;;;;;;
120133,230;168125;2705;167424;532772;534296;644096;700897;537001;811520;;;;;;
120149,619;163473;6124;166912;534296;535384;644096;697769;541508;811008;;;;;;
120166,084;166892;5639;166912;535384;536864;644096;702276;542503;811008;;;;;;
120177,897;164359;5234;164352;536864;538391;644096;701223;543625;808448;;;;;;
120197,474;163954;3316;166912;538391;539798;644096;702345;543114;811008;;;;;;
120207,909;161524;2560;166400;539798;542294;644096;701322;544854;810496;;;;;;
120224,644;160768;2288;167424;542294;542862;644096;703062;545150;811520;;;;;;
120244,235;162032;864;167424;542862;543558;644096;704894;544422;811520;;;;;;
120260,115;160608;1602;167424;543558;543862;644096;704166;545464;811520;;;;;;
120263,180;161346;3379;167424;543862;544405;644096;705208;547784;811520;;;;;;
120289,374;163123;864;167936;544405;545548;644096;707528;546412;812032;;;;;;
120299,498;161632;1048;167936;545548;545940;644096;707180;546988;812032;;;;;;
120313,368;161816;2543;168448;545940;546124;644096;707756;548667;812544;;;;;;
120334,039;163823;4176;167936;546124;546324;644096;709947;550500;812032;;;;;;
120368,872;165456;3425;168448;546324;546645;644096;711780;550070;812544;;;;;;
120384,763;164705;2065;167936;546645;547666;644096;711350;549731;812032;;;;;;
120404,456;163345;1666;168960;547666;547962;644096;711011;549628;813056;;;;;;
120410,199;163970;6131;168448;547962;548499;644096;711932;554630;812544;;;;;;
120422,708;168435;3524;167424;548499;549666;644096;716934;553190;811520;;;;;;
120437,475;164292;2236;167936;549666;551029;644096;713958;553265;812032;;;;;;
120457,114;163004;6047;166912;551029;552029;644096;714033;558076;811008;;;;;;
120467,920;165791;4110;167424;552029;552847;644096;717820;556957;811520;;;;;;
120513,099;163854;2369;167936;552847;553870;644096;716701;556239;812032;;;;;;
120624,799;162625;992;167424;553870;554230;644096;716495;555222;811520;;;;;;
120668,085;161248;896;167936;554230;554512;644096;715478;555408;812032;;;;;;
120695,719;161664;4143;165376;554512;554632;644096;716176;558775;809472;;;;;;
120756,952;164911;6932;165376;554632;555216;644096;719543;562148;809472;;;;;;
120763,463;164628;4187;166400;555216;556174;644096;719844;560361;810496;;;;;;
120798,117;161883;768;166912;556174;557497;644096;718057;558265;811008;;;;;;
120850,150;159488;1422;166912;557497;557977;644096;716985;559399;811008;;;;;;
120877,855;160142;608;166912;557977;558568;644096;718119;559176;811008;;;;;;
120916,891;159328;1542;166912;558568;558712;644096;717896;560254;811008;;;;;;
120925,037;160262;1309;167424;558712;558872;644096;718974;560181;811520;;;;;;
120944,361;161053;3448;167424;558872;559196;644096;719925;562644;811520;;;;;;
120954,973;163192;3268;167936;559196;559693;644096;722388;562961;812032;;;;;;
120981,476;164036;1667;167936;559693;560581;644096;723729;562248;812032;;;;;;
120989,560;162435;1920;168448;560581;561261;644096;723016;563181;812544;;;;;;
121006,930;163712;4856;166912;561261;561686;644096;724973;566542;811008;;;;;;
121071,608;166648;3899;167936;561686;562754;644096;728334;566653;812032;;;;;;
121104,965;164667;1602;167936;562754;564085;644096;727421;565687;812032;;;;;;
121127,989;162370;2256;168448;564085;564576;644096;726455;566832;812544;;;;;;
121171,118;163536;4798;167936;564576;565194;644096;728112;569992;812032;;;;;;
121204,912;166078;896;167936;565194;566170;644096;731272;567066;812032;;;;;;
121219,229;161664;1120;167936;566170;566474;644096;727834;567594;812032;;;;;;
121228,408;161888;2336;168448;566474;566818;644096;728362;569154;812544;;;;;;
121260,472;164128;3236;168448;566818;567307;644096;730946;570543;812544;;;;;;
121296,979;165028;5506;166912;567307;567899;644096;732335;573405;811008;;;;;;
121313,182;166274;912;167936;567899;568861;644096;734173;569773;812032;;;;;;
121349,346;161680;2496;168448;568861;569020;644096;730541;571516;812544;;;;;;
121360,105;163282;2364;167936;569020;570212;644096;732302;572576;812032;;;;;;
121373,115;163644;1824;168960;570212;570236;644096;733856;572060;813056;;;;;;
121379,535;164640;3084;168960;570236;571328;644096;734876;574412;813056;;;;;;
121392,590;165900;3060;169472;571328;572280;644096;737228;575340;813568;;;;;;
121400,555;166388;4172;168960;572280;572800;644096;738668;576972;813056;;;;;;
121416,490;167500;608;168960;572800;574087;644096;740300;574695;813056;;;;;;
121426,467;163424;3507;168960;574087;574175;644096;737511;577682;813056;;;;;;
121436,806;166323;1508;168960;574175;575164;644096;740498;576672;813056;;;;;;
121488,752;164324;5999;168960;575164;575562;644096;739488;581561;813056;;;;;;
121498,328;168815;1643;167936;575562;577041;644096;744377;578684;812032;;;;;;
121507,864;163435;3620;168448;577041;577449;644096;740476;581069;812544;;;;;;
121512,211;165412;544;168448;577449;578576;644096;742861;579120;812544;;;;;;
121519,562;162336;1089;168448;578576;578601;644096;740912;579690;812544;;;;;;
121527,953;162881;800;168448;578601;578833;644096;741482;579633;812544;;;;;;
121530,940;162592;1157;168448;578833;579185;644096;741425;580342;812544;;;;;;
121543,770;162949;4520;167936;579185;579393;644096;742134;583913;812032;;;;;;
121571,509;166312;1888;168448;579393;580482;644096;745705;582370;812544;;;;;;
121581,484;163680;1488;168960;580482;580819;644096;744162;582307;813056;;;;;;
121587,555;163792;3772;168448;580819;581179;644096;744611;584951;812544;;;;;;
121606,334;166076;5593;167424;581179;582239;644096;747255;587832;811520;;;;;;
121616,692;166361;1187;167936;582239;583727;644096;748600;584914;812032;;;;;;
121628,036;161955;2800;168448;583727;584063;644096;745682;586863;812544;;;;;;
121647,349;164080;944;167936;584063;585074;644096;748143;586018;812032;;;;;;
121652,747;162224;3343;168448;585074;585514;644096;747298;588857;812544;;;;;;
121670,314;165135;6636;163840;585516;595771;644096;750651;602407;807936;;;;;;
121691,373;163820;6537;161280;595771;597771;644096;759591;604308;805376;;;;;;
121714,010;159625;4848;158208;597771;598835;644096;757396;603683;802304;;;;;;
121720,651;157767;2933;164352;598836;600068;644096;756603;603001;808448;;;;;;
121734,871;156021;3544;163840;600068;600774;644096;756089;604318;807936;;;;;;
121748,905;156632;3598;165376;600774;601350;644096;757406;604948;809472;;;;;;
121777,139;158734;1056;164864;601350;602270;644096;760084;603326;808960;;;;;;
121818,739;156192;2899;165888;602270;602558;644096;758462;605457;809984;;;;;;
121838,070;159059;2544;165376;602558;603400;644096;761617;605944;809472;;;;;;
121860,274;158704;1728;166400;603400;603944;644096;762104;605672;810496;;;;;;
122033,981;159424;4634;166400;603944;604881;644096;763368;609515;810496;;;;;;
122052,881;162330;1132;166400;604881;606308;644096;767211;607440;810496;;;;;;
122083,286;158828;5554;166400;606308;606733;644096;765136;612287;810496;;;;;;
122125,445;163250;1827;166400;606733;608612;644096;769983;610439;810496;;;;;;
122147,482;159523;1828;166400;608612;608900;644096;768135;610728;810496;;;;;;
122234,927;159524;3367;166912;608900;609101;644096;768424;612468;811008;;;;;;
122255,107;162087;5778;164864;609101;609716;644096;771188;615494;808960;;;;;;
122269,511;164498;640;166400;609716;610914;644096;774214;611554;810496;;;;;;
122336,735;158336;4669;166400;610914;611162;644096;769250;615831;810496;;;;;;
122350,343;162365;1059;166912;611162;612237;644096;773527;613296;811008;;;;;;
122362,842;159267;871;166400;612237;612677;644096;771504;613548;810496;;;;;;
122403,155;159079;4416;166912;612677;612909;644096;771756;617325;811008;;;;;;
122468,586;163136;896;166912;612909;614140;644096;776045;615036;811008;;;;;;
122486,415;159616;913;166912;614140;614644;644096;773756;615557;811008;;;;;;
122499,513;159633;5427;164352;614644;614829;644096;774277;620256;808448;;;;;;
122509,901;164147;1375;166912;614829;616260;644096;778976;617635;811008;;;;;;
122561,153;159583;3276;166400;616260;616493;644096;775843;619769;810496;;;;;;
122581,708;161484;3348;167424;616493;617182;644096;777977;620530;811520;;;;;;
122607,011;162580;1635;166912;617182;618118;644096;779762;619753;811008;;;;;;
122619,319;160867;991;167936;618118;618574;644096;778985;619565;812032;;;;;;
122632,635;161759;960;167936;618574;618973;644096;780333;619933;812032;;;;;;
122642,261;161728;802;167936;618973;619405;644096;780701;620207;812032;;;;;;
122668,588;161570;5461;166400;619405;619573;644096;780975;625034;810496;;;;;;
122689,376;166229;832;167424;619573;620549;644096;785802;621381;811520;;;;;;
122725,470;160576;3204;167424;620549;620782;644096;781125;623986;811520;;;;;;
122754,025;162948;2708;167936;620782;621350;644096;783730;624058;812032;;;;;;
122788,379;163476;3492;167936;621350;621718;644096;784826;625210;812032;;;;;;
122806,266;164260;3523;168448;621718;622382;644096;785978;625905;812544;;;;;;
122813,006;165315;1956;168448;622382;623837;644096;787697;625793;812544;;;;;;
122817,434;163748;1507;168960;623837;624205;644096;787585;625712;813056;;;;;;
122824,926;163811;2868;168448;624205;624765;644096;788016;627633;812544;;;;;;
122852,426;165172;1363;168960;624765;625486;644096;789937;626849;813056;;;;;;
122867,196;164179;3706;168960;625486;625870;644096;789665;629576;813056;;;;;;
122872,730;166522;1024;168960;625870;626981;644096;792392;628005;813056;;;;;;
122891,790;163666;1153;168960;626982;627222;644096;790648;628375;813056;;;;;;
122903,841;163969;1615;169472;627222;627685;644096;791191;629300;813568;;;;;;
122943,056;164943;3357;168960;627685;627918;644096;792628;631275;813056;;;;;;
122950,417;166685;3929;168448;627918;628445;644096;794603;632374;812544;;;;;;
122956,804;166745;896;168960;628445;629245;644096;795190;630141;813056;;;;;;
122979,762;163712;768;168960;629245;629717;644096;792957;630485;813056;;;;;;
122987,950;163584;1095;168960;629717;629973;644096;793301;631068;813056;;;;;;
123025,332;163911;5618;166400;629973;631218;644096;793884;636836;810496;;;;;;
123070,959;166386;5071;165888;631218;632258;644096;797604;637329;809984;;;;;;
123086,926;165839;1260;167424;632258;633762;644096;798097;635022;811520;;;;;;
123102,912;161004;1152;167424;633762;634209;644096;794766;635361;811520;;;;;;
123137,793;160896;3397;167936;634209;634714;644096;795105;638111;812032;;;;;;
123172,135;164165;1904;167936;634714;635634;644096;798879;637538;812032;;;;;;
123191,244;162672;5953;166400;635634;636180;644096;798306;642133;810496;;;;;;
123236,593;165697;3971;167424;636180;636989;644096;801877;640960;811520;;;;;;
123257,180;163715;4246;167424;636989;637916;644096;800704;642162;811520;;;;;;
123270,909;163990;928;167424;637916;639116;644096;801906;640044;811520;;;;;;
123293,747;160672;1616;167936;639116;639348;644096;799788;640964;812032;;;;;;
123303,884;161872;5224;167424;639348;640084;644096;801220;645308;811520;;;;;;
123311,230;165480;2103;167424;640084;641445;644096;805564;643548;811520;;;;;;
123317,236;161847;2610;167424;641445;641901;644096;803292;644511;811520;;;;;;
123339,913;162354;3138;168448;641901;643725;644096;804255;646863;812544;;;;;;
123339,933;3138;0;168448;643725;534845;648192;646863;534845;816640;191015;185967;786432;837878;720812;1603072
123347,869;161280;1664;167936;534845;534846;648192;696125;536510;816128;;;;;;
123361,420;162944;1059;168448;534846;535658;648192;697790;536717;816640;;;;;;
123373,190;162851;6640;168448;535658;536651;648192;698509;543291;816640;;;;;;
123383,879;168432;1136;165376;536651;538266;648192;705083;539402;813568;;;;;;
123401,479;159856;4501;166912;538266;538891;648192;698122;543392;815104;;;;;;
123415,823;163221;896;166912;538891;539914;648192;702112;540810;815104;;;;;;
123424,882;159616;1200;166912;539914;540090;648192;699530;541290;815104;;;;;;
123434,638;159920;3108;167424;540090;540363;648192;700010;543471;815616;;;;;;
123442,600;162852;928;167424;540363;541626;648192;703215;542554;815616;;;;;;
123454,789;160672;1504;167936;541626;542074;648192;702298;543578;816128;;;;;;
123458,329;162272;1217;167936;542074;542346;648192;704346;543563;816128;;;;;;
123468,633;161985;4115;167424;542346;542547;648192;704331;546662;815616;;;;;;
123481,386;164883;3180;167936;542547;544180;648192;707430;547360;816128;;;;;;
123493,190;163948;3359;168448;544180;545336;648192;708128;548695;816640;;;;;;
123500,558;165151;3236;168448;545336;546216;648192;710487;549452;816640;;;;;;
123518,306;164972;1214;168448;546216;547040;648192;711188;548254;816640;;;;;;
123535,031;163006;4843;166912;547040;547824;648192;710046;552667;815104;;;;;;
123567,520;166635;2480;168448;547824;548670;648192;714459;551150;816640;;;;;;
123590,310;163760;3856;167936;548670;549351;648192;712430;553207;816128;;;;;;
123629,483;165136;4832;167424;549351;549855;648192;714487;554687;815616;;;;;;
123646,527;165600;2306;167936;549855;550614;648192;715455;552920;816128;;;;;;
123663,226;163074;4161;168448;550614;551215;648192;713688;555376;816640;;;;;;
123681,644;165953;4712;166912;551215;551870;648192;717168;556582;815104;;;;;;
123706,214;166504;1360;167936;551870;553232;648192;718374;554592;816128;;;;;;
123733,311;162128;3076;167936;553232;553807;648192;715360;556883;816128;;;;;;
123747,626;163844;768;168448;553807;554919;648192;717651;555687;816640;;;;;;
123767,097;162560;5865;167936;554919;555095;648192;717479;560960;816128;;;;;;
123774,826;167657;5362;166912;555095;556058;648192;722752;561420;815104;;;;;;
123783,336;165106;1344;167424;556058;557514;648192;721164;558858;815616;;;;;;
123793,863;161088;1280;167424;557514;558034;648192;718602;559314;815616;;;;;;
123805,683;161024;2869;167424;558034;558490;648192;719058;561359;815616;;;;;;
123810,967;162613;4256;167936;558490;559098;648192;721103;563354;816128;;;;;;
123827,727;165024;3982;167936;559098;561694;648192;724122;565676;816128;;;;;;
123838,936;164750;1056;167936;561694;563013;648192;726444;564069;816128;;;;;;
123843,235;161824;2501;167936;563013;563341;648192;724837;565842;816128;;;;;;
123884,162;163269;4927;167936;563341;564361;648192;726610;569288;816128;;;;;;
123896,592;165695;3060;167936;564361;565178;648192;730056;568238;816128;;;;;;
123901,535;163828;2721;168448;565178;565682;648192;729006;568403;816640;;;;;;
123907,154;164001;1996;167936;565682;566106;648192;729683;568102;816128;;;;;;
123921,153;163276;800;168448;566106;567490;648192;729382;568290;816640;;;;;;
123927,497;162592;1138;168448;567490;567850;648192;730082;568988;816640;;;;;;
123935,924;162930;1458;168960;567850;568203;648192;730780;569661;817152;;;;;;
123948,627;163762;2880;168448;568203;568846;648192;731965;571726;816640;;;;;;
123966,877;165184;1176;168960;568846;571151;648192;734030;572327;817152;;;;;;
123974,865;163992;3028;168960;571151;571575;648192;735143;574603;817152;;;;;;
124014,635;165844;5608;166400;571575;573266;648192;737419;578874;814592;;;;;;
124029,543;166376;2676;167936;573266;573666;648192;739642;576342;816128;;;;;;
124066,087;163444;1456;168448;573666;573970;648192;737110;575426;816640;;;;;;
124073,710;162736;768;167936;573970;574882;648192;736706;575650;816128;;;;;;
124097,340;162048;2365;168448;574882;575250;648192;736930;577615;816640;;;;;;
124120,755;164157;4974;166912;575250;575757;648192;739407;580731;815104;;;;;;
124124,181;22894;5930;166912;575757;577365;648192;598651;583295;815104;;;;;;
124124,196;5930;0;166912;577365;538186;648192;583295;538186;815104;186648;185192;786432;769943;723378;1601536
124172,514;159744;4605;167424;538186;538186;648192;697930;542791;815616;;;;;;
124202,599;164349;3361;167424;538186;538985;648192;702535;542346;815616;;;;;;
124207,799;163105;2181;167424;538985;539569;648192;702090;541750;815616;;;;;;
124231,683;161925;3072;168448;539569;539921;648192;701494;542993;816640;;;;;;
124261,737;164352;6302;167936;539921;540891;648192;704273;547193;816128;;;;;;
124271,192;167582;1984;166912;540891;542186;648192;708473;544170;815104;;;;;;
124280,628;161728;4057;167424;542186;542722;648192;703914;546779;815616;;;;;;
124284,513;163801;1280;167936;542722;544127;648192;706523;545407;816128;;;;;;
124292,145;161536;1088;167424;544127;545255;648192;705663;546343;815616;;;;;;
124299,059;161344;800;167936;545255;545903;648192;706599;546703;816128;;;;;;
124304,124;161568;864;167936;545903;546095;648192;707471;546959;816128;;;;;;
124319,990;161632;3921;167936;546095;546447;648192;707727;550368;816128;;;;;;
124333,394;164689;7161;163328;546447;549902;648192;711136;557063;811520;;;;;;
124343,683;163321;4336;162816;549902;551158;648192;713223;555494;811008;;;;;;
124358,368;159984;3325;165376;551158;554050;648192;711142;557375;813568;;;;;;
124363,429;71429;5553;165888;554051;555215;648192;625480;560768;814080;;;;;;
124363,440;5553;0;165888;555215;539195;648192;560768;539195;814080;185527;185192;786432;746295;724387;1600512
124389,116;156672;5087;165888;539195;539195;648192;695867;544282;814080;;;;;;
124407,517;161759;5044;165888;539195;540032;648192;700954;545076;814080;;;;;;
124422,133;161716;1167;165888;540032;541192;648192;701748;542359;814080;;;;;;
124444,287;157839;1024;165888;541192;541631;648192;699031;542655;814080;;;;;;
124448,592;157696;2273;165888;541631;542023;648192;699327;544296;814080;;;;;;
124464,562;158945;4272;166400;542023;543059;648192;700968;547331;814592;;;;;;
124483,965;161968;4584;166400;543059;544000;648192;705027;548584;814592;;;;;;
124512,073;162280;2509;166912;544000;545056;648192;706280;547565;815104;;;;;;
124535,336;160717;7521;165888;545056;545379;648192;705773;552900;814080;;;;;;
124549,647;165729;1088;165888;545379;546651;648192;711108;547739;814080;;;;;;
124559,570;157760;928;165888;546651;547131;648192;704411;548059;814080;;;;;;
124572,439;157600;4083;166400;547131;547531;648192;704731;551614;814592;;;;;;
124583,500;161267;2656;165888;547531;548219;648192;708798;550875;814080;;;;;;
124591,355;159840;1936;166912;548219;549443;648192;708059;551379;815104;;;;;;
124607,032;160144;2528;166400;549443;550243;648192;709587;552771;814592;;;;;;
124646,897;160736;1120;167424;550243;551369;648192;710979;552489;815616;;;;;;
124672,010;160864;4119;167424;551369;552002;648192;712233;556121;815616;;;;;;
124693,863;163863;4124;167424;552002;552554;648192;715865;556678;815616;;;;;;
124706,474;163868;720;167424;552554;553905;648192;716422;554625;815616;;;;;;
124732,613;160464;1214;167424;553905;554057;648192;714369;555271;815616;;;;;;
124778,181;160958;2673;167424;554057;554554;648192;715015;557227;815616;;;;;;
124788,925;162417;3312;168448;554554;555211;648192;716971;558523;816640;;;;;;
124806,503;164592;3941;167936;555211;555683;648192;719803;559624;816128;;;;;;
124823,682;165221;3188;168448;555683;556610;648192;720904;559798;816640;;;;;;
124844,348;164980;4559;168448;556610;557194;648192;721590;561753;816640;;;;;;
124858,886;166351;5365;167424;557194;558007;648192;723545;563372;815616;;;;;;
124870,484;166133;1568;167936;558007;559119;648192;724140;560687;816128;;;;;;
124879,381;162336;3338;167936;559119;559631;648192;721455;562969;816128;;;;;;
124897,675;164106;2580;167936;559631;560232;648192;723737;562812;816128;;;;;;
124921,226;163348;4668;167424;560232;560857;648192;723580;565525;815616;;;;;;
124939,611;165266;1100;167936;560857;562067;648192;726123;563167;816128;;;;;;
124947,758;161868;3573;168448;562067;562300;648192;723935;565873;816640;;;;;;
124958,062;164853;3927;167936;562300;563300;648192;727153;567227;816128;;;;;;
124961,647;165207;848;168448;563300;564028;648192;728507;564876;816640;;;;;;
124988,837;162640;3919;168448;564028;564188;648192;726668;568107;816640;;;;;;
125009,640;165711;2996;168448;564188;565164;648192;729899;568160;816640;;;;;;
125011,592;164788;2017;168448;565164;566332;648192;729952;568349;816640;;;;;;
125019,775;163809;3956;167936;566332;566524;648192;730141;570480;816128;;;;;;
125037,567;165748;4616;168448;566524;567203;648192;732272;571819;816640;;;;;;
125054,105;166408;4236;168448;567203;568029;648192;733611;572265;816640;;;;;;
125058,835;166028;960;168448;568029;569331;648192;734057;570291;816640;;;;;;
125069,365;162752;3967;168448;569331;569747;648192;732083;573714;816640;;;;;;
125089,173;165759;5894;167936;569747;570148;648192;735506;576042;816128;;;;;;
125109,508;167686;2128;167936;570148;571396;648192;737834;573524;816128;;;;;;
125125,846;162896;5139;166400;571396;571804;648192;734292;576943;814592;;;;;;
125142,178;165907;1696;167424;571804;572519;648192;737711;574215;815616;;;;;;
125149,106;161440;896;167424;572519;573495;648192;733959;574391;815616;;;;;;
125153,535;160640;976;167424;573495;573792;648192;734135;574768;815616;;;;;;
125161,876;160720;1008;167424;573792;574248;648192;734512;575256;815616;;;;;;
125167,170;160752;1024;167936;574248;574384;648192;735000;575408;816128;;;;;;
125175,228;161792;1040;167936;574384;574552;648192;736176;575592;816128;;;;;;
125189,154;161808;1058;168448;574552;575008;648192;736360;576066;816640;;;;;;
125213,789;162338;2881;167936;575008;575224;648192;737346;578105;816128;;;;;;
125226,181;164161;4345;167424;575224;575781;648192;739385;580126;815616;;;;;;
125252,147;165113;1267;167936;575781;576761;648192;740894;578028;816128;;;;;;
125279,654;162035;6645;165376;576761;577986;648192;738796;584631;813568;;;;;;
125287,764;165365;1952;166912;577986;579090;648192;743351;581042;815104;;;;;;
125298,397;160672;832;167424;579090;580210;648192;739762;581042;815616;;;;;;
125315,307;160064;5141;166912;580210;580586;648192;740274;585727;815104;;;;;;
125334,572;164373;1311;166912;580586;581627;648192;744959;582938;815104;;;;;;
125355,375;160031;992;166912;581627;582041;648192;741658;583033;815104;;;;;;
125378,512;159712;5492;166400;582041;582394;648192;741753;587886;814592;;;;;;
125384,709;164212;800;166912;582394;583417;648192;746606;584217;815104;;;;;;
125401,721;159520;832;166912;583417;583554;648192;742937;584386;815104;;;;;;
125423,763;159552;3268;166912;583554;583906;648192;743106;587174;815104;;;;;;
125479,720;161988;800;167424;583906;584793;648192;745894;585593;815616;;;;;;
125490,204;160544;3269;167424;584793;585234;648192;745337;588503;815616;;;;;;
125502,438;163013;6313;165888;585234;585618;648192;748247;591931;814080;;;;;;
125654,246;165033;4577;163328;585618;586790;648192;750651;591367;811520;;;;;;
125681,309;163297;3220;166912;586790;587896;648192;750087;591116;815104;;;;;;
125690,976;161428;832;166400;587896;588768;648192;749324;589600;814592;;;;;;
125746,642;159040;2558;167424;588768;589048;648192;747808;591606;815616;;;;;;
125777,402;161790;5135;166912;589048;589632;648192;750838;594767;815104;;;;;;
125904,554;164367;4433;166400;589632;591604;648192;753999;596037;814592;;;;;;
125926,702;163153;5844;164864;591604;593380;648192;754757;599224;813056;;;;;;
125945,170;164564;4367;166912;593380;594311;648192;757944;598678;815104;;;;;;
125960,068;162575;3380;166400;594311;595263;648192;756886;598643;814592;;;;;;
125979,547;161588;6160;165888;595263;595783;648192;756851;601943;814080;;;;;;
125987,050;163735;929;166400;595783;597015;648192;759518;597944;814592;;;;;;
126008,623;158625;3481;166912;597015;597239;648192;755640;600720;815104;;;;;;
126022,663;161689;2916;166400;597239;598052;648192;758928;600968;814592;;;;;;
126077,133;161124;2735;167424;598052;598540;648192;759176;601275;815616;;;;;;
126151,907;162479;4639;167424;598540;599164;648192;761019;603803;815616;;;;;;
126218,304;164362;3341;167936;599163;600356;648192;763525;603697;816128;;;;;;
126241,689;163597;1759;167424;600356;601348;648192;763953;603107;815616;;;;;;
126294,771;162015;3327;168448;601348;602139;648192;763363;605466;816640;;;;;;
126388,342;164607;640;167936;602139;603235;648192;766746;603875;816128;;;;;;
126463,687;161920;736;167424;603235;603234;648192;765155;603970;815616;;;;;;
126482,881;161504;928;167936;603234;603235;648192;764738;604163;816128;;;;;;
126506,284;161696;1568;168448;603235;603235;648192;764931;604803;816640;;;;;;
126559,561;163360;3139;168448;603235;603459;648192;766595;606598;816640;;;;;;
126600,542;164931;6424;166400;603459;603459;648192;768390;609883;814592;;;;;;
126613,704;166168;3407;167424;603459;603651;648192;769627;607058;815616;;;;;;
126688,367;163151;3407;167936;603651;604067;648192;766802;607474;816128;;;;;;
126734,593;164175;4930;167936;604067;605146;648192;768242;610076;816128;;;;;;
126776,109;165698;2208;167936;605146;606178;648192;770844;608386;816128;;;;;;
126840,538;162976;5150;166400;606178;606803;648192;769154;611953;814592;;;;;;
126889,944;165918;3455;167936;606803;607170;648192;772721;610625;816128;;;;;;
127000,592;163711;2835;167424;607170;607171;648192;770881;610006;815616;;;;;;
127032,962;163091;5172;167424;607171;607170;648192;770262;612342;815616;;;;;;
127094,110;165940;7143;167936;607170;607654;648192;773110;614797;816128;;;;;;
127129,578;167911;7159;163328;607654;609231;648192;775565;616390;811520;;;;;;
127153,383;163319;8255;164864;609231;609879;648192;772550;618134;813056;;;;;;
127403,253;164415;3046;164864;609879;611252;648192;774294;614298;813056;;;;;;
127433,026;157670;3008;164864;611252;612323;648192;768922;615331;813056;;;;;;
127465,097;157632;2147;164864;612323;612619;648192;769955;614766;813056;;;;;;
127512,633;156771;6246;164864;612619;613130;648192;769390;619376;813056;;;;;;
127535,924;160870;2033;164864;613130;613475;648192;774000;615508;813056;;;;;;
127552,459;156657;1057;164864;613475;614715;648192;770132;615772;813056;;;;;;
127588,385;155681;720;165376;614715;615098;648192;770396;615818;813568;;;;;;
127754,166;155856;4015;164864;615098;615466;648192;770954;619481;813056;;;;;;
127775,333;159151;3208;165888;615466;616080;648192;774617;619288;814080;;;;;;
127816,506;159368;2432;165376;616080;616992;648192;775448;619424;813568;;;;;;
127837,568;158592;1010;166400;616992;617440;648192;775584;618450;814592;;;;;;
127853,710;158706;993;166400;617440;617608;648192;776146;618601;814592;;;;;;
127964,549;150689;944;166912;617608;617968;648192;768297;618912;815104;;;;;;
127964,564;944;0;166912;617968;538218;648192;618912;538218;815104;187876;185282;786432;806788;723500;1601536
128018,297;158147;1891;166400;538219;538219;648192;696366;540110;814592;;;;;;
128044,924;160099;4041;167424;538219;538796;648192;698318;542837;815616;;;;;;
128067,087;163785;1059;167424;538796;540181;648192;702581;541240;815616;;;;;;
128087,316;160803;1808;167936;540181;540517;648192;700984;542325;816128;;;;;;
128102,178;162064;768;167424;540517;540813;648192;702581;541581;815616;;;;;;
128130,875;161024;2656;168448;540813;540909;648192;701837;543565;816640;;;;;;
128177,954;163936;946;167936;540909;542085;648192;704845;543031;816128;;;;;;
128206,860;162226;3603;168448;542085;542293;648192;704311;545896;816640;;;;;;
128259,508;165395;1184;168448;542293;543356;648192;707688;544540;816640;;;;;;
128288,774;162976;928;168448;543356;543892;648192;706332;544820;816640;;;;;;
128315,828;162720;972;168448;543892;544188;648192;706612;545160;816640;;;;;;
128332,870;162764;2144;169472;544188;544252;648192;706952;546396;817664;;;;;;
128361,948;165472;3964;168960;544252;546073;648192;709724;550037;817152;;;;;;
128424,526;167292;2352;169472;546073;546750;648192;713365;549102;817664;;;;;;
128511,208;165680;640;168960;546750;547655;648192;712430;548295;817152;;;;;;
128528,864;163968;4899;167424;547655;547728;648192;711623;552627;815616;;;;;;
128554,716;166691;1248;168448;547728;549025;648192;714419;550273;816640;;;;;;
128566,026;163040;1024;168960;549025;549610;648192;712065;550634;817152;;;;;;
128607,900;163840;2352;168960;549610;550089;648192;713450;552441;817152;;;;;;
128659,335;165168;4223;168448;550089;550329;648192;715257;554552;816640;;;;;;
128681,109;167039;1281;168960;550329;551473;648192;717368;552754;817152;;;;;;
128707,569;164097;1138;168960;551473;551737;648192;715570;552875;817152;;;;;;
128715,720;163954;1024;168960;551737;552121;648192;715691;553145;817152;;;;;;
128757,163;163840;3660;168448;552121;552481;648192;715961;556141;816640;;;;;;
128793,310;166476;4500;167424;552481;553376;648192;718957;557876;815616;;;;;;
128871,525;167316;1264;168960;553376;553928;648192;720692;555192;817152;;;;;;
128892,709;163568;2049;168448;553928;554344;648192;717496;556393;816640;;;;;;
128921,100;164353;5295;167936;554344;554929;648192;718697;560224;816128;;;;;;
128934,144;167087;3264;168448;554929;556203;648192;722016;559467;816640;;;;;;
128982,948;165056;2336;168960;556203;557070;648192;721259;559406;817152;;;;;;
129003,901;164640;2507;168448;557070;557652;648192;721710;560159;816640;;;;;;
129014,766;164811;2206;169472;557652;559582;648192;722463;561788;817664;;;;;;
129022,436;165534;896;168960;559582;560330;648192;725116;561226;817152;;;;;;
129142,354;164224;4284;168448;560330;560611;648192;724554;564895;816640;;;;;;
129153,961;167100;1186;168960;560611;561555;648192;727711;562741;817152;;;;;;
129160,149;164002;6129;166912;561555;561877;648192;725557;568006;815104;;;;;;
129177,502;166897;4500;167936;561877;562934;648192;728774;567434;816128;;;;;;
129193,824;165268;1228;167936;562934;564462;648192;728202;565690;816128;;;;;;
129202,551;161996;2512;167936;564462;564934;648192;726458;567446;816128;;;;;;
129209,940;163280;896;168448;564934;566079;648192;728214;566975;816640;;;;;;
129225,733;162688;4092;165888;566079;566336;648192;728767;570428;814080;;;;;;
129240,160;165884;3452;168448;566336;566853;648192;732220;570305;816640;;;;;;
129255,995;164732;5340;167936;566853;567390;648192;731585;572730;816128;;;;;;
129290,827;166620;2384;167936;567390;567847;648192;734010;570231;816128;;;;;;
129307,544;163152;4769;167936;567847;568406;648192;730999;573175;816128;;;;;;
129314,157;165537;4728;166912;568406;569551;648192;733943;574279;815104;;;;;;
129324,050;164472;5343;167424;569551;570752;648192;734023;576095;815616;;;;;;
129345,895;165087;2032;167424;570752;572528;648192;735839;574560;815616;;;;;;
129353,642;161776;3556;167424;572528;573015;648192;734304;576571;815616;;;;;;
129366,789;163300;608;166912;573015;574535;648192;736315;575143;815104;;;;;;
129389,809;160335;880;167424;574535;574823;648192;734870;575703;815616;;;;;;
129401,832;160624;4259;167424;574823;575168;648192;735447;579427;815616;;;;;;
129463,012;164003;3909;167424;575168;576528;648192;739171;580437;815616;;;;;;
129473,966;163653;1312;167936;576528;577916;648192;740181;579228;816128;;;;;;
129506,592;161568;3188;167424;577916;578044;648192;739484;581232;815616;;;;;;
129527,700;163444;1152;167936;578044;579111;648192;741488;580263;816128;;;;;;
129561,110;161920;2448;167936;579111;579591;648192;741031;582039;816128;;;;;;
129587,133;163216;3684;168448;579591;580048;648192;742807;583732;816640;;;;;;
129616,347;165476;4091;168448;580048;580472;648192;745524;584563;816640;;;;;;
129641,160;165883;2896;168960;580476;581495;648192;746359;584391;817152;;;;;;
129673,558;165200;1538;168448;581495;582311;648192;746695;583849;816640;;;;;;
129688,410;163842;784;168960;582311;582687;648192;746153;583471;817152;;;;;;
129720,278;163600;5697;168960;582687;582983;648192;746287;588680;817152;;;;;;
129763,390;168513;3425;167936;582983;583667;648192;751496;587092;816128;;;;;;
129784,692;165217;1332;168448;583667;584691;648192;748884;586023;816640;;;;;;
129802,905;163124;3008;168448;584691;585099;648192;747815;588107;816640;;;;;;
129817,973;164794;3214;168448;585099;585579;648192;749893;588793;816640;;;;;;
129835,807;165006;3715;168960;585579;586435;648192;750585;590150;817152;;;;;;
129849,787;166531;992;168960;586435;587937;648192;752966;588929;817152;;;;;;
129865,915;163808;3284;168960;587937;588242;648192;751745;591526;817152;;;;;;
129889,895;166100;5212;168448;588242;588970;648192;754342;594182;816640;;;;;;
129903,905;168028;1232;168448;588970;590362;648192;756998;591594;816640;;;;;;
129917,645;163024;3380;168448;590362;590770;648192;753386;594150;816640;;;;;;
129941,245;165172;3056;168960;590770;591530;648192;755942;594586;817152;;;;;;
129973,162;165013;3680;168448;591530;592450;648192;756543;596130;816640;;;;;;
130040,477;165984;2964;168960;592450;592986;648192;758434;595950;817152;;;;;;
130064,949;165780;3683;168960;592986;593563;648192;758766;597246;817152;;;;;;
130076,769;166499;5773;167936;593563;594348;648192;760062;600121;816128;;;;;;
130096,318;167565;1248;168448;594348;595580;648192;761913;596828;816640;;;;;;
130141,598;163040;2836;168448;595580;596229;648192;758620;599065;816640;;;;;;
130178,664;164628;4368;168448;596229;596741;648192;760857;601109;816640;;;;;;
130184,690;166160;1056;168448;596741;598124;648192;762901;599180;816640;;;;;;
130193,472;162848;3140;168448;598124;598564;648192;760972;601704;816640;;;;;;
130208,996;164932;2260;168960;598564;599596;648192;763496;601856;817152;;;;;;
130238,179;165076;3204;168960;599596;600052;648192;764672;603256;817152;;;;;;
130260,267;166020;912;168960;600052;601228;648192;766072;602140;817152;;;;;;
130278,839;163728;1176;168960;601228;601500;648192;764956;602676;817152;;;;;;
130310,802;163992;576;168960;601500;601868;648192;765492;602444;817152;;;;;;
130319,409;163326;2425;168960;601869;602101;648192;765195;604526;817152;;;;;;
130344,418;165241;1025;169472;602101;602300;648192;767342;603325;817664;;;;;;
130399,187;164865;1872;169472;602300;602628;648192;767165;604500;817664;;;;;;
130429,577;165712;2034;169984;602628;602916;648192;768340;604950;818176;;;;;;
130443,921;166386;1170;169472;602916;603205;648192;769302;604375;817664;;;;;;
130470,878;165522;896;169984;603205;603605;648192;768727;604501;818176;;;;;;
130569,353;165760;992;169984;603605;603836;648192;769365;604828;818176;;;;;;
130587,533;165856;1617;170496;603836;604261;648192;769692;605878;818688;;;;;;
130606,266;166993;960;169984;604261;604804;648192;771254;605764;818176;;;;;;
130624,478;166336;1556;171008;604804;605029;648192;771140;606585;819200;;;;;;
130635,637;167956;896;170496;605029;605421;648192;772985;606317;818688;;;;;;
130652,204;167296;2133;171008;605421;605653;648192;772717;607786;819200;;;;;;
130688,023;169045;2560;171008;605653;605972;648192;774698;608532;819200;;;;;;
130716,255;169472;1681;171008;605972;607149;648192;775444;608830;819200;;;;;;
130743,929;168593;1151;171008;607149;607437;648192;775742;608588;819200;;;;;;
130798,580;168063;736;171008;607437;607988;648192;775500;608724;819200;;;;;;
130850,884;167648;912;171008;607988;608316;648192;775636;609228;819200;;;;;;
130871,973;167824;704;171520;608316;608668;648192;776140;609372;819712;;;;;;
130939,509;168128;656;171008;608668;608964;648192;776796;609620;819200;;;;;;
130971,182;168080;1938;171520;608964;609100;648192;777044;611038;819712;;;;;;
130976,837;169874;800;171520;609100;609428;648192;778974;610228;819712;;;;;;
131032,240;168736;3076;170496;609428;609588;648192;778164;612664;818688;;;;;;
131048,657;169988;1120;171008;609588;610612;648192;779576;611732;819200;;;;;;
131054,844;168032;1549;171520;610612;611052;648192;778644;612601;819712;;;;;;
131089,079;168973;1185;171008;611052;611332;648192;780025;612517;819200;;;;;;
131184,670;168609;2387;171520;611332;611781;648192;779941;614168;819712;;;;;;
131215,707;170323;2832;171008;611781;612403;648192;782104;615235;819200;;;;;;
131240,343;170515;977;171008;612404;613500;648192;782919;614477;819200;;;;;;
131262,962;167889;4088;171008;613500;614244;648192;781389;618332;819200;;;;;;
131282,937;171000;1888;169984;614244;615011;648192;785244;616899;818176;;;;;;
131297,977;167776;3908;169984;615011;615579;648192;782787;619487;818176;;;;;;
131305,417;169796;2064;169984;615579;616612;648192;785375;618676;818176;;;;;;
131310,892;166928;1328;169984;616612;617051;648192;783540;618379;818176;;;;;;
131320,701;166192;1184;170496;617051;617579;648192;783243;618763;818688;;;;;;
131326,757;167072;976;170496;617579;617939;648192;784651;618915;818688;;;;;;
131360,464;166864;704;170496;617939;618211;648192;784803;618915;818688;;;;;;
131403,736;166592;816;170496;618211;618451;648192;784803;619267;818688;;;;;;
131446,535;166704;2822;170496;618451;618628;648192;785155;621450;818688;;;;;;
131462,896;168710;3136;170496;618628;619155;648192;787338;622291;818688;;;;;;
131489,850;169024;1040;170496;619155;620435;648192;788179;621475;818688;;;;;;
131504,974;166928;993;170496;620435;620820;648192;787363;621813;818688;;;;;;
131566,118;95316;592;170496;620820;621091;648192;716136;621683;818688;;;;;;
131566,131;592;0;170496;621091;548364;648192;621683;548364;818688;189514;185368;786432;811197;733732;1605120
131608,101;165888;1666;170496;548364;548365;648192;714252;550031;818688;;;;;;
131636,370;167554;1167;171008;548365;548493;648192;715919;549660;819200;;;;;;
131670,878;168079;512;171008;548493;549196;648192;716572;549708;819200;;;;;;
131692,356;167424;992;171008;549196;549380;648192;716620;550372;819200;;;;;;
131714,301;167904;4092;171008;549380;549938;648192;717284;554030;819200;;;;;;
131733,713;171004;963;169984;549938;550979;648192;720942;551942;818176;;;;;;
131795,465;166851;1154;170496;550979;551274;648192;717830;552428;818688;;;;;;
131806,812;167042;1872;170496;551274;551690;648192;718316;553562;818688;;;;;;
131829,453;167760;1423;170496;551690;552107;648192;719450;553530;818688;;;;;;
131863,775;167311;4080;167936;552107;554700;648192;719418;558780;816128;;;;;;
131914,298;167920;3476;167424;554700;555884;648192;722620;559360;815616;;;;;;
131931,277;167316;1171;169472;555884;557060;648192;723200;558231;817664;;;;;;
131959,638;164499;1281;168960;557060;557340;648192;721559;558621;817152;;;;;;
131998,614;164609;832;169472;557340;557964;648192;721949;558796;817664;;;;;;
132023,640;164672;784;169472;557964;558428;648192;722636;559212;817664;;;;;;
132065,408;164624;704;169984;558428;558708;648192;723052;559412;818176;;;;;;
132096,273;165568;800;169984;558708;559036;648192;724276;559836;818176;;;;;;
132136,714;165664;965;170496;559036;559444;648192;724700;560409;818688;;;;;;
132162,954;166341;2869;169984;559444;559620;648192;725785;562489;818176;;;;;;
132170,165;168245;3445;169984;559620;559908;648192;727865;563353;818176;;;;;;
132187,722;168309;2160;169984;559908;560980;648192;728217;563140;818176;;;;;;
132230,617;167024;3380;168960;560980;561669;648192;728004;565049;817152;;;;;;
132293,659;167220;928;169472;561669;562796;648192;728889;563724;817664;;;;;;
132334,279;164768;2548;169984;562796;562996;648192;727564;565544;818176;;;;;;
132367,021;167412;3907;168960;562996;563444;648192;730408;567351;817152;;;;;;
132385,069;168771;1370;169472;563444;564684;648192;732215;566054;817664;;;;;;
132396,232;165210;1216;169472;564684;565155;648192;729894;566371;817664;;;;;;
132438,151;165056;965;169984;565155;565892;648192;730211;566857;818176;;;;;;
132508,147;165829;3310;168448;565892;566164;648192;731721;569474;816640;;;;;;
132527,960;168174;1407;169984;566164;567019;648192;734338;568426;818176;;;;;;
132538,525;165759;3568;169472;567019;567619;648192;732778;571187;817664;;;;;;
132587,961;167920;1744;169984;567619;568827;648192;735539;570571;818176;;;;;;
132658,480;166096;1056;169472;568827;569010;648192;734923;570066;817664;;;;;;
132680,972;165408;1008;169984;569010;569419;648192;734418;570427;818176;;;;;;
132712,621;165872;3333;169984;569419;569715;648192;735291;573048;818176;;;;;;
132775,195;168197;1045;169984;569715;570763;648192;737912;571808;818176;;;;;;
132802,882;165909;2964;169984;570763;570979;648192;736672;573943;818176;;;;;;
132835,337;167828;5093;167936;570979;571632;648192;738807;576725;816128;;;;;;
132863,805;167909;3888;166912;571632;572739;648192;739541;576627;815104;;;;;;
132895,086;166704;960;168960;572739;574050;648192;739443;575010;817152;;;;;;
132927,950;163264;3236;168448;574050;574242;648192;737314;577478;816640;;;;;;
132948,038;165540;1862;168960;574242;575461;648192;739782;577323;817152;;;;;;
132974,476;164678;1988;168960;575461;575773;648192;740139;577761;817152;;;;;;
132999,782;164804;2464;169472;575773;576205;648192;740577;578669;817664;;;;;;
133022,241;166304;1408;169472;576205;577189;648192;742509;578597;817664;;;;;;
133045,561;165248;960;169984;577189;577725;648192;742437;578685;818176;;;;;;
133079,553;165312;3044;169472;577725;578254;648192;743037;581298;817664;;;;;;
133152,199;167396;3678;168960;578254;578966;648192;745650;582644;817152;;;;;;
133204,303;167518;3135;169472;578966;579981;648192;746484;583116;817664;;;;;;
133231,593;166975;1343;169472;579981;581045;648192;746956;582388;817664;;;;;;
133259,580;165183;5604;169472;581045;581890;648192;746228;587494;817664;;;;;;
133268,575;169444;1761;167424;581890;583457;648192;751334;585218;815616;;;;;;
133281,849;163553;1168;168448;583457;583778;648192;747010;584946;816640;;;;;;
133290,726;162960;1155;168960;583778;584347;648192;746738;585502;817152;;;;;;
133376,968;163254;2675;168448;584347;584531;648192;747601;587206;816640;;;;;;
133399,013;164979;3969;168960;584531;585391;648192;749510;589360;817152;;;;;;
133403,837;166785;1280;168960;585391;586431;648192;752176;587711;817152;;;;;;
133412,693;164096;1074;168960;586431;587175;648192;750527;588249;817152;;;;;;
133420,692;163877;1162;168960;587176;587576;648192;751053;588738;817152;;;;;;
133434,829;163978;3348;168448;587576;588022;648192;751554;591370;816640;;;;;;
133447,037;166164;1024;168960;588022;588910;648192;754186;589934;817152;;;;;;
133460,223;163840;1184;169472;588910;589214;648192;752750;590398;817664;;;;;;
133477,493;165024;2668;169472;589214;589487;648192;754238;592155;817664;;;;;;
133496,181;166508;1056;169472;589487;590430;648192;755995;591486;817664;;;;;;
133506,284;164896;3903;169472;590430;590870;648192;755326;594773;817664;;;;;;
133511,785;167743;1258;169472;590870;591927;648192;758613;593185;817664;;;;;;
133526,044;165098;800;169472;591927;592142;648192;757025;592942;817664;;;;;;
133542,061;164640;3631;169472;592142;592414;648192;756782;596045;817664;;;;;;
133548,348;167471;993;169472;592414;593495;648192;759885;594488;817664;;;;;;
133583,520;164833;2864;169472;593495;593718;648192;758328;596582;817664;;;;;;
133641,807;166704;1296;169472;593718;595094;648192;760422;596390;817664;;;;;;
133659,853;165136;2688;169984;595094;595198;648192;760230;597886;818176;;;;;;
133713,506;167040;672;169472;595198;596376;648192;762238;597048;817664;;;;;;
133729,180;165024;1265;169984;596376;596648;648192;761400;597913;818176;;;;;;
133762,165;166129;1057;169984;596648;596960;648192;762777;598017;818176;;;;;;
133793,430;165921;1602;170496;596960;597337;648192;762881;598939;818688;;;;;;
133813,829;166978;976;169984;597337;597560;648192;764315;598536;818176;;;;;;
133839,835;166352;960;170496;597560;597881;648192;763912;598841;818688;;;;;;
133873,418;166848;944;170496;597881;598128;648192;764729;599072;818688;;;;;;
133888,037;166832;860;171008;598128;598353;648192;764960;599213;819200;;;;;;
133899,314;167772;1034;171008;598353;598544;648192;766125;599578;819200;;;;;;
133919,663;167946;1297;171520;598544;598697;648192;766490;599994;819712;;;;;;
133949,055;168721;1851;171008;598697;598808;648192;767418;600659;819200;;;;;;
133957,393;169275;944;171520;598808;599273;648192;768083;600217;819712;;;;;;
133989,268;168880;3571;171520;599273;600160;648192;768153;603731;819712;;;;;;
134014,140;171507;3332;168448;600160;600935;648192;771667;604267;816640;;;;;;
134024,915;168196;1024;169984;600935;602015;648192;769131;603039;818176;;;;;;
134037,172;165888;3012;169472;602015;602223;648192;767903;605235;817664;;;;;;
134044,410;167876;1997;169984;602223;602903;648192;770099;604900;818176;;;;;;
134066,452;166861;1891;170496;602903;603928;648192;769764;605819;818688;;;;;;
134084,238;167779;3441;170496;603928;604207;648192;771707;607648;818688;;;;;;
134107,168;169329;1408;170496;604207;605207;648192;773536;606615;818688;;;;;;
134120,216;167296;1120;170496;605207;605743;648192;772503;606863;818688;;;;;;
134145,289;167008;3947;169472;605743;606255;648192;772751;610202;817664;;;;;;
134159,343;168811;2771;169984;606255;607375;648192;775066;610146;818176;;;;;;
134179,821;167635;1436;169984;607375;607704;648192;775010;609140;818176;;;;;;
134186,611;166300;963;169984;607704;608191;648192;774004;609154;818176;;;;;;
134225,218;165827;3524;169472;608191;608488;648192;774018;612012;817664;;;;;;
134233,835;168388;3508;168448;608488;609104;648192;776876;612612;816640;;;;;;
134248,101;168372;2016;169984;609104;610640;648192;777476;612656;818176;;;;;;
134259,543;166368;1232;169472;610640;611576;648192;777008;612808;817664;;;;;;
134298,592;165545;608;169984;611576;612280;648192;777121;612888;818176;;;;;;
134324,823;165472;799;169984;612280;612568;648192;777752;613367;818176;;;;;;
134356,647;165663;913;170496;612568;612976;648192;778231;613889;818688;;;;;;
134385,175;166289;801;169984;612976;613255;648192;779265;614056;818176;;;;;;
134410,651;166177;1569;170496;613255;613488;648192;779432;615057;818688;;;;;;
134438,709;167457;928;170496;613488;613872;648192;780945;614800;818688;;;;;;
134472,830;166816;4427;169472;613872;614120;648192;780688;618547;817664;;;;;;
134500,007;169291;912;169984;614120;615335;648192;783411;616247;818176;;;;;;
134548,458;165776;1009;170496;615335;615615;648192;781111;616624;818688;;;;;;
134588,765;166385;832;169984;615615;615919;648192;782000;616751;818176;;;;;;
134605,359;166208;576;170496;615919;616215;648192;782127;616791;818688;;;;;;
134617,565;166464;880;170496;616215;616567;648192;782679;617447;818688;;;;;;
134631,380;166768;1725;171008;616567;616672;648192;783335;618397;819200;;;;;;
134659,122;168125;672;170496;616672;617199;648192;784797;617871;818688;;;;;;
134665,879;167072;859;171008;617199;617503;648192;784271;618362;819200;;;;;;
134717,995;167771;1008;171008;617503;617592;648192;785274;618600;819200;;;;;;
134751,490;167920;960;171520;617592;617935;648192;785512;618895;819712;;;;;;
134803,145;168896;1632;171520;617935;618263;648192;786831;619895;819712;;;;;;
134815,624;169568;1220;171520;618263;618655;648192;787831;619875;819712;;;;;;
134832,879;169156;1270;171520;618655;618976;648192;787811;620246;819712;;;;;;
134940,808;169206;1156;172032;618976;619375;648192;788182;620531;820224;;;;;;
134978,165;170116;3044;172032;619375;621726;648192;789491;624770;820224;;;;;;
135009,772;172004;848;169984;621726;622933;648192;793730;623781;818176;;;;;;
135034,086;167760;3744;171008;622933;623373;648192;790693;627117;819200;;;;;;
135046,640;170656;1408;169984;623373;624580;648192;794029;625988;818176;;;;;;
135061,741;167296;3152;169472;624580;625776;648192;791876;628928;817664;;;;;;
135080,245;169040;4003;168960;625776;627337;648192;794816;631340;817152;;;;;;
135131,330;167843;2674;169472;627337;629596;648192;795180;632270;817664;;;;;;
135168,113;46886;320;169984;629596;630171;648192;676482;630491;818176;;;;;;
135168,126;320;0;169984;630171;551401;648192;630491;551401;818176;186252;185131;786432;816743;736532;1604608
135199,652;164864;5090;169984;551401;552689;648192;716265;557779;818176;;;;;;
135215,294;169954;1314;166912;552689;554089;648192;722643;555403;815104;;;;;;
135234,630;163106;5901;167936;554089;554409;648192;717195;560310;816128;;;;;;
135271,722;167693;1184;167936;554409;555632;648192;722102;556816;816128;;;;;;
135303,380;161952;1320;167936;555632;556073;648192;717584;557393;816128;;;;;;
135330,289;162088;1045;168448;556073;556160;648192;718161;557205;816640;;;;;;
135347,788;162325;4415;167936;556160;556289;648192;718485;560704;816128;;;;;;
135368,057;165695;1056;167936;556289;557816;648192;721984;558872;816128;;;;;;
135416,197;161824;3313;167936;557816;558177;648192;719640;561490;816128;;;;;;
135442,079;164081;3567;168448;558177;558530;648192;722258;562097;816640;;;;;;
135459,537;165359;832;168448;558530;559576;648192;723889;560408;816640;;;;;;
135512,066;162624;3539;168448;559576;559937;648192;722200;563476;816640;;;;;;
135530,738;165331;898;168448;559937;561176;648192;725268;562074;816640;;;;;;
135590,946;162690;896;168448;561176;561424;648192;723866;562320;816640;;;;;;
135618,844;162688;1471;168448;561424;561720;648192;724112;563191;816640;;;;;;
135675,991;163263;4950;167936;561720;561992;648192;724983;566942;816128;;;;;;
135683,760;166742;4068;165888;561992;562767;648192;728734;566835;814080;;;;;;
135698,462;165860;1392;168448;562767;564135;648192;728627;565527;816640;;;;;;
135755,071;162672;1567;167936;564135;564560;648192;726807;566127;816128;;;;;;
135770,966;162847;2166;168960;564560;564920;648192;727407;567086;817152;;;;;;
135781,494;164470;5224;167936;564920;565264;648192;729390;570488;816128;;;;;;
135793,769;167528;3009;168448;565264;566640;648192;732792;569649;816640;;;;;;
135802,756;164289;976;167936;566640;567248;648192;730929;568224;816128;;;;;;
135820,029;162256;1279;168960;567248;567416;648192;729504;568695;817152;;;;;;
135855,348;163583;848;168448;567416;567783;648192;730999;568631;816640;;;;;;
135901,990;163152;6143;165888;567783;569000;648192;730935;575143;814080;;;;;;
135946,143;165887;3428;167424;569000;570148;648192;734887;573576;815616;;;;;;
136035,350;163172;2384;167936;570148;571212;648192;733320;573596;816128;;;;;;
136059,450;162640;1152;167424;571212;571916;648192;733852;573068;815616;;;;;;
136072,259;161408;3556;167936;571916;572180;648192;733324;575736;816128;;;;;;
136090,521;164324;2368;167936;572180;573180;648192;736504;575548;816128;;;;;;
136118,276;163072;968;168448;573180;573924;648192;736252;574892;816640;;;;;;
136141,761;162760;3555;168448;573924;574324;648192;736684;577879;816640;;;;;;
136181,168;165347;3332;168448;574324;575003;648192;739671;578335;816640;;;;;;
136195,101;165124;864;168448;575003;576219;648192;740127;577083;816640;;;;;;
136239,884;162656;6649;166400;576219;576745;648192;738875;583394;814592;;;;;;
136389,548;166393;4032;167424;576745;577466;648192;743138;581498;815616;;;;;;
136660,316;163776;880;167424;577466;578960;648192;741242;579840;815616;;;;;;
136867,279;160624;1720;167424;578960;579184;648192;739584;580904;815616;;;;;;
136895,663;161464;5782;165888;579184;579185;648192;740648;584967;814080;;;;;;
136900,880;164502;3926;166912;579185;579536;648192;743687;583462;815104;;;;;;
136928,317;122861;7665;163328;579535;581067;648192;702396;588732;811520;;;;;;
136928,335;7665;0;163328;581067;560980;648192;588732;560980;811520;185309;185108;786432;774041;746088;1597952
136972,745;155648;946;165376;560980;560980;648192;716628;561926;813568;;;;;;
137187,926;156594;5719;165376;560980;561407;648192;717574;567126;813568;;;;;;
137235,203;161367;3348;165376;561407;563342;648192;722774;566690;813568;;;;;;
137325,119;158996;3644;166400;563342;563806;648192;722338;567450;814592;;;;;;
137342,978;160828;1072;165888;563806;564758;648192;724634;565830;814080;;;;;;
137505,043;158256;5572;165376;564758;565166;648192;723014;570738;813568;;;;;;
137519,878;162244;1952;165888;565166;566573;648192;727410;568525;814080;;;;;;
137552,580;158624;832;166400;566573;566989;648192;725197;567821;814592;;;;;;
137584,296;158528;3524;166400;566989;567270;648192;725517;570794;814592;;;;;;
137597,220;161220;2141;166912;567270;568125;648192;728490;570266;815104;;;;;;
137608,321;160861;3040;166912;568125;568816;648192;728986;571856;815104;;;;;;
137616,534;161760;2032;167936;568816;569648;648192;730576;571680;816128;;;;;;
137636,071;162288;1392;167424;569648;570048;648192;731936;571440;815616;;;;;;
137651,860;161648;817;167936;570048;570600;648192;731696;571417;816128;;;;;;
137665,212;161585;1968;167936;570600;571208;648192;732185;573176;816128;;;;;;
137674,602;162736;1088;168448;571208;572360;648192;733944;573448;816640;;;;;;
137686,993;162880;832;168448;572360;572528;648192;735240;573360;816640;;;;;;
137697,370;162624;1533;168960;572528;572584;648192;735152;574117;817152;;;;;;
137710,359;163837;2180;168448;572584;572840;648192;736421;575020;816640;;;;;;
137726,427;164484;2125;169472;572840;573347;648192;737324;575472;817664;;;;;;
137733,255;165965;3665;169472;573347;573675;648192;739312;577340;817664;;;;;;
137747,137;167505;3805;168448;573675;574347;648192;741180;578152;816640;;;;;;
137754,039;166621;3635;168960;574347;575403;648192;740968;579038;817152;;;;;;
137771,018;166451;1948;168960;575403;575987;648192;741854;577935;817152;;;;;;
137783,935;164764;3248;168960;575987;576563;648192;740751;579811;817152;;;;;;
137790,676;166064;1088;169472;576563;576731;648192;742627;577819;817664;;;;;;
137796,988;164928;992;169472;576731;577035;648192;741659;578027;817664;;;;;;
137800,821;164832;1249;169472;577035;577483;648192;741867;578732;817664;;;;;;
137811,739;165089;3823;167936;577483;577723;648192;742572;581546;816128;;;;;;
137830,326;167663;1666;169472;577723;579087;648192;745386;580753;817664;;;;;;
137847,444;164994;768;168960;579087;579391;648192;744081;580159;817152;;;;;;
137858,927;164096;1857;169984;579391;579679;648192;743487;581536;818176;;;;;;
137869,230;166209;832;169472;579679;579887;648192;745888;580719;817664;;;;;;
137877,708;165184;940;169984;579887;580151;648192;745071;581091;818176;;;;;;
137890,429;165804;3382;168448;580151;580239;648192;745955;583621;816640;;;;;;
137904,542;168246;816;169984;580239;580599;648192;748485;581415;818176;;;;;;
137911,202;165168;898;169472;580599;580815;648192;745767;581713;817664;;;;;;
137933,841;165250;1519;169984;580815;580991;648192;746065;582510;818176;;;;;;
137943,406;166383;1024;169984;580991;581390;648192;747374;582414;818176;;;;;;
137960,339;165888;1344;170496;581390;581502;648192;747278;582846;818688;;;;;;
137967,220;167232;3348;169472;581502;581622;648192;748734;584970;817664;;;;;;
137977,967;169236;1632;170496;581622;582550;648192;750858;584182;818688;;;;;;
137987,251;167008;1184;169984;582550;583366;648192;749558;584550;818176;;;;;;
138009,162;166560;848;170496;583366;583774;648192;749926;584622;818688;;;;;;
138036,754;166736;2417;170496;583774;584111;648192;750510;586528;818688;;;;;;
138047,881;168305;1137;171008;584111;584334;648192;752416;585471;819200;;;;;;
138054,563;167537;889;170496;584334;584559;648192;751871;585448;818688;;;;;;
138076,046;167289;2101;171008;584559;584719;648192;751848;586820;819200;;;;;;
138099,274;169013;3068;169984;584719;584878;648192;753732;587946;818176;;;;;;
138128,134;169980;1901;171008;584878;585206;648192;754858;587107;819200;;;;;;
138141,934;168301;832;170496;585206;585326;648192;753507;586158;818688;;;;;;
138155,638;167232;1392;171008;585326;585422;648192;752558;586814;819200;;;;;;
138170,635;168304;1040;171008;585422;585438;648192;753726;586478;819200;;;;;;
138188,087;167952;4068;168960;585438;586321;648192;753390;590389;817152;;;;;;
138201,463;168932;1376;169984;586321;587308;648192;755253;588684;818176;;;;;;
138216,396;166240;864;170496;587308;587876;648192;753548;588740;818688;;;;;;
138227,354;166752;896;170496;587876;587908;648192;754628;588804;818688;;;;;;
138246,187;166784;512;170496;587908;588212;648192;754692;588724;818688;;;;;;
138262,923;166400;384;170496;588212;588428;648192;754612;588812;818688;;;;;;
138272,192;166272;672;171008;588428;588524;648192;754700;589196;819200;;;;;;
138280,186;167072;944;170496;588524;588740;648192;755596;589684;818688;;;;;;
138310,287;167344;1104;171008;588740;589156;648192;756084;590260;819200;;;;;;
138317,320;168016;784;171008;589156;589484;648192;757172;590268;819200;;;;;;
138334,984;167696;896;171520;589484;589572;648192;757180;590468;819712;;;;;;
138342,702;168832;1648;171520;589572;589892;648192;758404;591540;819712;;;;;;
138410,494;169584;512;171520;589892;590060;648192;759476;590572;819712;;;;;;
138463,280;168448;1425;171520;590060;590245;648192;758508;591670;819712;;;;;;
138486,139;169361;832;172032;590245;590444;648192;759606;591276;820224;;;;;;
138509,384;169280;832;171520;590444;590612;648192;759724;591444;819712;;;;;;
138532,980;169280;1504;172032;590612;590788;648192;759892;592292;820224;;;;;;
138544,020;170464;1424;172032;590788;590980;648192;761252;592404;820224;;;;;;
138563,333;170384;2129;172032;590980;591348;648192;761364;593477;820224;;;;;;
138582,180;171089;640;172032;591348;591460;648192;762437;592100;820224;;;;;;
138609,897;169600;1790;172032;591460;591621;648192;761060;593411;820224;;;;;;
138628,185;170750;1025;172032;591621;591900;648192;762371;592925;820224;;;;;;
138642,290;169985;544;172032;591900;592172;648192;761885;592716;820224;;;;;;
138654,435;169504;3045;172032;592172;592870;648192;761676;595915;820224;;;;;;
138672,599;172005;2868;169984;592870;593650;648192;764875;596518;818176;;;;;;
138700,104;169780;4080;171008;593650;596284;648192;763430;600364;819200;;;;;;
138717,765;170992;1731;167936;596284;598884;648192;767276;600615;816128;;;;;;
138740,784;165571;2211;169472;598884;599669;648192;764455;601880;817664;;;;;;
138759,834;166051;3456;168960;599669;599987;648192;765720;603443;817152;;;;;;
138773,522;167296;1020;169472;599987;601340;648192;767283;602360;817664;;;;;;
138798,168;164860;1922;169984;601340;601515;648192;766200;603437;818176;;;;;;
138827,980;166786;3619;168960;601515;601819;648192;768301;605438;817152;;;;;;
138848,570;168483;3572;169472;601819;602578;648192;770302;606150;817664;;;;;;
138869,223;167412;1655;169472;602578;603830;648192;769990;605485;817664;;;;;;
138886,437;165495;1552;169984;603830;604126;648192;769325;605678;818176;;;;;;
138904,210;165904;1697;169472;604126;604374;648192;770030;606071;817664;;;;;;
138977,857;166049;4080;168960;604374;604671;648192;770423;608751;817152;;;;;;
139004,497;167920;5620;169472;604671;606361;648192;772591;611981;817664;;;;;;
139011,445;169460;1694;167424;606361;608151;648192;775821;609845;815616;;;;;;
139026,168;163486;3860;168448;608151;608544;648192;771637;612404;816640;;;;;;
139032,256;165652;928;168448;608544;609759;648192;774196;610687;816640;;;;;;
139041,905;162720;2673;168448;609759;610216;648192;772479;612889;816640;;;;;;
139074,963;164465;6637;165376;610216;611397;648192;774681;618034;813568;;;;;;
139089,857;165357;7511;166400;611397;612132;648192;776754;619643;814592;;;;;;
139092,971;166231;8688;162816;612132;617364;648192;778363;626052;811008;;;;;;
139197,412;162800;4604;158720;617364;625781;648192;780164;630385;806912;;;;;;
139207,863;158716;1105;163328;625781;628141;648192;784497;629246;811520;;;;;;
139228,871;152657;864;163328;628141;628228;648192;780798;629092;811520;;;;;;
139274,280;152416;832;163840;628228;628700;648192;780644;629532;812032;;;;;;
139308,416;153408;4431;163840;628700;629029;648192;782108;633460;812032;;;;;;
139348,394;157007;768;164352;629029;629189;648192;786036;629957;812544;;;;;;
139387,126;154368;3550;164352;629189;629581;648192;783557;633131;812544;;;;;;
139396,893;157150;992;165376;629581;630749;648192;786731;631741;813568;;;;;;
139418,657;156128;3647;164864;630749;631020;648192;786877;634667;813056;;;;;;
139451,032;158783;4152;165888;631020;631788;648192;789803;635940;814080;;;;;;
139461,449;160824;2279;165888;631788;632502;648192;792612;634781;814080;;;;;;
139472,306;158951;3940;166400;632502;632774;648192;791453;636714;814592;;;;;;
139478,819;161636;1440;166400;632774;634166;648192;794410;635606;814592;;;;;;
139496,491;159136;3921;166912;634166;634694;648192;793302;638615;815104;;;;;;
139537,084;162641;720;166912;634694;636318;648192;797335;637038;815104;;;;;;
139549,568;159440;1778;167424;636318;636598;648192;795758;638376;815616;;;;;;
139618,196;161010;4743;166912;636598;636991;648192;797608;641734;815104;;;;;;
139660,943;163975;2016;167424;636991;638641;648192;800966;640657;815616;;;;;;
139681,666;161248;7655;166912;638641;639280;648192;799889;646935;815104;;;;;;
139703,728;166887;2112;165888;639280;641191;648192;806167;643303;814080;;;;;;
139714,193;159808;3092;166400;641191;641631;648192;800999;644723;814592;;;;;;
139734,682;160788;1247;166912;641631;642207;648192;802419;643454;815104;;;;;;
139770,397;159967;1088;166912;642207;642838;648192;802174;643926;815104;;;;;;
139790,963;159808;864;166912;642838;643047;648192;802646;643911;815104;;;;;;
139843,396;159584;4292;166912;643047;643278;648192;802631;647570;815104;;;;;;
139858,594;163012;3492;167424;643278;643974;648192;806290;647466;815616;;;;;;
139871,413;162724;1292;166912;643974;645231;648192;806698;646523;815104;;;;;;
139886,379;160524;4012;167424;645231;645814;648192;805755;649826;815616;;;;;;
139886,395;4012;0;167424;645814;565304;676864;649826;565304;844288;185160;185156;786432;834986;750460;1630720
139907,992;159744;4617;167424;565304;565304;676864;725048;569921;844288;;;;;;
139916,969;164361;2176;167424;565304;567757;676864;729665;569933;844288;;;;;;
139955,598;161920;2612;167424;567757;569457;676864;729677;572069;844288;;;;;;
139994,561;162356;3844;167936;569457;569913;676864;731813;573757;844800;;;;;;
140040,914;164612;3460;167936;569913;570841;676864;734525;574301;844800;;;;;;
140063,507;164228;3188;168448;570841;571393;676864;735069;574581;845312;;;;;;
140092,606;164980;1612;168448;571393;572434;676864;736373;574046;845312;;;;;;
140110,371;163404;1376;168448;572434;573113;676864;735838;574489;845312;;;;;;
140122,749;163168;1056;168448;573113;573641;676864;736281;574697;845312;;;;;;
140198,592;162848;1152;168960;573641;573913;676864;736489;575065;845824;;;;;;
140229,437;163968;800;168960;573913;574521;676864;737881;575321;845824;;;;;;
140318,129;163616;1456;168960;574521;574681;676864;738137;576137;845824;;;;;;
140376,515;164272;6126;168960;574681;576571;676864;738953;582697;845824;;;;;;
140404,398;168942;800;165888;576571;578905;676864;745513;579705;842752;;;;;;
140417,349;160544;1024;167424;578905;579129;676864;739449;580153;844288;;;;;;
140473,574;160768;6935;164864;579129;579506;676864;739897;586441;841728;;;;;;
140499,535;164631;5542;163328;579506;580642;676864;744137;586184;840192;;;;;;
140516,867;163238;3012;166400;580642;581618;676864;743880;584630;843264;;;;;;
140529,636;160196;992;165888;581618;582651;676864;741814;583643;842752;;;;;;
140589,908;158176;5036;165888;582651;583043;676864;740827;588079;842752;;;;;;
140617,775;162732;3844;166400;583043;583914;676864;745775;587758;843264;;;;;;
140645,724;161540;959;166912;583914;585074;676864;745454;586033;843776;;;;;;
140784,931;159679;5357;164352;585074;585370;676864;744753;590727;841216;;;;;;
140866,206;164077;2247;166912;585370;586774;676864;749447;589021;843776;;;;;;
140927,764;160455;2064;166400;586774;587269;676864;747229;589333;843264;;;;;;
140988,921;160223;1296;167424;587269;587269;676864;747492;588565;844288;;;;;;
141065,412;160528;6934;166400;587269;587269;676864;747797;594203;843264;;;;;;
141188,294;166166;2240;166400;587269;587269;676864;753435;589509;843264;;;;;;
141269,422;159936;2980;166400;587269;587269;676864;747205;590249;843264;;;;;;
141397,993;160676;2815;167424;587269;587269;676864;747945;590084;844288;;;;;;
141447,329;162047;2815;166912;587269;587269;676864;749316;590084;843776;;;;;;
141580,375;162047;5411;166912;587269;587269;676864;749316;592680;843776;;;;;;
141676,562;165155;3887;167424;587269;587269;676864;752424;591156;844288;;;;;;
141716,076;163631;4667;167424;587269;587269;676864;750900;591936;844288;;;;;;
141726,628;164411;7651;167424;587269;589010;676864;751680;596661;844288;;;;;;
141751,017;167395;5265;164352;589010;589393;676864;756405;594658;841216;;;;;;
141763,592;161937;5075;165888;589393;590210;676864;751330;595285;842752;;;;;;
141782,957;161747;7123;164864;590210;590506;676864;751957;597629;841728;;;;;;
141789,223;162771;4449;165376;590506;591321;676864;753277;595770;842240;;;;;;
141796,119;160097;5572;165888;591321;591993;676864;751418;597565;842752;;;;;;
141820,710;162244;3584;165888;591993;592904;676864;754237;596488;842752;;;;;;
141856,350;160256;3856;166400;592904;593913;676864;753160;597769;843264;;;;;;
141881,298;161552;1632;166400;593913;595209;676864;755465;596841;843264;;;;;;
141918,240;159328;2979;166400;595209;595785;676864;754537;598764;843264;;;;;;
141950,580;160675;4848;166400;595785;596521;676864;756460;601369;843264;;;;;;
141967,496;162544;4853;166912;596521;597536;676864;759065;602389;843776;;;;;;
142213,092;163573;5208;166912;597536;598433;676864;761109;603641;843776;;;;;;
142236,226;163928;2276;166912;598433;599312;676864;762361;601588;843776;;;;;;
142262,737;160996;2885;166912;599312;599737;676864;760308;602622;843776;;;;;;
142346,360;161605;3444;167424;599737;600280;676864;761342;603724;844288;;;;;;
142574,166;162676;1294;166912;600280;601457;676864;762956;602751;843776;;;;;;
142590,962;160526;3891;167424;601457;601456;676864;761983;605347;844288;;;;;;
142605,260;163635;960;167424;601456;603336;676864;765091;604296;844288;;;;;;
142685,499;160704;3859;167936;603336;603567;676864;764040;607426;844800;;;;;;
142711,975;164115;704;167424;603567;604855;676864;767682;605559;844288;;;;;;
142736,596;160960;2595;167936;604855;604999;676864;765815;607594;844800;;;;;;
142802,301;162851;3909;167424;604999;605551;676864;767850;609460;844288;;;;;;
142816,086;164165;608;167936;605551;606646;676864;769716;607254;844800;;;;;;
142882,023;161376;2172;167936;606646;606879;676864;768022;609051;844800;;;;;;
142916,625;162940;2560;168448;606879;607342;676864;769819;609902;845312;;;;;;
143006,759;163840;768;167936;607342;608326;676864;771182;609094;844800;;;;;;
143135,208;162048;1265;168448;608326;608327;676864;770374;609592;845312;;;;;;
143208,802;163057;1523;168448;608327;608327;676864;771384;609850;845312;;;;;;
143286,213;163315;2242;168960;608327;608326;676864;771642;610568;845824;;;;;;
143372,642;164990;4421;168960;608327;608326;676864;773317;612747;845824;;;;;;
143389,667;167237;3823;167936;608326;608327;676864;775563;612150;844800;;;;;;
143447,532;165615;6190;168448;608327;608327;676864;773942;614517;845312;;;;;;
143486,977;167982;5822;165376;608327;608327;676864;776309;614149;842240;;;;;;
143488,115;34661;4175;166912;608326;608327;676864;642987;612502;843776;;;;;;
143488,129;4175;0;166912;608327;557332;676864;612502;557332;843776;185388;185213;786432;797890;742545;1630208
143757,004;158720;4504;167424;557332;557332;676864;716052;561836;844288;;;;;;
143940,738;164248;3071;167424;557332;557332;676864;721580;560403;844288;;;;;;
144116,792;162815;6717;166400;557332;557332;676864;720147;564049;843264;;;;;;
144150,795;165437;3603;166912;557332;557333;676864;722769;560936;843776;;;;;;
144184,523;162323;5266;166912;557333;557332;676864;719656;562598;843776;;;;;;
144221,143;163986;6130;164864;557332;557332;676864;721318;563462;841728;;;;;;
144230,346;164850;5356;166400;557332;557332;676864;722182;562688;843264;;;;;;
144242,071;163052;7930;165888;557332;557332;676864;720384;565262;842752;;;;;;
144389,892;165626;8640;162816;557332;557333;676864;722958;565973;839680;;;;;;
144450,403;162240;9379;163328;557333;557332;676864;719573;566711;840192;;;;;;
144466,652;162797;8084;163328;557333;557332;676864;720130;565416;840192;;;;;;
144523,925;159636;9383;161280;557332;558396;676864;716968;567779;838144;;;;;;
144549,872;160935;6094;162816;558396;559188;676864;719331;565282;839680;;;;;;
144609,825;156110;6942;162304;559188;560499;676864;715298;567441;839168;;;;;;
144680,249;156958;6993;163328;560499;561578;676864;717457;568571;840192;;;;;;
144687,198;158545;6225;163328;561578;562850;676864;720123;569075;840192;;;;;;
144698,268;157777;4848;164352;562850;563594;676864;720627;568442;841216;;;;;;
144717,329;157936;5181;163840;563594;564410;676864;721530;569591;840704;;;;;;
144791,787;158269;5624;164864;564410;565466;676864;722679;571090;841728;;;;;;
144805,167;159736;2209;164352;565466;566506;676864;725202;568715;841216;;;;;;
144850,364;156321;6454;164864;566506;567569;676864;722827;574023;841728;;;;;;
144863,400;161078;709;155648;567569;568561;676864;728647;569270;832512;;;;;;
144965,956;155333;5014;164864;568561;568886;676864;723894;573900;841728;;;;;;
144976,345;159126;3497;164352;568886;569302;676864;728012;572799;841216;;;;;;
144980,768;157609;704;164864;569302;570499;676864;726911;571203;841728;;;;;;
144990,038;155328;3220;164864;570499;570715;676864;725827;573935;841728;;;;;;
145065,716;157844;3809;165376;570715;571395;676864;728559;575204;842240;;;;;;
145163,013;159457;1231;165376;571395;572587;676864;730852;573818;842240;;;;;;
145194,724;156879;5062;165888;572587;573011;676864;729466;578073;842752;;;;;;
145210,239;161222;4323;165376;573011;573791;676864;734233;578114;842240;;;;;;
145223,835;160483;2033;166400;573791;575094;676864;734274;577127;843264;;;;;;
145304,117;159217;4839;165888;575094;575325;676864;734311;580164;842752;;;;;;
145333,246;162023;4337;166912;575325;576176;676864;737348;580513;843776;;;;;;
145339,938;162545;2433;166400;576176;577457;676864;738721;579890;843264;;;;;;
145355,661;160641;1282;166912;577457;578536;676864;738098;579818;843776;;;;;;
145366,066;160002;5729;164864;578536;578809;676864;738538;584538;841728;;;;;;
145373,379;164449;976;166400;578809;580210;676864;743258;581186;843264;;;;;;
145383,240;158672;672;166400;580210;580538;676864;738882;581210;843264;;;;;;
145399,732;158368;7783;164352;580538;580915;676864;738906;588698;841216;;;;;;
145417,048;163431;4184;165376;580915;582242;676864;744346;586426;842240;;;;;;
145420,511;159832;4116;165888;582242;583142;676864;742074;587258;842752;;;;;;
145428,124;160788;1635;165888;583142;584574;676864;743930;586209;842752;;;;;;
145439,119;158307;3071;166400;584574;585221;676864;742881;588292;843264;;;;;;
145449,052;160767;4944;166400;585221;586061;676864;745988;591005;843264;;;;;;
145454,948;162640;3008;166912;586061;586848;676864;748701;589856;843776;;;;;;
145460,866;161216;928;166400;586848;588148;676864;748064;589076;843264;;;;;;
145474,868;159136;1422;166912;588148;588540;676864;747284;589962;843776;;;;;;
145495,340;160142;2020;166912;588540;589084;676864;748682;591104;843776;;;;;;
145515,345;160740;1987;167424;589084;589593;676864;749824;591580;844288;;;;;;
145547,110;161731;2256;167424;589593;590096;676864;751324;592352;844288;;;;;;
145592,075;162000;2448;168448;590096;590701;676864;752096;593149;845312;;;;;;
145622,699;163728;3781;167936;590701;591567;676864;754429;595348;844800;;;;;;
145641,528;165061;2159;168448;591567;591927;676864;756628;594086;845312;;;;;;
145657,132;163951;3716;168448;591927;592543;676864;755878;596259;845312;;;;;;
145709,737;165508;2816;168960;592543;593546;676864;758051;596362;845824;;;;;;
145725,327;165120;2434;168448;593546;594650;676864;758666;597084;845312;;;;;;
145754,023;164738;736;168960;594650;595106;676864;759388;595842;845824;;;;;;
145770,788;163552;3992;168960;595106;595354;676864;758658;599346;845824;;;;;;
145793,038;166808;6117;165888;595354;596820;676864;762162;602937;842752;;;;;;
145844,771;165861;2575;167424;596820;597923;676864;762681;600498;844288;;;;;;
145850,780;162319;2720;167936;597923;598523;676864;760242;601243;844800;;;;;;
145911,706;162976;4040;167424;598523;599228;676864;761499;603268;844288;;;;;;
145941,355;164296;2288;168448;599228;600172;676864;763524;602460;845312;;;;;;
145987,480;163568;3972;167936;600172;600612;676864;763740;604584;844800;;;;;;
146007,889;165252;4741;167424;600612;601302;676864;765864;606043;844288;;;;;;
146017,826;165509;992;167936;601302;602753;676864;766811;603745;844800;;;;;;
146024,803;161760;3982;167936;602753;603018;676864;764513;607000;844800;;;;;;
146036,833;164750;1216;167936;603018;604377;676864;767768;605593;844800;;;;;;
146070,790;161984;1909;168448;604377;604897;676864;766361;606806;845312;;;;;;
146085,951;163189;5304;167936;604897;605532;676864;768086;610836;844800;;;;;;
146108,294;166584;1188;167936;605532;606828;676864;772116;608016;844800;;;;;;
146118,930;161956;3428;167936;606828;607236;676864;768784;610664;844800;;;;;;
146132,977;164196;3091;168448;607236;607772;676864;771432;610863;845312;;;;;;
146163,028;164371;4945;167936;607772;608307;676864;772143;613252;844800;;;;;;
146230,621;166225;3380;168448;608307;608995;676864;774532;612375;845312;;;;;;
146245,138;164660;1219;167936;608995;610086;676864;773655;611305;844800;;;;;;
146287,257;162499;752;168448;610086;610470;676864;772585;611222;845312;;;;;;
146303,397;162544;800;168448;610470;610959;676864;773014;611759;845312;;;;;;
146379,918;162592;4872;167424;610959;611127;676864;773551;615999;844288;;;;;;
146465,051;165640;2383;167936;611127;611743;676864;776767;614126;844800;;;;;;
146510,336;163151;3331;168448;611743;612175;676864;774894;615506;845312;;;;;;
146580,557;165123;4081;168448;612175;612902;676864;777298;616983;845312;;;;;;
146586,051;165873;3380;168448;612902;613406;676864;778775;616786;845312;;;;;;
146609,276;165172;1120;168448;613406;614342;676864;778578;615462;845312;;;;;;
146615,033;162912;1746;168448;614342;614718;676864;777254;616464;845312;;;;;;
146621,764;163538;2369;168448;614718;614951;676864;778256;617320;845312;;;;;;
146631,600;164161;832;168960;614951;615589;676864;779112;616421;845824;;;;;;
146643,548;163648;928;168960;615589;615774;676864;779237;616702;845824;;;;;;
146732,291;163744;4512;167936;615774;615949;676864;779518;620461;844800;;;;;;
146797,563;166304;6635;168448;615949;617983;676864;782253;624618;845312;;;;;;
146813,085;168427;927;165376;617983;619696;676864;786410;620623;842240;;;;;;
146823,557;159647;8189;166912;619696;620620;676864;779343;628809;843776;;;;;;
146833,972;166909;2096;163840;620620;622847;676864;787529;624943;840704;;;;;;
146838,961;157744;1440;165376;622847;623566;676864;780591;625006;842240;;;;;;
146849,523;157088;4053;165888;623566;624102;676864;780654;628155;842752;;;;;;
146864,856;160725;2176;165888;624102;625275;676864;784827;627451;842752;;;;;;
146868,129;158848;1024;166400;625275;626379;676864;784123;627403;843264;;;;;;
146877,538;158720;3505;166400;626379;627044;676864;785099;630549;843264;;;;;;
146892,780;161201;3777;166912;627044;627755;676864;788245;631532;843776;;;;;;
146896,157;162497;2016;166912;627755;629244;676864;790252;631260;843776;;;;;;
146909,338;160736;2672;167936;629244;630232;676864;789980;632904;844800;;;;;;
146911,617;162928;2743;167424;630232;631984;676864;793160;634727;844288;;;;;;
146921,849;162999;1087;167936;631984;632224;676864;794983;633311;844800;;;;;;
146924,148;161855;1150;167936;632224;632696;676864;794079;633846;844800;;;;;;
146971,541;161918;5336;167424;632696;632856;676864;794614;638192;844288;;;;;;
146996,446;166104;576;167936;632856;634519;676864;798960;635095;844800;;;;;;
147031,717;161344;6738;164864;634519;634840;676864;795863;641578;841728;;;;;;
147052,290;164434;3540;166400;634840;636118;676864;799274;639658;843264;;;;;;
147067,562;161214;2896;167424;636117;637333;676864;797331;640229;844288;;;;;;
147088,785;162128;3652;166912;637333;637790;676864;799461;641442;843776;;;;;;
147090,000;48806;256;167424;637790;639293;676864;686596;639549;844288;;;;;;
147090,017;256;0;167424;639293;578170;676864;639549;578170;844288;185565;185230;786432;825114;763400;1630720
147158,558;159744;1057;167424;578170;578170;676864;737914;579227;844288;;;;;;
147173,162;160801;928;167936;578170;578483;676864;738971;579411;844800;;;;;;
147211,971;161696;3519;167936;578483;578714;676864;740179;582233;844800;;;;;;
147231,484;164287;1104;167936;578714;580058;676864;743001;581162;844800;;;;;;
147283,492;161872;3460;167936;580058;580682;676864;741930;584142;844800;;;;;;
147296,463;164228;832;168448;580682;581938;676864;744910;582770;845312;;;;;;
147436,800;162112;3780;167936;581938;582155;676864;744050;585935;844800;;;;;;
147519,500;165060;3616;167936;582155;582970;676864;747215;586586;844800;;;;;;
147650,196;164384;4646;167936;582970;583602;676864;747354;588248;844800;;;;;;
147671,131;165414;4292;167936;583602;584404;676864;749016;588696;844800;;;;;;
147683,838;165060;640;167936;584404;585820;676864;749464;586460;844800;;;;;;
147688,264;161408;1220;167936;585820;585965;676864;747228;587185;844800;;;;;;
147697,266;161988;976;167936;585965;586052;676864;747953;587028;844800;;;;;;
147703,817;161744;3284;168448;586052;586357;676864;747796;589641;845312;;;;;;
147705,975;164564;1456;167936;586357;587724;676864;750921;589180;844800;;;;;;
147728,109;162736;1088;168448;587724;587740;676864;750460;588828;845312;;;;;;
147732,697;162880;992;168448;587740;588100;676864;750620;589092;845312;;;;;;
147734,929;162784;1264;168960;588100;588388;676864;750884;589652;845824;;;;;;
147760,853;164080;3984;166912;588388;588477;676864;752468;592461;843776;;;;;;
147771,080;166800;1809;168960;588477;589788;676864;755277;591597;845824;;;;;;
147777,247;164113;4221;168448;589788;590097;676864;753901;594318;845312;;;;;;
147784,210;166525;2188;168960;590097;590713;676864;756622;592901;845824;;;;;;
147834,517;164492;2866;168448;590713;591976;676864;755205;594842;845312;;;;;;
147872,394;165170;3571;168960;591976;592600;676864;757146;596171;845824;;;;;;
147888,858;166387;2289;168960;592600;594239;676864;758987;596528;845824;;;;;;
147931,836;165105;896;169472;594239;594496;676864;759344;595392;846336;;;;;;
147954,520;164736;4180;168448;594496;594857;676864;759232;599037;845312;;;;;;
147983,940;168020;1056;168960;594857;596164;676864;762877;597220;845824;;;;;;
148003,232;163872;5688;168960;596164;596588;676864;760036;602276;845824;;;;;;
148015,691;168504;3988;166912;596588;597711;676864;765092;601699;843776;;;;;;
148025,368;164756;1664;167936;597711;599007;676864;762467;600671;844800;;;;;;
148078,926;162432;4404;167424;599007;599648;676864;761439;604052;844288;;;;;;
148131,079;165172;3268;167936;599648;600336;676864;764820;603604;844800;;;;;;
148164,062;164036;1120;168448;600336;601495;676864;764372;602615;845312;;;;;;
148194,946;162912;1065;168448;601495;601647;676864;764407;602712;845312;;;;;;
148214,467;162857;2449;168960;601647;601656;676864;764504;604105;845824;;;;;;
148222,264;164753;1089;168448;601656;601767;676864;766409;602856;845312;;;;;;
148234,031;163393;898;168960;601767;602279;676864;765160;603177;845824;;;;;;
148260,720;163714;3380;168960;602279;602368;676864;765993;605748;845824;;;;;;
148277,214;166196;1548;168960;602368;603488;676864;768564;605036;845824;;;;;;
148298,650;164364;2673;168960;603488;604072;676864;767852;606745;845824;;;;;;
148315,761;165489;5109;167424;604072;605784;676864;769561;610893;844288;;;;;;
148320,124;166901;836;168448;605784;607600;676864;772685;608436;845312;;;;;;
148329,535;162628;1472;168960;607600;607689;676864;770228;609161;845824;;;;;;
148358,831;163776;4933;168448;607689;608777;676864;771465;613710;845312;;;;;;
148367,159;167237;5239;167424;608777;609892;676864;776014;615131;844288;;;;;;
148388,905;166007;1648;167936;609892;611196;676864;775899;612844;844800;;;;;;
148568,825;162416;5957;166912;611196;611525;676864;773612;617482;843776;;;;;;
148580,751;165701;4166;167424;611525;612813;676864;777226;616979;844288;;;;;;
148589,435;163910;848;167424;612813;613349;676864;776723;614197;844288;;;;;;
148604,904;160592;1042;167424;613349;613573;676864;773941;614615;844288;;;;;;
148621,976;160786;802;167424;613573;614020;676864;774359;614822;844288;;;;;;
148636,208;160546;736;167424;614020;614212;676864;774566;614948;844288;;;;;;
148678,594;160480;5763;165888;614212;614557;676864;774692;620320;842752;;;;;;
148694,097;164483;3699;166912;614557;615357;676864;779040;619056;843776;;;;;;
148701,759;162419;4096;166912;615357;616308;676864;777776;620404;843776;;;;;;
148717,437;162816;2476;166912;616308;617493;676864;779124;619969;843776;;;;;;
148736,249;161196;6498;165376;617493;617860;676864;778689;624358;842240;;;;;;
148744,764;164194;3633;166400;617860;618811;676864;782054;622444;843264;;;;;;
148755,792;161329;992;166912;618811;620125;676864;780140;621117;843776;;;;;;
148780,698;159712;6169;165376;620125;620365;676864;779837;626534;842240;;;;;;
148793,946;164889;2498;166912;620365;621928;676864;785254;624426;843776;;;;;;
148800,226;160706;1569;166400;621928;622808;676864;782634;624377;843264;;;;;;
148807,619;159777;3519;167424;622808;623128;676864;782585;626647;844288;;;;;;
148830,218;162751;3300;166912;623128;623824;676864;785879;627124;843776;;;;;;
148847,668;162532;1088;167936;623824;625072;676864;786356;626160;844800;;;;;;
148883,393;161344;2691;167424;625072;625241;676864;786416;627932;844288;;;;;;
148907,754;162947;4320;167936;625241;625744;676864;788188;630064;844800;;;;;;
148921,637;165088;1798;167936;625744;627081;676864;790832;628879;844800;;;;;;
148948,797;162566;4292;167936;627081;627657;676864;789647;631949;844800;;;;;;
148955,762;165060;1025;167936;627657;628729;676864;792717;629754;844800;;;;;;
148963,400;161793;2095;168448;628729;628969;676864;790522;631064;845312;;;;;;
149001,849;163375;5014;167936;628969;629355;676864;792344;634369;844800;;;;;;
149020,274;166294;992;167936;629355;631036;676864;795649;632028;844800;;;;;;
149040,269;161760;3682;167936;631036;631381;676864;792796;635063;844800;;;;;;
149055,024;164450;1152;167936;631381;632572;676864;795831;633724;844800;;;;;;
149065,714;161920;3827;167936;632572;633141;676864;794492;636968;844800;;;;;;
149070,889;164595;3571;168448;633141;633805;676864;797736;637376;845312;;;;;;
149085,106;164851;3412;167936;633805;634495;676864;798656;637907;844800;;;;;;
149090,237;164692;4204;168448;634495;635279;676864;799187;639483;845312;;;;;;
149095,967;165996;1184;168448;635279;636887;676864;801275;638071;845312;;;;;;
149107,495;162976;1443;168448;636887;637192;676864;799863;638635;845312;;;;;;
149126,436;163235;960;168448;637192;637551;676864;800427;638511;845312;;;;;;
149137,740;162752;1211;168448;637551;637904;676864;800303;639115;845312;;;;;;
149152,107;163003;3364;168448;637904;638232;676864;800907;641596;845312;;;;;;
149159,867;165156;1215;168960;638232;639395;676864;803388;640610;845824;;;;;;
149176,869;163519;3485;168448;639395;639676;676864;802914;643161;845312;;;;;;
149205,999;165789;6131;165888;639676;640548;676864;805465;646679;842752;;;;;;
149207,933;165875;4488;167424;640548;641537;676864;806423;646025;844288;;;;;;
149216,440;164232;1657;167424;641537;642690;676864;805769;644347;844288;;;;;;
149239,530;161401;4192;167424;642690;643049;676864;804091;647241;844288;;;;;;
149263,287;163936;7426;165376;643049;644185;676864;806985;651611;842240;;;;;;
149278,790;165122;4979;166400;644185;645141;676864;809307;650120;843264;;;;;;
149288,381;162675;1546;166400;645141;647045;676864;807816;648591;843264;;;;;;
149293,184;159242;4530;166400;647045;647356;676864;806287;651886;843264;;;;;;
149298,864;162226;1955;166912;647356;649061;676864;809582;651016;843776;;;;;;
149309,314;160163;2128;166400;649061;649685;676864;809224;651813;843264;;;;;;
149315,807;160336;4124;166912;649685;650679;676864;810021;654803;843776;;;;;;
149330,108;162844;3510;166912;650679;651395;676864;813523;654905;843776;;;;;;
149350,553;162230;2512;167936;651395;652675;676864;813625;655187;844800;;;;;;
149385,521;162669;7123;167424;652674;653299;676864;815343;660422;844288;;;;;;
149423,075;167379;2594;166400;653299;654861;676864;820678;657455;843264;;;;;;
149457,384;161314;4147;166912;654861;655382;676864;816175;659529;843776;;;;;;
149479,808;162867;4559;167424;655382;656070;676864;818249;660629;844288;;;;;;
149493,412;164303;1328;167424;656070;657493;676864;820373;658821;844288;;;;;;
149501,154;161072;3647;167424;657493;657822;676864;818565;661469;844288;;;;;;
149543,993;163391;4012;167424;657822;658237;676864;821213;662249;844288;;;;;;
149609,472;163743;2632;167936;658238;659533;676864;821981;662165;844800;;;;;;
149629,932;163400;3295;167936;659533;660110;676864;822933;663405;844800;;;;;;
149697,868;164063;5065;167424;660110;660789;676864;824173;665854;844288;;;;;;
149733,256;165833;1238;167936;660789;662287;676864;826622;663525;844800;;;;;;
149872,953;162006;6029;166912;662287;662600;676864;824293;668629;843776;;;;;;
149880,840;165773;3838;167424;662600;663375;676864;828373;667213;844288;;;;;;
149896,845;163582;3163;167936;663375;663839;676864;826957;667002;844800;;;;;;
149903,594;163419;3328;167424;663839;664465;676864;827258;667793;844288;;;;;;
149912,459;163584;6524;166912;664465;665082;676864;828049;671606;843776;;;;;;
149944,704;166268;4995;167424;665082;666252;676864;831350;671247;844288;;;;;;
149971,051;164692;6341;166400;666252;666980;676864;830944;673321;843264;;;;;;
149993,378;165061;1680;166912;666980;668641;676864;832041;670321;843776;;;;;;
150004,897;160400;2884;166912;668641;668876;676864;829041;671760;843776;;;;;;
150008,541;161604;3664;166912;668876;669608;676864;830480;673272;843776;;;;;;
150026,512;162384;4831;167424;669608;670283;676864;831992;675114;844288;;;;;;
150042,895;164575;2385;167424;670283;671631;676864;834858;674016;844288;;;;;;
150068,126;162129;2587;167424;671631;671959;676864;833760;674546;844288;;;;;;
150091,979;162331;2240;167424;671959;672567;676864;834290;674807;844288;;;;;;
150117,983;161984;1420;167936;672567;673095;676864;834551;674515;844800;;;;;;
150133,585;162188;2504;167936;673095;673647;676864;835283;676151;844800;;;;;;
150140,919;163272;5816;166912;673647;673968;676864;836919;679784;843776;;;;;;
150161,003;165560;5004;167424;673968;674809;676864;839528;679813;844288;;;;;;
150170,202;164748;3279;167424;674809;675479;676864;839557;678758;844288;;;;;;
150170,215;3279;0;167424;675479;599335;708096;678758;599335;875520;185406;185238;786432;864164;784573;1661952
150179,550;159744;3604;167424;599335;599336;708096;759079;602940;875520;;;;;;
150190,295;163348;3025;167936;599336;600423;708096;762684;603448;876032;;;;;;
150205,394;163793;3828;167936;600423;600928;708096;764216;604756;876032;;;;;;
150219,499;164596;2368;168448;600928;602163;708096;765524;604531;876544;;;;;;
150247,698;164160;944;168448;602163;602411;708096;766323;603355;876544;;;;;;
150264,249;162736;2628;168448;602411;602748;708096;765147;605376;876544;;;;;;
150327,582;164420;3830;168448;602748;603051;708096;767168;606881;876544;;;;;;
150350,230;165622;827;168448;603051;604436;708096;768673;605263;876544;;;;;;
150421,199;162619;4792;166912;604436;604651;708096;767055;609443;875008;;;;;;
150518,292;166583;1370;168448;604652;605708;708096;771235;607078;876544;;;;;;
150588,293;162650;6287;167936;605708;606083;708096;768358;612370;876032;;;;;;
150625,869;167567;1185;166912;606083;607625;708096;773650;608810;875008;;;;;;
150658,798;160929;5212;165376;607625;607626;708096;768554;612838;873472;;;;;;
150674,595;164956;4375;166912;607626;608066;708096;772582;612441;875008;;;;;;
150690,688;163095;928;166912;608066;610169;708096;771161;611097;875008;;;;;;
150709,420;159648;3456;167424;610169;610434;708096;769817;613890;875520;;;;;;
150738,023;162688;4469;166912;610434;611057;708096;773122;615526;875008;;;;;;
150756,313;163701;1024;167424;611057;612700;708096;774758;613724;875520;;;;;;
150766,220;160768;3044;167424;612700;613044;708096;773468;616088;875520;;;;;;
150772,614;162788;1309;167936;613044;614164;708096;775832;615473;876032;;;;;;
150798,408;162077;5434;166400;614164;614348;708096;776241;619782;874496;;;;;;
150838,988;166202;2115;167424;614348;615376;708096;780550;617491;875520;;;;;;
150871,973;161859;4305;167424;615376;615847;708096;777235;620152;875520;;;;;;
150927,059;164049;1040;167424;615847;616975;708096;779896;618015;875520;;;;;;
150945,599;160778;7339;167424;616975;617351;708096;777753;624690;875520;;;;;;
150955,440;167083;5186;165376;617351;618382;708096;784434;623568;873472;;;;;;
150968,510;162882;2339;166400;618382;619743;708096;781264;622082;874496;;;;;;
150975,160;160035;3968;166912;619743;620422;708096;779778;624390;875008;;;;;;
150990,632;162176;800;166400;620422;622890;708096;782598;623690;874496;;;;;;
150993,535;159008;4387;166912;622890;623227;708096;781898;627614;875008;;;;;;
151012,449;163107;3740;166912;623227;623442;708096;786334;627182;875008;;;;;;
151021,323;162460;1953;167424;623442;624685;708096;785902;626638;875520;;;;;;
151036,210;161697;1056;167424;624685;625037;708096;786382;626093;875520;;;;;;
151048,990;160800;1728;167424;625037;625349;708096;785837;627077;875520;;;;;;
151056,326;161472;1232;167424;625349;626129;708096;786821;627361;875520;;;;;;
151077,151;160976;1024;167936;626129;626545;708096;787105;627569;876032;;;;;;
151110,808;161792;4367;167936;626545;627169;708096;788337;631536;876032;;;;;;
151121,317;165135;784;167936;627169;628548;708096;792304;629332;876032;;;;;;
151164,206;161552;2996;167936;628548;628708;708096;790100;631704;876032;;;;;;
151177,851;163764;3476;168448;628708;629276;708096;792472;632752;876544;;;;;;
151201,087;164660;4964;167936;629276;629676;708096;793936;634640;876032;;;;;;
151214,235;166244;5116;166912;629676;630417;708096;795920;635533;875008;;;;;;
151220,035;164860;1423;167424;630417;631815;708096;795277;633238;875520;;;;;;
151225,928;161167;3684;167424;631815;632063;708096;792982;635747;875520;;;;;;
151283,889;163428;3581;167424;632063;632631;708096;795491;636212;875520;;;;;;
151366,747;163325;7164;164864;632631;633744;708096;795956;640908;872960;;;;;;
151397,737;164860;2702;166400;633744;634553;708096;798604;637255;874496;;;;;;
151431,587;160398;4563;166912;634553;634881;708096;794951;639444;875008;;;;;;
151451,394;163283;3364;166912;634881;636663;708096;798164;640027;875008;;;;;;
151568,793;162084;6546;165888;636663;637072;708096;798747;643618;873984;;;;;;
151596,675;164242;6381;164352;637072;637952;708096;801314;644333;872448;;;;;;
151613,294;164077;4694;166400;637952;639025;708096;802029;643719;874496;;;;;;
151641,815;161878;4573;165888;639025;639984;708096;800903;644557;873984;;;;;;
151669,109;161757;4256;166912;639984;640795;708096;801741;645051;875008;;;;;;
151692,146;162464;1264;166400;640795;642424;708096;803259;643688;874496;;;;;;
151703,534;159472;4031;167424;642424;642759;708096;801896;646790;875520;;;;;;
151716,745;163263;936;166912;642759;644010;708096;806022;644946;875008;;;;;;
151726,147;160168;4952;166912;644010;644186;708096;804178;649138;875008;;;;;;
151736,989;163671;4113;166912;644185;644949;708096;807856;649062;875008;;;;;;
151749,959;162833;4211;167424;644949;645853;708096;807782;650064;875520;;;;;;
151782,431;163955;1120;167424;645853;647583;708096;809808;648703;875520;;;;;;
151798,216;160864;1376;167424;647583;648144;708096;808447;649520;875520;;;;;;
151842,520;161120;992;167424;648144;648703;708096;809264;649695;875520;;;;;;
151853,507;160736;2789;167936;648703;649160;708096;809439;651949;876032;;;;;;
151859,952;163045;1619;167424;649160;650671;708096;812205;652290;875520;;;;;;
151871,755;161875;3520;167936;650671;651430;708096;812546;654950;876032;;;;;;
151882,134;164288;1056;167936;651430;652854;708096;815718;653910;876032;;;;;;
151888,167;161824;928;168448;652854;653166;708096;814678;654094;876544;;;;;;
151901,837;162208;5064;167936;653166;653566;708096;815374;658630;876032;;;;;;
151935,462;166344;4832;166912;653566;654438;708096;819910;659270;875008;;;;;;
151969,269;164576;1453;167424;654438;656166;708096;819014;657619;875520;;;;;;
151994,473;161197;2718;167936;656166;656574;708096;817363;659292;876032;;;;;;
152023,264;162906;2573;167424;656575;656950;708096;819481;659523;875520;;;;;;
152056,277;162829;6627;164352;656950;659524;708096;819779;666151;872448;;;;;;
152107,059;164323;5699;163840;659524;661427;708096;823847;667126;871936;;;;;;
152158,859;163395;4621;166400;661427;661910;708096;824822;666531;874496;;;;;;
152187,305;161805;704;165888;661910;663446;708096;823715;664150;873984;;;;;;
152297,567;157888;3773;166400;663446;663702;708096;821334;667475;874496;;;;;;
152342,435;161469;5097;166400;663702;664727;708096;825171;669824;874496;;;;;;
152353,140;162793;1540;166400;664727;665982;708096;827520;667522;874496;;;;;;
152383,069;159236;3024;166400;665982;666382;708096;825218;669406;874496;;;;;;
152412,170;160720;3925;167424;666382;666806;708096;827102;670731;875520;;;;;;
152421,937;163157;1229;166912;666806;667806;708096;829963;669035;875008;;;;;;
152444,152;160461;6316;165376;667806;668086;708096;828267;674402;873472;;;;;;
152456,078;164012;6547;164352;668086;669041;708096;832098;675588;872448;;;;;;
152466,987;164243;2656;166400;669041;670779;708096;833284;673435;874496;;;;;;
152498,028;159840;960;165888;670779;671291;708096;830619;672251;873984;;;;;;
152529,402;158144;2556;166400;671291;671908;708096;829435;674464;874496;;;;;;
152540,550;160252;1424;166400;671908;673046;708096;832160;674470;874496;;;;;;
152581,033;159120;3941;166912;673046;673454;708096;832166;677395;875008;;;;;;
152593,714;162661;1184;166912;673454;674685;708096;836115;675869;875008;;;;;;
152621,935;159904;1266;167424;674685;674949;708096;834589;676215;875520;;;;;;
152640,089;160498;4024;166912;674949;675689;708096;835447;679713;875008;;;;;;
152673,938;163256;5781;166400;675689;676602;708096;838945;682383;874496;;;;;;
152689,220;164501;960;166912;676602;677938;708096;841103;678898;875008;;;;;;
152697,231;159680;3796;166912;677938;678514;708096;837618;682310;875008;;;;;;
152716,618;162516;1456;166912;678514;680180;708096;841030;681636;875008;;;;;;
152726,364;160176;1437;167424;680180;680864;708096;840356;682301;875520;;;;;;
152736,185;161181;1935;167424;680864;681199;708096;842045;683134;875520;;;;;;
152794,132;161679;7136;163840;681199;683426;708096;842878;690562;871936;;;;;;
152829,254;163808;4840;165888;683426;684576;708096;847234;689416;873984;;;;;;
152841,981;161512;2800;166400;684576;685136;708096;846088;687936;874496;;;;;;
152882,887;159984;1806;165888;685136;686489;708096;845120;688295;873984;;;;;;
152899,529;158990;1172;166400;686489;687302;708096;845479;688474;874496;;;;;;
152941,337;158868;4336;166400;687302;687477;708096;846170;691813;874496;;;;;;
152967,800;162032;2946;166912;687477;689616;708096;849509;692562;875008;;;;;;
153010,954;161154;3264;166400;689616;690265;708096;850770;693529;874496;;;;;;
153040,774;161472;4532;167424;690265;690859;708096;851737;695391;875520;;;;;;
153050,383;164276;3286;167424;690859;691148;708096;855135;694434;875520;;;;;;
153057,072;163030;6982;165888;691148;691711;708096;854178;698693;873984;;;;;;
153060,323;165702;2873;166912;691711;694138;708096;857413;697011;875008;;;;;;
153066,083;161593;4444;167424;694138;694730;708096;855731;699174;875520;;;;;;
153082,960;163676;2919;166912;694730;696043;708096;858406;698962;875008;;;;;;
153089,734;162151;800;167424;696043;696482;708096;858194;697282;875520;;;;;;
153094,176;160544;672;167424;696482;696770;708096;857026;697442;875520;;;;;;
153103,935;160416;1453;167424;696770;696971;708096;857186;698424;875520;;;;;;
153118,690;161197;5153;165376;696971;697259;708096;858168;702412;873472;;;;;;
153126,472;164897;1216;167424;697259;697877;708096;862156;699093;875520;;;;;;
153133,992;160448;1567;166912;697877;698149;708096;858325;699716;875008;;;;;;
153166,861;160799;1377;167936;698149;698413;708096;858948;699790;876032;;;;;;
153200,819;161322;3799;167424;698413;698893;708096;859735;702692;875520;;;;;;
153220,241;164055;3923;167936;698893;699697;708096;862948;703620;876032;;;;;;
153256,942;164691;1359;167936;699697;701240;708096;864388;702599;876032;;;;;;
153284,139;162081;4498;166912;701240;701447;708096;863321;705945;875008;;;;;;
153304,045;164242;4489;167424;701447;702346;708096;865689;706835;875520;;;;;;
153335,310;164233;1040;167424;702346;703833;708096;866579;704873;875520;;;;;;
153388,442;160784;480;167424;703833;704385;708096;864617;704865;875520;;;;;;
153429,063;160224;784;167936;704385;704585;708096;864609;705369;876032;;;;;;
153465,701;161040;672;167424;704585;704777;708096;865625;705449;875520;;;;;;
153484,420;160928;1260;168448;704777;704914;708096;865705;706174;876544;;;;;;
153498,724;162540;3699;167936;704914;705018;708096;867454;708717;876032;;;;;;
153522,654;164979;1634;168448;705018;706169;708096;869997;707803;876544;;;;;;
153522,682;1634;0;168448;706169;611756;718848;707803;611756;887296;188359;185561;786432;896162;797317;1673728
153543,262;161280;5967;167424;611756;611757;718848;773036;617724;886272;;;;;;
153547,320;167247;2484;167936;611757;614402;718848;779004;616886;886784;;;;;;
153557,888;162740;2828;167424;614402;614842;718848;777142;617670;886272;;;;;;
153579,352;162281;2839;168448;614842;615973;718848;777123;618812;887296;;;;;;
153591,353;164631;6211;168448;615973;616493;718848;780604;622704;887296;;;;;;
153611,647;168003;1697;167424;616493;618164;718848;784496;619861;886272;;;;;;
153617,981;162465;1313;167936;618164;618772;718848;780629;620085;886784;;;;;;
153627,207;162081;1088;167936;618772;619205;718848;780853;620293;886784;;;;;;
153650,977;161856;4503;167936;619205;619477;718848;781061;623980;886784;;;;;;
153660,308;165271;1089;167936;619477;621084;718848;784748;622173;886784;;;;;;
153669,065;161857;3348;167936;621084;621516;718848;782941;624864;886784;;;;;;
153702,093;164116;784;168448;621516;622772;718848;785632;623556;887296;;;;;;
153724,477;162064;1456;167936;622772;623108;718848;784836;624564;886784;;;;;;
153766,415;162736;4536;167424;623108;623357;718848;785844;627893;886272;;;;;;
153800,990;165304;864;167936;623357;624735;718848;788661;625599;886784;;;;;;
153827,243;161632;4761;167936;624735;625031;718848;786367;629792;886784;;;;;;
153845,735;165529;2676;167936;625031;626585;718848;790560;629261;886784;;;;;;
153915,526;163444;3299;168448;626585;626674;718848;790029;629973;887296;;;;;;
153924,903;164579;1184;167936;626674;627849;718848;791253;629033;886784;;;;;;
153942,469;162464;2948;168448;627849;628145;718848;790313;631093;887296;;;;;;
153962,134;164740;1580;168448;628145;628641;718848;792885;630221;887296;;;;;;
153980,894;163372;976;168960;628641;628929;718848;792013;629905;887808;;;;;;
153992,999;163792;2144;168960;628929;629145;718848;792721;631289;887808;;;;;;
154030,253;164960;1169;169472;629145;629505;718848;794105;630674;888320;;;;;;
154052,692;165009;5034;168960;629505;629827;718848;794514;634861;887808;;;;;;
154059,516;168874;4863;166912;629827;630554;718848;798701;635417;885760;;;;;;
154079,703;165631;1040;167936;630554;631529;718848;796185;632569;886784;;;;;;
154105,610;161769;6292;166400;631530;631761;718848;793299;638053;885248;;;;;;
154204,633;166036;6363;166400;631761;632402;718848;797797;638765;885248;;;;;;
154237,153;166107;6232;165376;632402;633454;718848;798509;639686;884224;;;;;;
154253,764;162904;1091;165888;633454;634830;718848;796358;635921;884736;;;;;;
154271,207;157763;5555;165888;634830;635154;718848;792593;640709;884736;;;;;;
154292,622;162227;992;165888;635154;636772;718848;797381;637764;884736;;;;;;
154296,347;157664;944;165888;636772;637205;718848;794436;638149;884736;;;;;;
154312,468;157616;3715;165888;637205;637373;718848;794821;641088;884736;;;;;;
154323,309;160387;6361;165376;637373;637909;718848;797760;644270;884224;;;;;;
154337,687;163033;2498;165888;637909;639396;718848;800942;641894;884736;;;;;;
154354,415;159170;1696;166400;639396;640093;718848;798566;641789;885248;;;;;;
154367,240;158880;1410;165888;640093;640510;718848;798973;641920;884736;;;;;;
154382,651;158594;1168;166912;640510;640926;718848;799104;642094;885760;;;;;;
154402,081;159376;832;166400;640926;641606;718848;800302;642438;885248;;;;;;
154428,979;159040;1440;167424;641606;641918;718848;800646;643358;886272;;;;;;
154465,727;160672;1682;166912;641918;642518;718848;802590;644200;885760;;;;;;
154479,260;160914;6515;165376;642518;642742;718848;803432;649257;884224;;;;;;
154492,262;164211;2747;166400;642742;643602;718848;806953;646349;885248;;;;;;
154495,192;160443;3812;167424;643602;644509;718848;804045;648321;886272;;;;;;
154504,916;163044;2204;166912;644509;645867;718848;807553;648071;885760;;;;;;
154534,585;161436;3889;167424;645867;647559;718848;807303;651448;886272;;;;;;
154545,804;163633;3346;167424;647559;648159;718848;811192;651505;886272;;;;;;
154572,915;163090;2317;168448;648159;649765;718848;811249;652082;887296;;;;;;
154609,293;163597;4390;167936;649765;650301;718848;813362;654691;886784;;;;;;
154621,460;165502;1406;167936;650300;651948;718848;815802;653354;886784;;;;;;
154683,064;162174;1136;167936;651948;652348;718848;814122;653484;886784;;;;;;
154744,485;161904;2884;168448;652348;653098;718848;814252;655982;887296;;;;;;
154769,449;164676;624;168448;653098;654193;718848;817774;654817;887296;;;;;;
154849,321;162416;6636;165376;654193;655433;718848;816609;662069;884224;;;;;;
154959,482;165356;1435;166912;655433;656964;718848;820789;658399;885760;;;;;;
154986,126;160155;3430;167424;656964;657636;718848;817119;661066;886272;;;;;;
154989,015;162662;1976;166912;657636;658652;718848;820298;660628;885760;;;;;;
154992,366;161208;6124;165888;658652;658967;718848;819860;665091;884736;;;;;;
155005,831;164844;3926;166912;658967;660022;718848;823811;663948;885760;;;;;;
155015,576;162646;960;167424;660022;661431;718848;822668;662391;886272;;;;;;
155032,059;160192;3443;166912;661431;661783;718848;821623;665226;885760;;;;;;
155054,439;162675;2589;167936;661783;662454;718848;824458;665043;886784;;;;;;
155105,914;162845;3270;167424;662454;663590;718848;825299;666860;886272;;;;;;
155123,178;163526;3912;168448;663590;664306;718848;827116;668218;887296;;;;;;
155228,256;165192;1504;167936;664306;665705;718848;829498;667209;886784;;;;;;
155261,097;162784;1661;168448;665705;665874;718848;828489;667535;887296;;;;;;
155298,830;163453;3700;168448;665874;666289;718848;829327;669989;887296;;;;;;
155326,543;165492;1200;168448;666289;667457;718848;831781;668657;887296;;;;;;
155343,480;162992;1350;168448;667457;668113;718848;830449;669463;887296;;;;;;
155407,579;163142;3768;168448;668113;668329;718848;831255;672097;887296;;;;;;
155446,674;165560;3981;168448;668329;668952;718848;833889;672933;887296;;;;;;
155504,784;165692;2188;168448;668952;670081;718848;834644;672269;887296;;;;;;
155549,637;163980;4130;168448;670081;670611;718848;834061;674741;887296;;;;;;
155571,023;165922;576;168448;670611;671995;718848;836533;672571;887296;;;;;;
155664,627;162368;5898;167936;671995;672267;718848;834363;678165;886784;;;;;;
155681,350;167690;3251;167936;672267;672988;718848;839957;676239;886784;;;;;;
155726,219;163976;2641;167936;672987;674290;718848;836963;676931;886784;;;;;;
155752,542;163409;4132;168448;674290;675103;718848;837699;679235;887296;;;;;;
155886,191;165924;4124;168448;675103;675751;718848;841027;679875;887296;;;;;;
155920,576;165916;3264;168448;675751;676674;718848;841667;679938;887296;;;;;;
155940,365;165056;963;168448;676674;677930;718848;841730;678893;887296;;;;;;
155991,115;162755;1553;168448;677930;678249;718848;840685;679802;887296;;;;;;
156027,171;163345;1250;168448;678249;678641;718848;841594;679891;887296;;;;;;
156061,915;163042;1664;168960;678641;679041;718848;841683;680705;887808;;;;;;
156074,425;163968;2192;168448;679041;679505;718848;843009;681697;887296;;;;;;
156080,828;164496;5068;167936;679505;679778;718848;844001;684846;886784;;;;;;
156105,897;166860;4002;168448;679778;680209;718848;846638;684211;887296;;;;;;
156110,171;165794;850;168448;680209;681713;718848;846003;682563;887296;;;;;;
156115,669;162642;2189;168448;681713;681857;718848;844355;684046;887296;;;;;;
156118,066;163981;3376;168960;681857;682849;718848;845838;686225;887808;;;;;;
156145,895;165680;5474;167936;682849;683121;718848;848529;688595;886784;;;;;;
156177,192;167778;3477;168448;683121;684250;718848;850899;687727;887296;;;;;;
156211,658;164757;4277;167936;684250;684833;718848;849007;689110;886784;;;;;;
156232,377;165416;3627;168448;684833;686061;718848;850249;689688;887296;;;;;;
156292,756;164907;4367;167936;686061;688546;718848;850968;692913;886784;;;;;;
156330,652;165647;2193;168448;688546;689805;718848;854193;691998;887296;;;;;;
156387,142;163985;2708;168448;689805;690021;718848;853790;692729;887296;;;;;;
156411,994;164500;4009;168448;690021;690585;718848;854521;694594;887296;;;;;;
156424,578;165801;4661;168448;690585;691489;718848;856386;696150;887296;;;;;;
156446,745;166453;1682;168448;691489;693754;718848;857942;695436;887296;;;;;;
156454,083;163474;1164;168448;693754;694257;718848;857228;695421;887296;;;;;;
156461,245;162956;1859;168448;694257;694665;718848;857213;696524;887296;;;;;;
156498,891;163651;1362;168448;694665;695321;718848;858316;696683;887296;;;;;;
156529,951;163154;5781;167424;695321;696142;718848;858475;701923;886272;;;;;;
156551,117;166549;3678;167936;696142;696749;718848;862691;700427;886784;;;;;;
156579,999;164446;5289;166912;696749;697453;718848;861195;702742;885760;;;;;;
156596,972;165033;1920;167424;697453;698444;718848;862486;700364;886272;;;;;;
156614,642;161664;1280;167936;698444;699132;718848;860108;700412;886784;;;;;;
156688,436;162048;3912;167936;699132;699485;718848;861180;703397;886784;;;;;;
156747,373;164680;1935;167936;699485;700744;718848;864165;702679;886784;;;;;;
156782,128;162703;4035;167936;700744;701015;718848;863447;705050;886784;;;;;;
156807,637;164803;3188;168448;701015;701999;718848;865818;705187;887296;;;;;;
156927,819;164468;3395;167936;701999;702527;718848;866467;705922;886784;;;;;;
157002,480;164675;3237;168960;702527;703486;718848;867202;706723;887808;;;;;;
157029,499;165541;5021;168448;703486;704519;718848;869027;709540;887296;;;;;;
157057,121;167325;6015;167424;704519;704992;718848;871844;711007;886272;;;;;;
157081,458;166783;1948;167936;704992;706265;718848;871775;708213;886784;;;;;;
157090,312;162716;896;167936;706265;707809;718848;868981;708705;886784;;;;;;
157108,758;161664;4128;167936;707809;708033;718848;869473;712161;886784;;;;;;
157123,587;164896;2304;167936;708033;709480;718848;872929;711784;886784;;;;;;
157124,366;89382;5416;166400;709481;711728;718848;798863;717144;885248;;;;;;
157124,382;5416;0;166400;711728;622915;718848;717144;622915;885248;185785;185380;786432;902929;808295;1671680
157149,002;160768;3136;167936;622915;622916;718848;783683;626052;886784;;;;;;
157172,170;163392;2492;167424;622916;625428;718848;786308;627920;886272;;;;;;
157185,460;162748;6444;166912;625428;626180;718848;788176;632624;885760;;;;;;
157196,654;166188;3710;167424;626180;627195;718848;792368;630905;886272;;;;;;
157227,888;163454;7671;165376;627195;627924;718848;790649;635595;884224;;;;;;
157239,313;165367;6378;164352;627924;629449;718848;793291;635827;883200;;;;;;
157249,211;164074;3524;166400;629449;630268;718848;793523;633792;885248;;;;;;
157257,907;160708;1264;165888;630268;631548;718848;790976;632812;884736;;;;;;
157264,833;158448;896;165888;631548;631932;718848;789996;632828;884736;;;;;;
157265,613;157568;961;165888;631932;632204;718848;789500;633165;884736;;;;;;
157275,269;157633;3043;166400;632204;632436;718848;789837;635479;885248;;;;;;
157279,395;160227;992;165888;632436;633771;718848;792663;634763;884736;;;;;;
157285,821;158176;1128;166912;633771;633939;718848;791947;635067;885760;;;;;;
157301,560;159848;738;166912;633939;634363;718848;793787;635101;885760;;;;;;
157305,636;159458;3315;167424;634363;634588;718848;793821;637903;886272;;;;;;
157365,690;162547;5115;166912;634588;635284;718848;797135;640399;885760;;;;;;
157399,905;164347;4177;166912;635284;636876;718848;799631;641053;885760;;;;;;
157445,733;162897;5830;164864;636876;637846;718848;799773;643676;883712;;;;;;
157498,650;164550;4641;166400;637846;638903;718848;802396;643544;885248;;;;;;
157505,870;162337;3840;166400;638903;640126;718848;801240;643966;885248;;;;;;
157562,533;161536;920;166912;640126;642971;718848;801662;643891;885760;;;;;;
157693,439;159640;2516;166912;642971;643575;718848;802611;646091;885760;;;;;;
157800,179;161236;4483;166400;643575;643903;718848;804811;648386;885248;;;;;;
157826,753;163203;896;166912;643903;645478;718848;807106;646374;885760;;;;;;
157930,416;159616;2377;167424;645478;645703;718848;805094;648080;886272;;;;;;
157963,511;162121;5080;167424;645703;646209;718848;807824;651289;886272;;;;;;
157975,595;164824;945;167424;646209;647569;718848;811033;648514;886272;;;;;;
158001,800;160689;999;167424;647569;647898;718848;808258;648897;886272;;;;;;
158106,325;160743;2988;167936;649195;649370;718848;809938;652358;886784;;;;;;
158151,134;163244;3470;167424;649375;650400;718848;812619;653870;886272;;;;;;
158167,965;163726;1260;167936;650400;651665;718848;814126;652925;886784;;;;;;
158182,886;162028;1408;167936;651665;651976;718848;813693;653384;886784;;;;;;
158271,009;162176;672;168448;651976;652560;718848;814152;653232;887296;;;;;;
158323,532;162464;3762;168448;652560;652744;718848;815024;656506;887296;;;;;;
158342,949;165554;2623;168448;652744;653188;718848;818298;655811;887296;;;;;;
158363,082;164415;4113;168448;653188;653899;718848;817603;658012;887296;;;;;;
158417,938;165905;1072;168448;653899;655308;718848;819804;656380;887296;;;;;;
158454,096;162864;2542;168448;655308;655419;718848;818172;657961;887296;;;;;;
158469,848;164196;4025;167936;655419;656140;718848;819615;660165;886784;;;;;;
158585,374;165817;3862;168448;656140;657531;718848;821957;661393;887296;;;;;;
158599,058;165654;4944;167424;657531;657900;718848;823185;662844;886272;;;;;;
158630,204;165712;5263;166400;657900;658544;718848;823612;663807;885248;;;;;;
158633,499;166031;5473;167424;658544;660424;718848;824575;665897;886272;;;;;;
158646,138;165217;832;167424;660424;665255;718848;825641;666087;886272;;;;;;
158782,881;160576;7126;165376;665255;665872;718848;825831;672998;884224;;;;;;
158802,147;164822;3314;166400;665872;666265;718848;830694;669579;885248;;;;;;
158805,151;161010;8160;161280;666265;671164;718848;827275;679324;880128;;;;;;
158862,872;161248;2285;155648;671164;679093;718848;832412;681378;874496;;;;;;
158888,961;155373;4167;164352;679093;680564;718848;834466;684731;883200;;;;;;
158919,511;157255;880;163840;680564;682020;718848;837819;682900;882688;;;;;;
159082,342;153968;5649;164352;682020;682276;718848;835988;687925;883200;;;;;;
159198,708;159249;5846;164352;682276;683421;718848;841525;689267;883200;;;;;;
159227,733;159446;1409;164864;683421;684724;718848;842867;686133;883712;;;;;;
159244,207;155521;2820;164352;684724;684973;718848;840245;687793;883200;;;;;;
159265,728;156932;6193;164864;684973;685461;718848;841905;691654;883712;;;;;;
159281,685;160817;512;164864;685461;690393;718848;846278;690905;883712;;;;;;
159334,755;155136;3988;165376;690393;690825;718848;845529;694813;884224;;;;;;
159349,186;159124;3936;164864;690825;691426;718848;849949;695362;883712;;;;;;
159356,097;159072;1469;165888;691426;692330;718848;850498;693799;884736;;;;;;
159365,045;158141;4122;165888;692330;693027;718848;850471;697149;884736;;;;;;
159371,399;160794;1360;166400;693027;694284;718848;853821;695644;885248;;;;;;
159381,959;159056;3557;166400;694284;694972;718848;853340;698529;885248;;;;;;
159396,489;161253;896;166912;694972;696875;718848;856225;697771;885760;;;;;;
159434,938;159616;5780;164864;696875;697164;718848;856491;702944;883712;;;;;;
159444,036;164500;768;166400;697164;699323;718848;861664;700091;885248;;;;;;
159499,248;158464;848;166400;699323;699403;718848;857787;700251;885248;;;;;;
159540,800;158544;2228;166912;699403;700020;718848;857947;702248;885760;;;;;;
159617,147;160436;6773;165376;700020;700707;718848;860456;707480;884224;;;;;;
159618,641;164981;8440;163840;700707;702519;718848;865688;710959;882688;;;;;;
159627,976;163064;1074;164864;702519;706239;718848;865583;707313;883712;;;;;;
159706,364;155698;4760;164864;706239;706415;718848;861937;711175;883712;;;;;;
159706,870;158327;10227;164864;706415;708002;718848;864742;718229;883712;;;;;;
159916,256;164771;8496;159232;708003;713517;718848;872774;722013;878080;;;;;;
159916,281;8496;0;159232;713517;621433;730112;722013;621433;889344;185732;185327;786432;907745;806760;1675776
159935,337;150528;4880;184320;621433;621434;730112;771961;626314;914432;;;;;;
159988,374;184080;4291;185344;621434;626134;730112;805514;630425;915456;;;;;;
160040,677;177859;6362;175104;626134;626534;730112;803993;632896;905216;;;;;;
160079,724;174810;6431;169984;626534;627399;730112;801344;633830;900096;;;;;;
160135,226;169759;3455;162304;627399;628793;730112;797158;632248;892416;;;;;;
160146,156;162175;704;160768;628793;630018;730112;790968;630722;890880;;;;;;
160206,470;154816;5101;159232;630018;630353;730112;784834;635454;889344;;;;;;
160213,510;159213;1989;164352;630353;631933;730112;789566;633922;894464;;;;;;
160258,907;155589;4250;164352;631933;632158;730112;787522;636408;894464;;;;;;
160271,076;157850;4753;165376;632158;632373;730112;790008;637126;895488;;;;;;
160273,019;159889;9040;164352;632373;635105;730112;792262;644145;894464;;;;;;
160620,288;164120;2556;164352;635105;637522;730112;799225;640078;894464;;;;;;
160693,917;156156;9497;163328;637522;638664;730112;793678;648161;893440;;;;;;
160695,190;163097;7560;162304;638664;640287;730112;801761;647847;892416;;;;;;
160857,007;158088;2931;162816;640287;644032;730112;798375;646963;892928;;;;;;
160892,847;153459;2197;163328;644032;645183;730112;797491;647380;893440;;;;;;
160909,289;153749;1058;163328;645183;645567;730112;798932;646625;893440;;;;;;
161004,772;152610;3867;163840;645567;645807;730112;798177;649674;893952;;;;;;
161029,878;155931;967;163328;645807;647175;730112;801738;648142;893440;;;;;;
161062,545;153031;4168;164864;647175;647494;730112;800206;651662;894976;;;;;;
161068,724;157768;832;163840;647494;649033;730112;805262;649865;893952;;;;;;
161175,845;154432;5786;163840;649033;649281;730112;803465;655067;893952;;;;;;
161215,432;159386;4294;164352;649281;650432;730112;808667;654726;894464;;;;;;
161316,302;157894;1446;165376;650432;651792;730112;808326;653238;895488;;;;;;
161722,620;156582;5783;164864;651792;652240;730112;808374;658023;894976;;;;;;
161792,735;160919;5978;164864;652240;653491;730112;813159;659469;894976;;;;;;
161827,804;160602;4773;164864;653491;654915;730112;814093;659688;894976;;;;;;
161876,551;159397;5007;165376;654915;655759;730112;814312;660766;895488;;;;;;
162046,131;160655;4736;165376;655759;657154;730112;816414;661890;895488;;;;;;
162122,393;160384;7153;164864;657154;657153;730112;817538;664306;894976;;;;;;
162137,460;162801;4208;165376;657153;657153;730112;819954;661361;895488;;;;;;
162151,195;159856;6136;164864;657153;657857;730112;817009;663993;894976;;;;;;
162161,274;161784;3984;165376;657857;658784;730112;819641;662768;895488;;;;;;
162181,893;159632;2676;165888;658784;660196;730112;818416;662872;896000;;;;;;
162195,982;159348;3215;165888;660196;660572;730112;819544;663787;896000;;;;;;
162219,989;159887;2078;166400;660572;661820;730112;820459;663898;896512;;;;;;
162238,649;159774;4725;166400;661820;662554;730112;821594;667279;896512;;;;;;
162288,894;162421;3365;166912;662554;664538;730112;824975;667903;897024;;;;;;
162309,009;161573;2208;166400;664538;665254;730112;826111;667462;896512;;;;;;
162921,971;160416;1744;166912;665254;666447;730112;825670;668191;897024;;;;;;
163371,471;160464;4778;166912;666447;667103;730112;826911;671881;897024;;;;;;
163431,455;163498;5914;165888;667103;667103;730112;830601;673017;896000;;;;;;
163464,099;163610;3343;166400;667103;667103;730112;830713;670446;896512;;;;;;
163517,847;71962;3150;166912;667103;667103;730112;739065;670253;897024;;;;;;
163517,863;3150;0;166912;667103;616109;730112;670253;616109;897024;185338;185312;786432;855591;801421;1683456
163690,666;158720;5512;166912;616109;616109;730112;774829;621621;897024;;;;;;
163721,656;164232;2257;166912;616109;616109;730112;780341;618366;897024;;;;;;
163904,885;160977;3755;166912;616109;616109;730112;777086;619864;897024;;;;;;
163946,121;162475;5778;166400;616109;616109;730112;778584;621887;896512;;;;;;
164188,397;164498;5693;166912;616109;616109;730112;780607;621802;897024;;;;;;
164234,517;164413;5219;166912;616109;616109;730112;780522;621328;897024;;;;;;
164263,297;163939;7873;166912;616109;616109;730112;780048;623982;897024;;;;;;
164277,766;166593;6097;164864;616109;616109;730112;782702;622206;894976;;;;;;
164288,400;162769;8952;165888;616109;616109;730112;778878;625061;896000;;;;;;
164297,262;165624;8273;161792;616109;616109;730112;781733;624382;891904;;;;;;
164313,141;160837;6655;163840;616109;617076;730112;776946;623731;893952;;;;;;
164329,796;159231;8745;162304;617076;617820;730112;776307;626565;892416;;;;;;
164333,068;160297;7810;163328;617820;618868;730112;778117;626678;893440;;;;;;
164340,341;159362;4924;163840;618868;619964;730112;778230;624888;893952;;;;;;
164346,928;156988;6859;163328;619964;621043;730112;776952;627902;893440;;;;;;
164367,638;158923;3487;163840;621043;622173;730112;779966;625660;893952;;;;;;
164383,168;156063;5464;163840;622173;622901;730112;778236;628365;893952;;;;;;
164404,575;157992;6315;164864;622901;623933;730112;780893;630248;894976;;;;;;
164417,354;160427;1690;164352;623933;626210;730112;784360;627900;894464;;;;;;
164447,448;155802;6567;164352;626210;626402;730112;782012;632969;894464;;;;;;
164497,453;160167;3280;164352;626402;628568;730112;786569;631848;894464;;;;;;
164537,097;156880;1760;164352;628568;629656;730112;785448;631416;894464;;;;;;
164610,396;155360;816;164352;629656;629840;730112;785016;630656;894464;;;;;;
164643,831;154416;831;164352;629840;630184;730112;784256;631015;894464;;;;;;
164692,013;154385;4769;164352;630184;630296;730112;784569;635065;894464;;;;;;
164745,678;158369;4692;164864;630296;631299;730112;788665;635991;894976;;;;;;
164769,476;159316;864;164864;631299;632835;730112;790615;633699;894976;;;;;;
164801,303;155488;3444;165376;632835;633051;730112;788323;636495;895488;;;;;;
164820,112;158580;912;164864;633051;634362;730112;791631;635274;894976;;;;;;
164873,770;156048;5197;165376;634362;634666;730112;790410;639863;895488;;;;;;
164927,316;160845;5480;165376;634666;635430;730112;795511;640910;895488;;;;;;
164970,108;161128;1024;165376;635430;637061;730112;796558;638085;895488;;;;;;
165014,661;156672;1056;165376;637061;637061;730112;793733;638117;895488;;;;;;
165053,982;156704;3024;166400;637061;637061;730112;793765;640085;896512;;;;;;
165069,925;160208;5256;165888;637061;637566;730112;797269;642822;896000;;;;;;
165104,241;162440;2339;166400;637566;638462;730112;800006;640801;896512;;;;;;
165388,409;159523;1090;165888;638462;639605;730112;797985;640695;896000;;;;;;
165623,078;158274;6207;165376;639605;640278;730112;797879;646485;895488;;;;;;
165661,112;162879;4691;165888;640278;640277;730112;803157;644968;896000;;;;;;
165765,437;161363;8527;163840;640277;640277;730112;801640;648804;893952;;;;;;
165834,993;163151;3816;164864;640277;640277;730112;803428;644093;894976;;;;;;
165855,314;158440;3542;165888;640277;640277;730112;798717;643819;896000;;;;;;
165948,856;159702;4716;165376;640277;640277;730112;799979;644993;895488;;;;;;
166010,070;160876;8178;163840;640277;640278;730112;801153;648456;893952;;;;;;
166248,947;162802;7121;161792;640278;640277;730112;803080;647398;891904;;;;;;
166339,809;161745;9054;162304;640277;640278;730112;802022;649332;892416;;;;;;
166381,734;160606;9856;161792;640278;640277;730112;800884;650133;891904;;;;;;
166391,869;161408;6948;162304;640277;640278;730112;801685;647226;892416;;;;;;
166399,420;156452;10089;159744;640278;640933;730112;796730;651022;889856;;;;;;
166415,730;159593;8778;160768;640933;641614;730112;800526;650392;890880;;;;;;
166430,622;156234;10409;158208;641614;642015;730112;797848;652424;888320;;;;;;
166454,114;157865;10065;159744;642015;643167;730112;799880;653232;889856;;;;;;
166496,603;155473;5993;160256;643167;644463;730112;798640;650456;890368;;;;;;
166522,523;151401;7233;161280;644463;645527;730112;795864;652760;891392;;;;;;
166550,307;154177;6080;160768;645527;647050;730112;799704;653130;890880;;;;;;
166571,037;153024;7677;162304;647050;648937;730112;800074;656614;892416;;;;;;
166582,602;156669;4150;161792;648937;650002;730112;805606;654152;891904;;;;;;
166599,406;153142;2544;162304;650002;651257;730112;803144;653801;892416;;;;;;
166604,720;152048;2916;162304;651257;652037;730112;803305;654953;892416;;;;;;
166612,037;152420;2128;162304;652037;652445;730112;804457;654573;892416;;;;;;
166618,694;151632;1047;162304;652445;653629;730112;804077;654676;892416;;;;;;
166624,249;150551;5877;162816;653629;653925;730112;804180;659802;892928;;;;;;
166636,391;155893;4357;162304;653925;654837;730112;809818;659194;892416;;;;;;
166650,758;154373;3780;163328;654837;656165;730112;809210;659945;893440;;;;;;
166658,666;155332;3684;163328;656165;657149;730112;811497;660833;893440;;;;;;
166678,309;155236;3968;164352;657149;657766;730112;812385;661734;894464;;;;;;
166687,117;157056;1908;163840;657766;659550;730112;814822;661458;893952;;;;;;
166692,473;154996;4430;164864;659550;659973;730112;814546;664403;894976;;;;;;
166709,000;158542;4373;164352;659973;661357;730112;818515;665730;894464;;;;;;
166733,477;158485;1247;165376;661357;662555;730112;819842;663802;895488;;;;;;
166747,254;156895;3204;165376;662555;663450;730112;819450;666654;895488;;;;;;
166762,728;158852;3985;166400;663450;663842;730112;822302;667827;896512;;;;;;
166781,593;161169;4177;165888;663842;664594;730112;825011;668771;896000;;;;;;
166789,948;161361;2288;166912;664594;665746;730112;825955;668034;897024;;;;;;
166809,666;161008;6716;165888;665746;666418;730112;826754;673134;896000;;;;;;
166839,376;165436;1233;166400;666418;668987;730112;831854;670220;896512;;;;;;
166865,026;158929;4019;166400;668987;669370;730112;827916;673389;896512;;;;;;
166909,167;161715;3967;166912;669370;670530;730112;831085;674497;897024;;;;;;
166931,325;162175;6323;166400;670530;671309;730112;832705;677632;896512;;;;;;
166949,369;164531;3284;166912;671309;672547;730112;835840;675831;897024;;;;;;
167036,743;161492;1296;166400;672547;673963;730112;834039;675259;896512;;;;;;
167043,429;159504;1376;166912;673963;674643;730112;833467;676019;897024;;;;;;
167107,347;160096;4399;166912;674643;674803;730112;834739;679202;897024;;;;;;
167119,779;145024;5530;165888;674803;675407;730112;819827;680937;896000;;;;;;
167119,797;5530;0;165888;675407;632537;730112;680937;632537;896000;186184;185347;786432;867121;817884;1682432
167197,266;157696;1248;166400;632537;632537;730112;790233;633785;896512;;;;;;
167237,478;158944;1744;166912;632537;633225;730112;791481;634969;897024;;;;;;
167270,076;159952;2112;166400;633225;633769;730112;793177;635881;896512;;;;;;
167275,724;160320;1376;166912;633769;635132;730112;794089;636508;897024;;;;;;
167279,749;160096;960;166912;635132;635984;730112;795228;636944;897024;;;;;;
167313,476;159680;3572;167424;635984;636320;730112;795664;639892;897536;;;;;;
167323,446;163316;928;167424;636320;637768;730112;799636;638696;897536;;;;;;
167345,964;92261;5822;166400;637768;638033;730112;730029;643855;896512;;;;;;
167346,029;5822;0;166400;638033;635530;730112;643855;635530;896512;185543;185491;786432;829398;821021;1682944
167472,012;158720;6295;165376;635530;635530;730112;794250;641825;895488;;;;;;
167550,128;165015;1031;166400;635530;637318;730112;800545;638349;896512;;;;;;
167593,174;158727;4142;166400;637318;637654;730112;796045;641796;896512;;;;;;
167633,756;161838;1079;166400;637654;638902;730112;799492;639981;896512;;;;;;
167650,350;158775;2262;166400;638902;639373;730112;797677;641635;896512;;;;;;
167712,504;159958;7596;164864;639373;639637;730112;799331;647233;894976;;;;;;
167763,650;164268;999;165888;639637;641485;730112;803905;642484;896000;;;;;;
167796,753;157671;3288;166400;641485;641749;730112;799156;645037;896512;;;;;;
167998,464;160472;7697;165376;641749;642308;730112;802221;650005;895488;;;;;;
168159,570;164881;7124;164352;642308;643788;730112;807189;650912;894464;;;;;;
168220,091;161748;9407;164352;643788;643788;730112;805536;653195;894464;;;;;;
168237,197;164031;5087;163328;643788;643788;730112;807819;648875;893440;;;;;;
168284,683;157663;3089;163840;643788;644796;730112;801451;647885;893952;;;;;;
168300,805;155665;2439;164352;644796;646227;730112;800461;648666;894464;;;;;;
168315,821;156039;1248;164352;646227;646874;730112;802266;648122;894464;;;;;;
168331,696;154848;2280;164864;646874;647403;730112;801722;649683;894976;;;;;;
168346,987;156392;3697;164352;647403;647942;730112;803795;651639;894464;;;;;;
168368,864;157809;1797;165888;647942;649302;730112;805751;651099;896000;;;;;;
168384,115;157957;4349;165376;649302;649733;730112;807259;654082;895488;;;;;;
168393,575;160509;2183;166400;649733;650301;730112;810242;652484;896512;;;;;;
168411,176;159367;2580;165888;650301;651524;730112;809668;654104;896000;;;;;;
168430,125;159764;1088;166912;651524;651980;730112;811288;653068;897024;;;;;;
168438,387;159296;3971;166400;651980;652229;730112;811276;656200;896512;;;;;;
168455,308;162179;2349;167424;652229;653652;730112;814408;656001;897536;;;;;;
168468,206;161581;2241;166912;653652;653964;730112;815233;656205;897024;;;;;;
168477,570;161473;2912;167936;653964;654444;730112;815437;657356;898048;;;;;;
168487,283;163168;4671;167424;654444;655019;730112;817612;659690;897536;;;;;;
168634,235;164794;7051;165888;656378;657366;730112;821172;664417;896000;;;;;;
168652,069;165771;8169;162304;657368;659762;730112;823139;667931;892416;;;;;;
168683,187;104174;6458;162816;659762;663381;730112;763936;669839;892928;;;;;;
168683,204;6458;0;162816;663381;635513;730112;669839;635513;892928;185677;185391;786432;855516;820904;1679360
168698,772;154112;762;155136;635513;635514;730112;789625;636276;885248;;;;;;
168763,238;154874;1265;164352;635514;635852;730112;790388;637117;894464;;;;;;
168794,763;154865;880;164352;635852;636188;730112;790717;637068;894464;;;;;;
168837,899;154480;1183;164864;636188;636588;730112;790668;637771;894976;;;;;;
168957,609;155807;1476;164864;636588;636963;730112;792395;638439;894976;;;;;;
168997,201;156100;1280;165376;636963;637427;730112;793063;638707;895488;;;;;;
169037,202;156928;1088;165376;637427;637883;730112;794355;638971;895488;;;;;;
169055,988;156736;3088;166400;637883;638587;730112;794619;641675;896512;;;;;;
169094,037;160272;1616;165888;638587;640271;730112;798859;641887;896000;;;;;;
169131,458;158800;1746;166912;640271;640512;730112;799071;642258;897024;;;;;;
169199,829;82520;5848;164864;640512;641360;730112;723032;647208;894976;;;;;;
169199,850;5848;0;164864;641360;634052;730112;647208;634052;894976;185397;185390;786432;832605;819442;1681408
169242,642;158654;931;166400;634053;634053;730112;792707;634984;896512;;;;;;
169311,345;158627;7017;164864;634053;634371;730112;792680;641388;894976;;;;;;
169328,430;164713;2977;166400;634371;636376;730112;799084;639353;896512;;;;;;
169337,510;159649;908;165376;636376;638236;730112;796025;639144;895488;;;;;;
169622,978;157358;2673;166912;638236;638468;730112;795594;641141;897024;;;;;;
169996,393;160814;5806;166400;638468;639126;730112;799282;644932;896512;;;;;;
170109,468;164014;5578;165376;639126;640081;730112;803140;645659;895488;;;;;;
170147,659;162250;8280;165376;640081;641385;730112;802331;649665;895488;;;;;;
170158,381;164952;5328;164352;641385;643096;730112;806337;648424;894464;;;;;;
170161,949;159952;9456;164352;643096;647920;730112;803048;657376;894464;;;;;;
170230,424;164080;1184;162304;647920;648712;730112;812000;649896;892416;;;;;;
170557,483;152736;3465;163328;648712;649240;730112;801448;652705;893440;;;;;;
170600,172;154719;5619;164352;649241;650259;730112;803960;655878;894464;;;;;;
170604,422;158707;10736;159744;650259;653339;730112;808966;664075;889856;;;;;;
171388,441;159728;1338;158720;653339;663243;730112;813067;664581;888832;;;;;;
171811,031;148794;5782;161280;663243;664231;730112;812037;670013;891392;;;;;;
171834,342;153238;6433;162304;664231;664695;730112;817469;671128;892416;;;;;;
171849,365;155425;1092;161792;664695;669575;730112;820120;670667;891904;;;;;;
171894,349;150084;3443;162816;669575;669983;730112;819659;673426;892928;;;;;;
171986,833;153459;4384;162304;669983;670542;730112;823442;674926;892416;;;;;;
172017,590;154400;848;163840;670542;672290;730112;824942;673138;893952;;;;;;
172097,226;152912;4888;163328;672290;672402;730112;825202;677290;893440;;;;;;
172231,420;156952;5145;164352;672402;673215;730112;829354;678360;894464;;;;;;
172304,934;158233;928;163840;673215;674865;730112;831448;675793;893952;;;;;;
172338,386;154016;1152;164352;674865;674866;730112;828881;676018;894464;;;;;;
172388,636;154752;1654;164352;674866;675178;730112;829618;676832;894464;;;;;;
172404,527;155254;6123;163840;675178;675338;730112;830432;681461;893952;;;;;;
172457,897;159723;2032;164352;675338;677060;730112;835061;679092;894464;;;;;;
172528,693;155632;768;164864;677060;677644;730112;832692;678412;894976;;;;;;
172586,106;155392;3492;164864;677644;677828;730112;833036;681320;894976;;;;;;
172600,320;158116;800;165888;677828;679156;730112;835944;679956;896000;;;;;;
172640,790;157472;3876;165888;679156;679396;730112;836628;683272;896000;;;;;;
172667,466;160548;4884;165888;679396;679788;730112;839944;684672;896000;;;;;;
172712,510;161556;3457;165888;679788;680559;730112;841344;684016;896000;;;;;;
172777,133;160129;1620;166912;680559;682028;730112;840688;683648;897024;;;;;;
172802,398;143145;544;166400;682029;682441;730112;825174;682985;896512;;;;;;
172802,413;544;0;166400;682441;628709;730112;682985;628709;896512;185725;185374;786432;868710;814083;1682944
172824,425;158208;3555;166912;628709;628709;730112;786917;632264;897024;;;;;;
172848,094;162275;4203;166912;628709;629174;730112;790984;633377;897024;;;;;;
172871,326;162923;1056;167424;629174;630693;730112;792097;631749;897536;;;;;;
172909,337;160288;1024;166912;630693;631277;730112;790981;632301;897024;;;;;;
173188,452;160256;4795;166400;631277;631549;730112;791533;636344;896512;;;;;;
173259,014;163515;8179;166912;631549;633980;730112;795064;642159;897024;;;;;;
173260,620;166899;8184;162304;633980;635872;730112;800879;644056;892416;;;;;;
173503,993;162296;5924;160256;635872;643848;730112;798168;649772;890368;;;;;;
173701,274;160036;6126;163328;643848;648079;730112;803884;654205;893440;;;;;;
173749,614;157678;1100;163328;648079;649993;730112;805757;651093;893440;;;;;;
173865,164;152614;3763;163840;649993;650569;730112;802607;654332;893952;;;;;;
173912,475;155827;7461;163328;650569;651058;730112;806396;658519;893440;;;;;;
173915,257;159525;9728;161280;651058;653817;730112;810583;663545;891392;;;;;;
174701,400;159232;1055;162304;653817;656194;730112;813049;657249;892416;;;;;;
175288,447;150559;831;162304;656194;656530;730112;806753;657361;892416;;;;;;
175904,252;150335;3635;162304;656530;656922;730112;806865;660557;892416;;;;;;
175959,116;153139;5359;163328;656922;657826;730112;810061;663185;893440;;;;;;
175975,101;156911;3328;163328;657826;658556;730112;814737;661884;893440;;;;;;
176003,442;154880;752;163840;658556;659828;730112;813436;660580;893952;;;;;;
176056,349;153328;2433;163840;659828;659916;730112;813156;662349;893952;;;;;;
176102,156;154951;2441;164864;659917;660197;730112;814868;662638;894976;;;;;;
176148,097;156553;3174;164352;660197;660723;730112;816750;663897;894464;;;;;;
176201,728;157286;3896;165888;660723;661531;730112;818009;665427;896000;;;;;;
176227,893;160056;1956;165376;661531;662795;730112;821587;664751;895488;;;;;;
176233,097;158116;4337;166400;662795;663237;730112;820911;667574;896512;;;;;;
176275,619;162033;1784;166400;663237;664712;730112;825270;666496;896512;;;;;;
176299,001;159480;1616;166912;664712;665492;730112;824192;667108;897024;;;;;;
176404,544;31906;1856;166400;665493;665772;730112;697399;667628;896512;;;;;;
176404,589;1856;0;166400;665772;626828;730112;667628;626828;896512;186212;185470;786432;853840;812298;1682944
176524,499;158208;3469;167424;626828;626829;730112;785036;630298;897536;;;;;;
176548,994;162701;820;166912;626829;628116;730112;789530;628936;897024;;;;;;
176556,305;160052;736;167424;628116;628356;730112;788168;629092;897536;;;;;;
176569,623;160480;608;167424;628356;628588;730112;788836;629196;897536;;;;;;
176809,847;160352;3779;167424;628588;628829;730112;788940;632608;897536;;;;;;
176847,336;163523;448;167424;628829;630403;730112;792352;630851;897536;;;;;;
177004,372;160192;4248;166912;630403;630644;730112;790595;634892;897024;;;;;;
177373,711;163992;4647;167424;630644;631308;730112;794636;635955;897536;;;;;;
177465,118;164382;5762;165376;631308;631308;730112;795690;637070;895488;;;;;;
177476,616;163458;8473;166400;631308;631308;730112;794766;639781;896512;;;;;;
177498,668;166169;3410;165376;631308;632755;730112;797477;636165;895488;;;;;;
177518,449;160082;3843;165888;632755;634015;730112;792837;637858;896000;;;;;;
178126,120;160515;3068;166400;634015;634719;730112;794530;637787;896512;;;;;;
178588,458;160764;4516;166400;634719;635556;730112;795483;640072;896512;;;;;;
179339,025;162180;5303;165888;635557;635557;730112;797737;640860;896000;;;;;;
179787,918;162999;6951;164864;635557;635557;730112;798556;642508;894976;;;;;;
179817,731;164647;4322;166400;635557;635556;730112;800204;639878;896512;;;;;;
179878,734;161506;7458;164864;635556;635557;730112;797062;643015;894976;;;;;;
179910,859;164642;4041;165888;635557;635557;730112;800199;639598;896000;;;;;;
179972,692;160201;4625;165376;635557;635557;730112;795758;640182;895488;;;;;;
180007,326;122606;4463;166912;635557;635557;730112;758163;640020;897024;;;;;;
180007,345;4463;0;166912;635557;626016;730112;640020;626016;897024;186049;185285;786432;826069;811301;1683456
180056,398;158208;2477;166400;626016;626016;730112;784224;628493;896512;;;;;;
180088,439;160685;2928;166912;626016;626016;730112;786701;628944;897024;;;;;;
180127,867;161648;3568;166912;626016;626016;730112;787664;629584;897024;;;;;;
180195,930;162288;3551;167424;626016;626016;730112;788304;629567;897536;;;;;;
180218,496;162783;7387;166912;626016;626016;730112;788799;633403;897024;;;;;;
180242,388;166619;4466;166912;626016;626016;730112;792635;630482;897024;;;;;;
180388,483;163186;8187;166912;626016;626086;730112;789202;634273;897024;;;;;;
180490,527;166907;5364;164864;626086;626086;730112;792993;631450;894976;;;;;;
180528,857;162036;5246;165888;626086;626086;730112;788122;631332;896000;;;;;;
180571,722;161918;8339;164352;626086;626086;730112;788004;634425;894464;;;;;;
180590,355;163987;6545;165376;626086;626086;730112;790073;632631;895488;;;;;;
180627,546;162193;9701;162304;626086;627100;730112;788279;636801;892416;;;;;;
180658,744;162277;10373;163328;627100;628152;730112;789377;638525;893440;;;;;;
180674,413;162949;8725;161280;628152;628672;730112;791101;637397;891392;;;;;;
180699,682;158229;6374;162304;628672;629842;730112;786901;636216;892416;;;;;;
180712,877;155878;5087;163328;629842;630888;730112;785720;635975;893440;;;;;;
180730,283;156127;4735;162816;630888;631647;730112;787015;636382;892928;;;;;;
180958,939;155751;7574;163328;631647;632929;730112;787398;640503;893440;;;;;;
181003,000;159126;11463;163328;632929;634097;730112;792055;645560;893440;;;;;;
181023,108;163015;6745;162304;634097;634561;730112;797112;641306;892416;;;;;;
181046,857;157273;3935;162816;634561;637358;730112;791834;641293;892928;;;;;;
181061,170;154463;1840;161792;637358;638917;730112;791821;640757;891904;;;;;;
181090,704;151344;3568;162304;638917;639373;730112;790261;642941;892416;;;;;;
181167,266;153072;2686;162816;639373;639917;730112;792445;642603;892928;;;;;;
181213,794;153214;3560;162816;639917;640572;730112;793131;644132;892928;;;;;;
181234,963;154088;3828;163328;640572;641108;730112;794660;644936;893440;;;;;;
181256,659;154804;2418;162816;641108;641916;730112;795912;644334;892928;;;;;;
181314,565;153458;1024;163328;641916;642988;730112;795374;644012;893440;;;;;;
181503,499;152576;4067;163328;642988;643380;730112;795564;647447;893440;;;;;;
181615,063;155619;4702;164864;643380;644131;730112;798999;648833;894976;;;;;;
181668,690;158814;2980;164352;644131;644131;730112;802945;647111;894464;;;;;;
181680,078;157092;4483;165376;644131;644132;730112;801223;648615;895488;;;;;;
181693,488;159619;6360;164864;644132;645116;730112;803751;651476;894976;;;;;;
181710,351;161496;2152;165376;645116;647032;730112;806612;649184;895488;;;;;;
181734,312;157800;3200;165376;647032;647634;730112;804832;650834;895488;;;;;;
181765,356;158848;4342;165888;647634;648266;730112;806482;652608;896000;;;;;;
181833,990;161014;3332;165888;648266;648977;730112;809280;652309;896000;;;;;;
181871,355;160004;3188;166912;648977;649529;730112;808981;652717;897024;;;;;;
182012,116;161389;2523;166400;649529;650281;730112;810918;652804;896512;;;;;;
182045,738;160731;3375;167424;650281;650969;730112;811012;654344;897536;;;;;;
182066,724;162607;5724;166912;650969;651625;730112;813576;657349;897024;;;;;;
182107,020;164956;2224;166912;651625;652523;730112;816581;654747;897024;;;;;;
182215,495;160944;7181;166400;652523;653414;730112;813467;660595;896512;;;;;;
182228,833;165901;6669;165376;653414;655082;730112;819315;661751;895488;;;;;;
182258,691;163341;2740;165888;655082;656270;730112;818423;659010;896000;;;;;;
182320,532;159412;3684;166400;656270;656885;730112;815682;660569;896512;;;;;;
182418,349;160868;2896;165888;656885;657565;730112;817753;660461;896000;;;;;;
182440,635;160080;960;166400;657565;658869;730112;817645;659829;896512;;;;;;
182457,410;158656;3940;166400;658869;659294;730112;817525;663234;896512;;;;;;
182496,515;161636;4579;166912;659294;660011;730112;820930;664590;897024;;;;;;
182512,401;163299;4596;166912;660011;661125;730112;823310;665721;897024;;;;;;
182538,456;163316;3544;167424;661125;662009;730112;824441;665553;897536;;;;;;
182548,991;162776;1120;166912;662009;663353;730112;824785;664473;897024;;;;;;
182555,875;160352;2144;167424;663353;663720;730112;823705;665864;897536;;;;;;
182581,922;161888;5816;165888;663720;664732;730112;825608;670548;896000;;;;;;
182603,629;165560;4600;166912;664732;666012;730112;830292;670612;897024;;;;;;
182617,858;163320;1382;166912;666012;667510;730112;829332;668892;897024;;;;;;
182646,769;160102;1919;166912;667510;668086;730112;827612;670005;897024;;;;;;
182662,058;160639;1496;166912;668086;669375;730112;828725;670871;897024;;;;;;
182694,327;160216;6825;165376;669375;670123;730112;829591;676948;895488;;;;;;
182709,647;164521;5560;163328;670123;671095;730112;834644;676655;893440;;;;;;
182722,805;163256;5685;165888;671095;672097;730112;834351;677782;896000;;;;;;
182735,945;162357;3599;165888;672097;672962;730112;834454;676561;896000;;;;;;
182757,217;160271;1266;166400;672962;674090;730112;833233;675356;896512;;;;;;
182772,708;158962;960;166400;674090;674762;730112;833052;675722;896512;;;;;;
182782,975;158656;4477;166400;674762;674994;730112;833418;679471;896512;;;;;;
182807,560;162173;4852;166400;674994;676445;730112;837167;681297;896512;;;;;;
182810,248;162516;2193;166912;677255;678780;730112;839771;680973;897024;;;;;;
182820,965;160401;7345;165888;678783;679473;730112;839184;686818;896000;;;;;;
182866,837;165553;1280;165888;679473;681211;730112;845026;682491;896000;;;;;;
182874,737;157952;962;165888;681211;681587;730112;839163;682549;896000;;;;;;
182893,093;157634;6446;164864;681587;681819;730112;839221;688265;894976;;;;;;
182911,651;162094;928;165376;681819;683350;730112;843913;684278;895488;;;;;;
182931,500;156576;2943;165888;683350;683718;730112;839926;686661;896000;;;;;;
182958,083;159103;5336;165376;683718;684500;730112;842821;689836;895488;;;;;;
182973,328;161496;4852;165888;684500;685292;730112;845996;690144;896000;;;;;;
182991,877;161524;3748;165888;685292;686152;730112;846816;689900;896000;;;;;;
183024,693;160420;5952;165376;686152;687179;730112;846572;693131;895488;;;;;;
183061,994;162624;720;165888;687179;688376;730112;849803;689096;896000;;;;;;
183083,159;157392;2400;166400;688376;688720;730112;845768;691120;896512;;;;;;
183135,349;159584;8703;165888;688720;689703;730112;848304;698406;896000;;;;;;
183178,254;165873;3435;164864;689703;691421;730112;855576;694856;894976;;;;;;
183233,755;159083;4653;165376;691421;691821;730112;850504;696474;895488;;;;;;
183241,033;160301;2704;165888;691821;692656;730112;852122;695360;896000;;;;;;
183256,418;159376;5290;165888;692656;693327;730112;852032;698617;896000;;;;;;
183259,612;161962;4668;166400;693327;694193;730112;855289;698861;896512;;;;;;
183273,732;161852;3638;165888;694193;695137;730112;856045;698775;896000;;;;;;
183287,590;160822;4299;166912;695137;695810;730112;855959;700109;897024;;;;;;
183299,978;162507;896;166400;695810;697001;730112;858317;697897;896512;;;;;;
183306,770;159104;3428;166912;697001;697321;730112;856105;700749;897024;;;;;;
183318,376;162148;1024;166912;697321;698457;730112;859469;699481;897024;;;;;;
183330,788;159744;3919;167424;698457;698713;730112;858201;702632;897536;;;;;;
183341,098;163151;4451;166912;698713;700011;730112;861864;704462;897024;;;;;;
183354,677;163683;2892;167424;700011;702193;730112;863694;705085;897536;;;;;;
183403,804;162636;7669;167424;702193;703070;730112;864829;710739;897536;;;;;;
183463,514;167413;720;164352;703070;704448;730112;870483;705168;894464;;;;;;
183502,324;157392;7233;164352;704448;704751;730112;861840;711984;894464;;;;;;
183565,231;163905;960;165376;704751;706264;730112;868656;707224;895488;;;;;;
183586,966;156608;5160;165376;706264;706566;730112;862872;711726;895488;;;;;;
183610,119;126326;4902;165376;706566;707410;730112;832892;712312;895488;;;;;;
183610,137;4902;0;165376;707410;662064;730112;712312;662064;895488;190395;186087;786432;902707;848151;1681920
183663,332;155648;3792;165376;662064;662064;730112;817712;665856;895488;;;;;;
183692,546;159440;6929;164864;662064;663261;730112;821504;670190;894976;;;;;;
183707,125;162577;5671;165376;663261;664738;730112;825838;670409;895488;;;;;;
183712,803;161319;800;165376;664738;666402;730112;826057;667202;895488;;;;;;
183726,041;156448;1168;165376;666402;666498;730112;822850;667666;895488;;;;;;
183738,514;156816;3393;165888;666498;666826;730112;823314;670219;896000;;;;;;
183759,066;159553;1242;165376;666826;668193;730112;826379;669435;895488;;;;;;
183787,370;157402;3350;166400;668193;668569;730112;825595;671919;896512;;;;;;
183849,493;160534;4499;165888;668569;669018;730112;829103;673517;896000;;;;;;
183891,072;161683;2756;166912;669018;670204;730112;830701;672960;897024;;;;;;
184145,158;160964;3747;166400;670204;670596;730112;831168;674343;896512;;;;;;
184172,015;161955;3042;167424;670596;671544;730112;832551;674586;897536;;;;;;
184202,110;162786;4084;167424;671544;672024;730112;834330;676108;897536;;;;;;
184252,822;163828;3076;167936;672024;672616;730112;835852;675692;898048;;;;;;
184294,602;163844;4717;167936;672616;673073;730112;836460;677790;898048;;;;;;
184337,439;165485;3965;167936;673073;674275;730112;838558;678240;898048;;;;;;
184362,674;164733;3914;167936;674275;675083;730112;839008;678997;898048;;;;;;
184372,655;164682;3740;168448;675083;675814;730112;839765;679554;898560;;;;;;
184390,608;165532;1216;168448;675814;677314;730112;841346;678530;898560;;;;;;
184405,353;163008;1152;168448;677314;677770;730112;840322;678922;898560;;;;;;
184437,670;162944;3155;168448;677770;678227;730112;840714;681382;898560;;;;;;
184476,115;164947;848;168448;678227;679513;730112;843174;680361;898560;;;;;;
184551,086;162640;2528;168448;679513;679817;730112;842153;682345;898560;;;;;;
184573,214;164320;4350;167936;679817;680289;730112;844137;684639;898048;;;;;;
184587,809;166142;3052;168448;680289;681160;730112;846431;684212;898560;;;;;;
184595,991;164844;1504;168960;681160;682509;730112;846004;684013;899072;;;;;;
184631,327;164133;1948;168960;682509;682797;730112;846642;684745;899072;;;;;;
184650,480;164764;3540;168960;682797;683149;730112;847561;686689;899072;;;;;;
184673,395;166356;2496;168960;683149;683836;730112;849505;686332;899072;;;;;;
184711,257;165312;2896;169472;683836;684254;730112;849148;687150;899584;;;;;;
184746,611;166736;3295;169472;684254;684920;730112;850990;688215;899584;;;;;;
184762,761;167135;2080;169984;684920;685967;730112;852055;688047;900096;;;;;;
184784,902;166432;2896;169472;685967;686777;730112;852399;689673;899584;;;;;;
184845,177;167248;3108;169984;686777;687611;730112;854025;690719;900096;;;;;;
184871,720;167972;3476;169984;687611;688003;730112;855583;691479;900096;;;;;;
184889,263;168340;4834;168960;688003;688672;730112;856343;693506;899072;;;;;;
184936,941;168674;1187;169472;688672;690306;730112;857346;691493;899584;;;;;;
184954,694;165027;5611;167424;690306;691214;730112;855333;696825;897536;;;;;;
184977,999;167403;6629;163840;691214;694956;730112;858617;701585;893952;;;;;;
184984,981;163813;5790;163328;694956;697340;730112;858769;703130;893440;;;;;;
184991,665;162462;2688;165888;697340;699003;730112;859802;701691;896000;;;;;;
184997,386;159360;1684;165888;699003;700699;730112;858363;702383;896000;;;;;;
185002,009;158356;1120;165888;700699;701959;730112;859055;703079;896000;;;;;;
185020,976;157792;1328;166400;701959;702583;730112;859751;703911;896512;;;;;;
185042,257;159024;960;166400;702583;703359;730112;861607;704319;896512;;;;;;
185061,726;158656;5252;166400;703359;703680;730112;862015;708932;896512;;;;;;
185083,358;162948;4393;166400;703680;704844;730112;866628;709237;896512;;;;;;
185117,458;162089;4098;166400;704844;705523;730112;866933;709621;896512;;;;;;
185139,738;161761;5544;166400;705523;706403;730112;867284;711947;896512;;;;;;
185147,339;163240;2497;166400;706403;707818;730112;869643;710315;896512;;;;;;
185155,685;160193;3392;166400;707818;708533;730112;868011;711925;896512;;;;;;
185168,969;161088;2224;167424;708533;710514;730112;869621;712738;897536;;;;;;
185178,129;161456;2688;166912;710514;711324;730112;871970;714012;897024;;;;;;
185194,246;161920;3798;167936;711324;712154;730112;873244;715952;898048;;;;;;
185229,446;164054;3668;167424;712154;712802;730112;876208;716470;897536;;;;;;
185240,180;163924;1249;167936;712802;713786;730112;876726;715035;898048;;;;;;
185255,965;162017;3581;167936;713786;714017;730112;875803;717598;898048;;;;;;
185281,123;164349;4708;167424;714017;714996;730112;878366;719704;897536;;;;;;
185313,675;165476;1296;167936;714996;716441;730112;880472;717737;898048;;;;;;
185328,071;162064;1536;167936;716441;716897;730112;878505;718433;898048;;;;;;
185335,672;162304;2145;167936;716897;717498;730112;879201;719643;898048;;;;;;
185353,556;162913;4630;167424;717498;717761;730112;880411;722391;897536;;;;;;
185361,310;165398;6083;166912;717761;719038;730112;883159;725121;897024;;;;;;
185373,444;166851;3810;167424;719038;719809;730112;885889;723619;897536;;;;;;
185379,394;163554;2256;167424;719809;721242;730112;883363;723498;897536;;;;;;
185402,108;162000;1216;167936;721242;722814;730112;883242;724030;898048;;;;;;
185413,876;161984;3571;167936;722814;723129;730112;884798;726700;898048;;;;;;
185426,152;164339;2823;168448;723129;723974;730112;887468;726797;898560;;;;;;
185448,563;164103;3204;167936;723974;724711;730112;888077;727915;898048;;;;;;
185459,078;164484;2592;168960;724711;725482;730112;889195;728074;899072;;;;;;
185483,879;164896;2416;168448;725482;726674;730112;890378;729090;898560;;;;;;
185506,707;164720;3683;168960;726674;727224;730112;891394;730907;899072;;;;;;
185530,987;166499;4048;168960;727224;727774;730112;893723;731822;899072;;;;;;
185542,411;166864;1024;168960;727774;729508;730112;894638;730532;899072;;;;;;
185542,429;1024;0;168960;729508;660864;764416;730532;660864;933376;190785;186044;786432;921317;846908;1719808
185569,930;162816;2625;168960;660864;660864;764416;823680;663489;933376;;;;;;
185579,824;165441;5067;167936;660864;661886;764416;826305;666953;932352;;;;;;
185613,295;166859;2512;168448;661886;663408;764416;828745;665920;932864;;;;;;
185656,361;164304;991;168960;663408;664592;764416;827712;665583;933376;;;;;;
185680,273;163807;2512;168960;664592;665007;764416;828399;667519;933376;;;;;;
185706,678;165328;2512;169472;665007;665701;764416;830335;668213;933888;;;;;;
185752,465;165840;3232;168960;665701;666386;764416;831541;669618;933376;;;;;;
185775,937;166560;928;169472;666386;667905;764416;832946;668833;933888;;;;;;
185788,408;164768;2432;169472;667905;668137;764416;832673;670569;933888;;;;;;
185807,405;166272;928;169472;668137;669279;764416;834409;670207;933888;;;;;;
185832,062;164768;3891;169472;669279;669657;764416;834047;673548;933888;;;;;;
185857,214;167731;4452;168448;669657;670328;764416;837388;674780;932864;;;;;;
185928,836;167268;4804;167936;670328;671305;764416;837596;676109;932352;;;;;;
186125,957;167620;3316;168448;671305;672385;764416;838925;675701;932864;;;;;;
186148,650;165108;2128;168448;672385;672385;764416;837493;674513;932864;;;;;;
186235,238;163920;6128;166912;672385;672617;764416;836305;678745;931328;;;;;;
186272,492;166896;3519;167936;672617;673505;764416;839513;677024;932352;;;;;;
186302,763;164287;5139;167936;673505;673505;764416;837792;678644;932352;;;;;;
186481,504;165907;6856;167936;673505;673504;764416;839412;680360;932352;;;;;;
186505,792;167624;5887;164864;673504;673505;764416;841128;679392;929280;;;;;;
186548,289;163583;4223;166400;673505;674958;764416;837088;679181;930816;;;;;;
186579,125;161919;4290;167424;674958;675655;764416;836877;679945;931840;;;;;;
186671,638;163522;6897;166400;675655;676407;764416;839177;683304;930816;;;;;;
186697,025;166129;8492;164352;676407;677007;764416;842536;685499;928768;;;;;;
186714,739;164140;5188;165376;677007;677595;764416;841147;682783;929792;;;;;;
186745,807;160836;5220;165888;677595;678941;764416;838431;684161;930304;;;;;;
186777,431;161892;2555;165888;678941;680614;764416;840833;683169;930304;;;;;;
186846,657;159227;3681;166400;680614;681545;764416;839841;685226;930816;;;;;;
186883,645;160865;3726;165888;681545;682073;764416;842410;685799;930304;;;;;;
186895,889;160910;3856;166912;682073;682937;764416;842983;686793;931328;;;;;;
186935,712;162064;4564;166400;682937;683634;764416;845001;688198;930816;;;;;;
186989,759;162772;3252;167424;683634;684479;764416;846406;687731;931840;;;;;;
187004,455;162484;1600;166912;684479;685282;764416;846963;686882;931328;;;;;;
187064,924;160832;6988;165888;685282;685713;764416;846114;692701;930304;;;;;;
187095,464;164684;3951;166400;685713;686881;764416;850397;690832;930816;;;;;;
187124,741;161647;3010;166912;686881;687730;764416;848528;690740;931328;;;;;;
187156,364;161730;3440;166912;687730;688153;764416;849460;691593;931328;;;;;;
187284,177;162160;4362;167424;688153;688976;764416;850313;693338;931840;;;;;;
187310,407;164106;3366;167424;688976;688977;764416;853082;692343;931840;;;;;;
187351,591;163104;5094;167424;689364;690189;764416;852468;695283;931840;;;;;;
187378,846;164838;6089;165888;690191;690191;764416;855029;696280;930304;;;;;;
187414,301;165833;4495;167424;690191;690560;764416;856024;695055;931840;;;;;;
187429,155;163727;5571;166912;690560;691200;764416;854287;696771;931328;;;;;;
187449,145;164803;4137;167424;691200;692727;764416;856003;696864;931840;;;;;;
187455,479;163881;2112;167424;692727;694333;764416;856608;696445;931840;;;;;;
187486,000;161856;4504;167424;694333;695153;764416;856189;699657;931840;;;;;;
187492,768;164248;7665;167424;695153;696585;764416;859401;704250;931840;;;;;;
187505,878;167409;4560;165376;696585;697716;764416;863994;702276;929792;;;;;;
187531,314;162256;5992;166400;697716;698980;764416;859972;704972;930816;;;;;;
187553,976;163174;4944;166912;698980;699780;764416;862154;704724;931328;;;;;;
187586,707;163152;3572;166400;699780;700792;764416;862932;704364;930816;;;;;;
187602,207;161780;1667;165888;700792;702040;764416;862572;703707;930304;;;;;;
187611,962;159363;1324;166400;702040;702984;764416;861403;704308;930816;;;;;;
187620,498;159020;4516;166912;702984;703272;764416;862004;707788;931328;;;;;;
187637,279;162724;1824;166400;703272;705135;764416;865996;706959;930816;;;;;;
187651,247;160032;3924;167424;705135;706360;764416;865167;710284;931840;;;;;;
187658,937;163156;4308;166912;706360;708104;764416;869516;712412;931328;;;;;;
187680,992;163540;2960;167424;708104;709923;764416;871644;712883;931840;;;;;;
187682,238;161526;4930;167424;709923;710595;764416;871449;715525;931840;;;;;;
187710,273;164674;1984;167424;710595;711627;764416;875269;713611;931840;;;;;;
187730,698;161728;672;167424;711627;712074;764416;873355;712746;931840;;;;;;
187767,235;160416;2960;167424;712074;712179;764416;872490;715139;931840;;;;;;
187833,162;162704;2400;167424;712179;712720;764416;874883;715120;931840;;;;;;
187889,651;162144;2560;167936;712720;712984;764416;874864;715544;932352;;;;;;
187978,484;163328;649;167936;713571;714741;764416;876899;715390;932352;;;;;;
187978,503;793;64;167936;714741;715335;764416;715534;715399;932352;;;;;;
188033,714;160832;3434;167936;715335;715344;764416;876167;718778;932352;;;;;;
188121,077;164202;1232;199168;715344;716798;764416;879546;718030;963584;;;;;;
188151,772;194256;4330;199680;716798;716961;764416;911054;721291;964096;;;;;;
188182,504;197354;4892;238592;716961;717947;764416;914315;722839;1003008;;;;;;
188352,721;236316;4173;239104;717947;718679;764416;954263;722852;1003520;;;;;;
188403,456;235597;4080;284672;718679;719819;764416;954276;723899;1049088;;;;;;
188442,521;281450;2624;285184;719819;720394;764416;1001269;723018;1049600;;;;;;
188496,341;280128;7163;337920;720394;721325;764416;1000522;728488;1102336;;;;;;
188543,775;337915;4737;339456;721325;722407;764416;1059240;727144;1103872;;;;;;
188595,907;335489;6737;403456;722407;723160;764416;1057896;729897;1167872;;;;;;
188770,197;401489;7647;403968;723160;724128;764416;1124649;731775;1168384;;;;;;
189051,615;402399;3824;383488;724128;724937;764416;1126527;728761;1147904;;;;;;
189087,867;383216;8184;372736;724937;725608;764416;1108153;733792;1137152;;;;;;
189144,054;359714;3332;368128;725608;727889;764416;1085322;731221;1132544;;;;;;
189144,086;3332;0;368128;727889;660557;764416;731221;660557;1132544;191906;185542;786432;923127;846099;1918976
189243,062;364544;9106;359936;660557;660557;764416;1025101;669663;1124352;;;;;;
189326,107;359826;3341;340992;660557;662173;764416;1020383;665514;1105408;;;;;;
189435,546;340749;5125;330240;662173;663229;764416;1002922;668354;1094656;;;;;;
189488,936;329733;3732;316416;663229;664622;764416;992962;668354;1080832;;;;;;
189547,259;316052;3623;304640;664622;665470;764416;980674;669093;1069056;;;;;;
189589,380;304167;4301;294400;665470;666222;764416;969637;670523;1058816;;;;;;
189628,534;294093;3847;283648;666222;667297;764416;960315;671144;1048064;;;;;;
189934,839;283347;5354;274944;667297;667945;764416;950644;673299;1039360;;;;;;
190062,164;274666;8139;267776;667945;669164;764416;942611;677303;1032192;;;;;;
190092,704;267723;3800;254464;669164;670918;764416;936887;674718;1018880;;;;;;
190127,655;254168;1852;243712;670918;672245;764416;925086;674097;1008128;;;;;;
190153,778;243516;2905;236544;672245;672709;764416;915761;675614;1000960;;;;;;
190182,593;236106;4574;230400;672709;673293;764416;908815;677867;994816;;;;;;
190228,099;230366;704;219136;673293;674765;764416;903659;675469;983552;;;;;;
190251,651;218816;1088;212480;674765;674798;764416;893581;675886;976896;;;;;;
190288,435;212032;7422;211968;674798;675053;764416;886830;682475;976384;;;;;;
190309,895;211650;9284;207360;675215;676491;764416;886865;685775;971776;;;;;;
190359,241;206916;3392;195072;676495;678057;764416;883411;681449;959488;;;;;;
190381,772;194880;1024;186368;678057;679345;764416;872937;680369;950784;;;;;;
190390,769;186368;2035;181760;679345;679618;764416;865713;681653;946176;;;;;;
190397,173;181747;5093;179200;679618;680036;764416;861365;685129;943616;;;;;;
190423,421;179173;4878;174080;680036;681147;764416;859209;686025;938496;;;;;;
190431,435;173838;4460;168448;681147;681896;764416;854985;686356;932864;;;;;;
190442,049;168300;5148;164864;681896;682560;764416;850196;687708;929280;;;;;;
190467,052;164380;3076;363520;682560;683151;764416;846940;686227;1127936;;;;;;
190513,386;363012;4036;350208;683151;683503;764416;1046163;687539;1114624;;;;;;
190538,625;350148;8042;340992;683503;684470;764416;1033651;692512;1105408;;;;;;
190554,366;340842;4829;325632;684470;685773;764416;1025312;690602;1090048;;;;;;
190602,633;325341;3512;312320;685773;686853;764416;1011114;690365;1076736;;;;;;
190631,572;312248;9184;306688;686853;690846;764416;999101;700030;1071104;;;;;;
190659,346;306656;1936;288768;690846;694243;764416;997502;696179;1053184;;;;;;
190704,024;288656;6607;283136;694243;694771;764416;982899;701378;1047552;;;;;;
190735,775;283087;5280;272384;694771;695739;764416;977858;701019;1036800;;;;;;
190788,987;272032;7533;265216;695739;696918;764416;967771;704451;1029632;;;;;;
190841,207;265069;3667;252416;696918;698713;764416;961987;702380;1016832;;;;;;
190847,923;251987;3782;243712;698713;699521;764416;950700;703303;1008128;;;;;;
190882,061;243398;5281;237056;699521;700112;764416;942919;705393;1001472;;;;;;
190899,282;236705;7151;230912;700112;700855;764416;936817;708006;995328;;;;;;
190924,085;230895;1552;218112;700855;703348;764416;931750;704900;982528;;;;;;
190954,884;217616;4288;213504;703348;703524;764416;920964;707812;977920;;;;;;
190967,275;213184;2048;204800;703524;706408;764416;916708;708456;969216;;;;;;
190996,234;203223;9986;205824;706408;707250;764416;909631;717236;970240;;;;;;
191025,703;205570;4508;194048;707250;708198;764416;912820;712706;958464;;;;;;
191052,814;193948;3700;187392;708198;709510;764416;902146;713210;951808;;;;;;
191066,266;186996;1088;179200;709510;711078;764416;896506;712166;943616;;;;;;
191077,925;178752;3348;175616;711078;711638;764416;889830;714986;940032;;;;;;
191086,793;175380;4832;172032;711638;712383;764416;887018;717215;936448;;;;;;
191105,108;171744;3976;165888;712383;715020;764416;884127;718996;930304;;;;;;
191110,445;165768;4272;161792;715020;715707;764416;880788;719979;926208;;;;;;
191133,168;161456;1807;237056;715707;718068;764416;877163;719875;1001472;;;;;;
191167,031;236815;5108;231936;718068;718356;764416;954883;723464;996352;;;;;;
191197,088;231924;5275;224768;718356;719100;764416;950280;724375;989184;;;;;;
191227,763;224411;6024;218112;719100;720143;764416;943511;726167;982528;;;;;;
191263,931;217992;7154;211968;720143;721811;764416;938135;728965;976384;;;;;;
191279,239;211954;928;199168;721811;723806;764416;933765;724734;963584;;;;;;
191292,928;199072;5825;198144;723806;724103;764416;922878;729928;962560;;;;;;
191326,057;197825;5160;191488;724103;724865;764416;921928;730025;955904;;;;;;
191347,591;191016;1120;181760;724865;726241;764416;915881;727361;946176;;;;;;
191353,898;181344;1088;176128;726241;726609;764416;907585;727697;940544;;;;;;
191388,481;175680;4368;174080;726609;726881;764416;902289;731249;938496;;;;;;
191442,501;173840;1453;165888;726881;728023;764416;900721;729476;930304;;;;;;
191478,059;165805;3542;163328;728023;728343;764416;893828;731885;927744;;;;;;
191553,792;163286;3491;187392;728343;729010;764416;891629;732501;951808;;;;;;
191673,470;187299;3907;182272;729010;729466;764416;916309;733373;946688;;;;;;
191718,013;182083;2280;175104;729466;730953;764416;911549;733233;939520;;;;;;
191757,389;174824;6221;174080;730953;730953;764416;905777;737174;938496;;;;;;
191782,690;173645;5878;168448;730953;730953;764416;904598;736831;932864;;;;;;
191812,881;168182;2144;165888;730953;731464;764416;899135;733608;930304;;;;;;
191832,221;165472;6515;165376;732983;734084;764416;898455;740599;929792;;;;;;
191838,624;165235;6002;162816;734088;735534;764416;899323;741536;927232;;;;;;
191844,374;162674;4081;160768;735534;736811;764416;898208;740892;925184;;;;;;
191860,184;160753;2667;166400;736811;739108;764416;897564;741775;930816;;;;;;
191863,421;159851;8685;165888;739108;741183;764416;898959;749868;930304;;;;;;
191889,100;165869;4035;163840;741183;743907;764416;907052;747942;928256;;;;;;
191896,292;158659;3635;164864;743907;744968;764416;902566;748603;929280;;;;;;
191918,128;158259;3690;165376;744968;746751;764416;903227;750441;929792;;;;;;
191920,537;158826;4131;164864;746751;748728;764416;905577;752859;929280;;;;;;
191947,292;159267;5924;165888;748728;750343;764416;907995;756267;930304;;;;;;
191947,575;92964;6738;163840;750343;751927;764416;843307;758665;928256;;;;;;
191947,599;6738;0;163840;751927;691337;764416;758665;691337;928256;190075;185772;786432;948740;877109;1714688
191974,458;156672;6220;165376;691337;691338;764416;848009;697558;929792;;;;;;
191998,825;161868;816;156672;691338;693047;764416;853206;693863;921088;;;;;;
192043,693;156464;3508;165376;693047;693335;764416;849511;696843;929792;;;;;;
192076,620;158644;2896;164864;693335;694031;764416;851979;696927;929280;;;;;;
192119,770;158032;4214;166400;694031;694904;764416;852063;699118;930816;;;;;;
192155,635;161398;4813;165888;694904;695996;764416;856302;700809;930304;;;;;;
192176,714;161997;4746;166912;695996;696783;764416;857993;701529;931328;;;;;;
192206,998;162954;2084;166400;696783;697706;764416;859737;699790;930816;;;;;;
192229,580;160292;6652;165376;697706;697876;764416;857998;704528;929792;;;;;;
192245,117;163324;5713;165888;697876;699363;764416;861200;705076;930304;;;;;;
192250,943;162385;4382;166400;699363;700892;764416;861748;705274;930816;;;;;;
192252,641;16355;5406;165888;700892;702885;764416;717247;708291;930304;;;;;;
192252,654;5406;0;165888;702885;687927;764416;708291;687927;930304;186108;185438;786432;894399;873365;1716736
192291,319;157184;1601;166400;687927;687927;764416;845111;689528;930816;;;;;;
192333,199;159297;672;166400;687927;688536;764416;847224;689208;930816;;;;;;
192353,716;158368;1296;166400;688536;688760;764416;846904;690056;930816;;;;;;
192384,363;158992;1552;166400;688760;689048;764416;847752;690600;930816;;;;;;
192411,042;159248;1121;166400;689048;689353;764416;848296;690474;930816;;;;;;
192428,204;158817;2352;166400;689353;689632;764416;848170;691984;930816;;;;;;
192449,371;160048;1568;166912;689632;690856;764416;849680;692424;931328;;;;;;
192477,939;160288;1472;166912;690856;691656;764416;851144;693128;931328;;;;;;
192514,546;160192;1233;167424;691656;691817;764416;851848;693050;931840;;;;;;
192538,897;160977;864;167424;691817;692504;764416;852794;693368;931840;;;;;;
192546,866;160608;1449;167936;692504;692560;764416;853112;694009;932352;;;;;;
192559,246;161705;960;167424;692560;692776;764416;854265;693736;931840;;;;;;
192578,090;161216;1120;168448;692776;693041;764416;853992;694161;932864;;;;;;
192592,293;162400;2576;167936;693041;693392;764416;855441;695968;932352;;;;;;
192592,967;21859;5430;167424;693393;694465;764416;715252;699895;931840;;;;;;
192592,981;5430;0;167424;694465;684497;764416;699895;684497;931840;185606;185439;786432;885501;869936;1718272
192628,730;160768;1524;167936;684497;684498;764416;845265;686022;932352;;;;;;
192651,097;162292;2374;168448;684498;684958;764416;846790;687332;932864;;;;;;
192668,166;163654;3264;167936;684958;685134;764416;848612;688398;932352;;;;;;
192684,525;164544;1217;168960;685134;686447;764416;849678;687664;933376;;;;;;
192732,127;163521;736;168448;686447;686926;764416;849968;687662;932864;;;;;;
192869,042;163040;1023;168960;686926;687078;764416;849966;688101;933376;;;;;;
192938,396;163839;1236;168960;687078;687509;764416;850917;688745;933376;;;;;;
192960,293;164052;4347;168448;687509;687510;764416;851561;691857;932864;;;;;;
192970,335;167163;3459;166400;687510;687702;764416;854673;691161;930816;;;;;;
192989,392;166275;2317;168960;687702;688413;764416;853977;690730;933376;;;;;;
193036,522;164621;1494;168448;688413;689688;764416;853034;691182;932864;;;;;;
193077,811;163798;3496;168448;689688;690227;764416;853486;693723;932864;;;;;;
193099,723;166312;3028;168960;690227;690907;764416;856539;693935;933376;;;;;;
193144,338;165844;5607;166400;690907;692652;764416;856751;698259;930816;;;;;;
193172,882;166375;480;167936;692652;694148;764416;859027;694628;932352;;;;;;
193295,725;161248;3459;167936;694148;694493;764416;855396;697952;932352;;;;;;
193331,251;164227;2946;167936;694493;694492;764416;858720;697438;932352;;;;;;
193376,248;163714;2319;168448;694492;694492;764416;858206;696811;932864;;;;;;
193418,955;164111;6644;168448;694492;695110;764416;858603;701754;932864;;;;;;
193475,596;168436;5518;165376;695110;695909;764416;863546;701427;929792;;;;;;
193516,730;164238;2991;166912;695909;695910;764416;860147;698901;931328;;;;;;
193549,515;161711;5956;166400;695910;695910;764416;857621;701866;930816;;;;;;
193564,005;164676;3809;166912;695910;695910;764416;860586;699719;931328;;;;;;
193662,428;162529;5667;166912;695910;696086;764416;858439;701753;931328;;;;;;
193675,811;164387;6115;164864;696086;696086;764416;860473;702201;929280;;;;;;
194311,652;164835;5457;166400;696086;697094;764416;860921;702551;930816;;;;;;
194512,108;163153;8697;166400;697125;698289;764416;860278;706986;930816;;;;;;
194553,339;166393;6559;162304;698294;698965;764416;864687;705524;926720;;;;;;
194586,115;160159;3632;164352;698965;699710;764416;859124;703342;928768;;;;;;
194701,265;157232;5996;164864;699710;700283;764416;856942;706279;929280;;;;;;
194774,787;160620;3520;164864;700283;700284;764416;860903;703804;929280;;;;;;
194817,051;158144;3775;165376;700284;700283;764416;858428;704058;929792;;;;;;
194856,632;159423;4033;165376;700283;700283;764416;859706;704316;929792;;;;;;
195297,281;159681;8002;163840;700283;700283;764416;859964;708285;928256;;;;;;
195340,512;162626;5456;164864;700283;700284;764416;862909;705740;929280;;;;;;
195358,100;160080;6373;165376;700284;700283;764416;860364;706656;929792;;;;;;
195373,109;162021;6349;165376;700283;700770;764416;862304;707119;929792;;;;;;
195379,102;161997;5265;165888;700770;701419;764416;862767;706684;930304;;;;;;
195587,174;161425;5088;165376;701419;701987;764416;862844;707075;929792;;;;;;
195690,245;161248;6597;165888;701987;702379;764416;863235;708976;930304;;;;;;
195879,409;163269;8545;165376;702379;703285;764416;865648;711830;929792;;;;;;
195934,811;165217;6438;165376;703285;703605;764416;868502;710043;929792;;;;;;
195953,933;162086;6464;165376;703605;704300;764416;865691;710764;929792;;;;;;
195961,831;162112;5051;165376;704300;704844;764416;866412;709895;929792;;;;;;
195980,622;160699;4819;165376;704844;706458;764416;865543;711277;929792;;;;;;
196026,801;160438;6928;165888;706457;707313;764416;866895;714241;930304;;;;;;
196036,977;163600;5067;165888;707313;707913;764416;870913;712980;930304;;;;;;
196047,791;161739;848;164864;707913;709752;764416;869652;710600;929280;;;;;;
196066,259;156496;704;156672;709752;710056;764416;866248;710760;921088;;;;;;
196093,483;156352;881;164864;710056;710256;764416;866408;711137;929280;;;;;;
196103,885;155505;833;164864;710256;710504;764416;865761;711337;929280;;;;;;
196133,395;155457;5061;164864;710504;710745;764416;865961;715806;929280;;;;;;
196176,986;159685;736;164864;710745;712369;764416;870430;713105;929280;;;;;;
196194,423;21618;320;164864;712370;712665;764416;733988;712985;929280;;;;;;
196194,436;320;0;164864;712665;670984;764416;712985;670984;929280;186946;185428;786432;899931;856412;1715712
196222,394;154624;512;164864;670984;670984;764416;825608;671496;929280;;;;;;
196251,820;155136;4773;165376;670984;671265;764416;826120;676038;929792;;;;;;
196258,640;160421;2082;165376;671265;672723;764416;831686;674805;929792;;;;;;
196296,413;157730;865;165888;672723;673099;764416;830453;673964;930304;;;;;;
196381,824;157537;2864;165888;673099;673386;764416;830636;676250;930304;;;;;;
196478,357;159536;3378;166912;673386;673715;764416;832922;677093;931328;;;;;;
196504,510;161586;6760;165376;673715;674542;764416;835301;681302;929792;;;;;;
196520,380;164968;896;165888;674542;676109;764416;839510;677005;930304;;;;;;
196533,043;157568;2512;165888;676109;676397;764416;833677;678909;930304;;;;;;
196540,554;159184;3940;166912;676397;676996;764416;835581;680936;931328;;;;;;
196560,514;162148;832;166400;676996;678538;764416;839144;679370;930816;;;;;;
196584,406;159040;864;166912;678538;678834;764416;837578;679698;931328;;;;;;
196788,465;159584;2560;166912;678834;679074;764416;838418;681634;931328;;;;;;
196871,043;161280;4489;167424;679074;679779;764416;840354;684268;931840;;;;;;
196901,095;164233;608;167424;679779;681318;764416;844012;681926;931840;;;;;;
197022,552;160352;4677;166400;681318;681670;764416;841670;686347;930816;;;;;;
197052,102;163397;8183;166912;681670;682529;764416;845067;690712;931328;;;;;;
197087,898;166903;3777;164864;682529;684254;764416;849432;688031;929280;;;;;;
197238,612;160449;6201;163328;684254;685352;764416;844703;691553;927744;;;;;;
197262,601;162873;4381;165888;685352;685352;764416;848225;689733;930304;;;;;;
197296,399;160541;3986;165376;685352;685352;764416;845893;689338;929792;;;;;;
197317,561;160146;3585;166400;685352;685352;764416;845498;688937;930816;;;;;;
197332,247;161281;3359;166400;685352;686340;764416;846633;689699;930816;;;;;;
197364,020;161055;5950;165888;686340;687035;764416;847395;692985;930304;;;;;;
197408,847;163646;3958;166400;687035;687924;764416;850681;691882;930816;;;;;;
197420,913;161654;1472;166912;687924;689875;764416;849578;691347;931328;;;;;;
197427,050;160192;2928;166912;689875;690371;764416;850067;693299;931328;;;;;;
197451,668;161648;7669;162304;690371;693216;764416;852019;700885;926720;;;;;;
197471,003;162293;2962;164864;693216;694388;764416;855509;697350;929280;;;;;;
197482,779;157586;2721;165888;694388;695931;764416;851974;698652;930304;;;;;;
197487,129;158881;3343;165376;695931;696452;764416;854812;699795;929792;;;;;;
197509,402;159503;5051;166400;696452;697821;764416;855955;702872;930816;;;;;;
197539,667;162181;5378;165888;697821;699223;764416;860002;704601;930304;;;;;;
197582,881;162562;6043;165888;699223;700339;764416;861785;706382;930304;;;;;;
197604,883;162715;4049;165888;700339;701798;764416;863054;705847;930304;;;;;;
197610,592;160721;2912;166400;701798;703510;764416;862519;706422;930816;;;;;;
197616,644;160608;4345;166400;703510;706114;764416;864118;710459;930816;;;;;;
197633,308;162041;2143;166912;706114;706807;764416;868155;708950;931328;;;;;;
197655,116;160863;2224;166912;706807;707642;764416;867670;709866;931328;;;;;;
197701,392;160944;3360;167424;707642;708503;764416;868586;711863;931840;;;;;;
197740,898;162592;4963;166912;708503;709316;764416;871095;714279;931328;;;;;;
197761,345;164195;6200;166400;709316;710136;764416;873511;716336;930816;;;;;;
197780,260;164920;2864;166912;710136;710707;764416;875056;713571;931328;;;;;;
197863,354;161584;2496;166912;710707;711227;764416;872291;713723;931328;;;;;;
197945,367;161216;4435;166912;711227;711612;764416;872443;716047;931328;;;;;;
197957,670;163155;4739;167424;711612;712212;764416;874767;716951;931840;;;;;;
197983,885;164483;929;160768;712212;714019;764416;876695;714948;925184;;;;;;
197992,502;160673;8083;164864;714019;714299;764416;874692;722382;929280;;;;;;
198023,926;164755;4481;165888;714299;715422;764416;879054;719903;930304;;;;;;
198036,060;161153;2167;166400;715422;716969;764416;876575;719136;930816;;;;;;
198048,667;159863;3907;166400;716969;717370;764416;876832;721277;930816;;;;;;
198060,530;161603;4512;166912;717370;718377;764416;878973;722889;931328;;;;;;
198077,122;163232;3188;166912;718377;719176;764416;881609;722364;931328;;;;;;
198082,984;161908;2432;167424;719176;719888;764416;881084;722320;931840;;;;;;
198089,743;162176;1424;167424;719888;721580;764416;882064;723004;931840;;;;;;
198116,798;161168;2736;167424;721580;722296;764416;882748;725032;931840;;;;;;
198142,008;162480;3746;167424;722296;722929;764416;884776;726675;931840;;;;;;
198163,865;163490;3010;167936;722929;723673;764416;886419;726683;932352;;;;;;
198188,319;163778;5736;166912;723673;724266;764416;887451;730002;931328;;;;;;
198201,288;166504;4256;167936;724266;725202;764416;890770;729458;932352;;;;;;
198226,069;164512;1376;167424;725202;726521;764416;889714;727897;931840;;;;;;
198236,719;161632;2080;167936;726521;727232;764416;888153;729312;932352;;;;;;
198263,234;162848;1040;167936;727232;728835;764416;890080;729875;932352;;;;;;
198286,954;161808;3092;167936;728835;729432;764416;890643;732524;932352;;;;;;
198375,335;163860;2673;167936;729432;730110;764416;893292;732783;932352;;;;;;
198380,623;163428;5669;167424;730110;730626;764416;893538;736295;931840;;;;;;
198484,458;166437;1808;167936;730626;732501;764416;897063;734309;932352;;;;;;
198513,924;162576;1344;167936;732501;733489;764416;895077;734833;932352;;;;;;
198562,783;162112;2592;167936;733489;733753;764416;895601;736345;932352;;;;;;
198569,954;163360;1001;168448;733753;735144;764416;897113;736145;932864;;;;;;
198616,569;162793;5056;166912;735144;735487;764416;897937;740543;931328;;;;;;
198706,340;166848;5469;166912;735487;736919;764416;902335;742388;931328;;;;;;
198741,611;165213;2608;167424;736919;738193;764416;902132;740801;931840;;;;;;
198765,333;162352;2304;167936;738193;738737;764416;900545;741041;932352;;;;;;
198822,235;162560;6837;167424;738737;739365;764416;901297;746202;931840;;;;;;
198854,775;167093;3766;167424;739365;740263;764416;906458;744029;931840;;;;;;
198877,277;163510;896;167424;740263;741575;764416;903773;742471;931840;;;;;;
198919,850;160640;5385;166400;741575;741743;764416;902215;747128;930816;;;;;;
198949,166;164105;4579;166912;741743;742503;764416;905848;747082;931328;;;;;;
198968,287;163299;3328;167424;742503;743334;764416;905802;746662;931840;;;;;;
199022,530;162560;2560;166912;743334;744206;764416;905894;746766;931328;;;;;;
199077,354;161792;1056;167424;744206;745493;764416;905998;746549;931840;;;;;;
199176,004;160800;4003;167424;745493;745493;764416;906293;749496;931840;;;;;;
199199,125;163747;5761;166400;745493;745493;764416;909240;751254;930816;;;;;;
199220,813;164481;2912;166912;745493;745493;764416;909974;748405;931328;;;;;;
199247,220;161632;2815;167936;745493;745733;764416;907125;748548;932352;;;;;;
199276,674;163071;2351;167424;745733;746405;764416;908804;748756;931840;;;;;;
199329,364;162607;4912;166912;746405;746821;764416;909012;751733;931328;;;;;;
199336,785;164656;3236;167424;746821;746821;764416;911477;750057;931840;;;;;;
199355,366;162980;2770;168448;746821;747186;764416;909801;749956;932864;;;;;;
199377,000;164050;5104;167936;747186;748010;764416;911236;753114;932352;;;;;;
199397,197;166384;5068;167936;748010;748458;764416;914394;753526;932352;;;;;;
199413,555;165836;928;161792;748458;750337;764416;914294;751265;926208;;;;;;
199434,161;161696;1163;167424;750337;750633;764416;912033;751796;931840;;;;;;
199443,998;160907;768;167424;750633;751128;764416;911540;751896;931840;;;;;;
199468,798;160512;1520;167936;751128;751281;764416;911640;752801;932352;;;;;;
199496,477;161776;1088;167424;751281;751732;764416;913057;752820;931840;;;;;;
199512,454;161344;3816;167936;751732;752253;764416;913076;756069;932352;;;;;;
199522,094;164584;2890;167936;752253;752656;764416;916837;755546;932352;;;;;;
199549,945;163658;4648;167424;752656;753400;764416;916314;758048;931840;;;;;;
199572,400;165416;3386;167936;753400;754944;764416;918816;758330;932352;;;;;;
199621,505;164154;2688;168448;754944;755455;764416;919098;758143;932864;;;;;;
199642,810;163851;4352;167936;756105;756646;764416;919956;760998;932352;;;;;;
199647,427;165632;6019;166400;756647;757292;764416;922279;763311;930816;;;;;;
199660,300;165763;3168;167424;757292;758540;764416;923055;761708;931840;;;;;;
199670,271;162802;1058;167936;758540;759956;764416;921342;761014;932352;;;;;;
199697,432;161826;800;167936;759956;760413;764416;921782;761213;932352;;;;;;
199709,261;161568;3715;167936;760413;760669;764416;921981;764384;932352;;;;;;
199713,632;164393;3576;167936;760668;761636;764416;925061;765212;932352;;;;;;
199755,338;164344;4500;167936;761636;762417;764416;925980;766917;932352;;;;;;
199796,427;72052;2096;167936;762417;763518;764416;834469;765614;932352;;;;;;
199796,445;2096;0;167936;763518;697434;764416;765614;697434;932352;193650;186345;786432;959264;883779;1718784
199816,316;160768;4259;167936;697434;697435;764416;858202;701694;932352;;;;;;
199834,612;165027;512;167936;697435;699105;764416;862462;699617;932352;;;;;;
199885,216;161280;3812;167936;699105;699345;764416;860385;703157;932352;;;;;;
199915,950;164580;2882;167936;699345;700374;764416;863925;703256;932352;;;;;;
200020,137;163650;4905;167424;700374;700909;764416;864024;705814;931840;;;;;;
200056,453;165673;3931;167936;700909;701965;764416;866582;705896;932352;;;;;;
200075,876;164699;4658;167936;701965;702616;764416;866664;707274;932352;;;;;;
200083,686;165426;4320;167936;702616;703264;764416;868042;707584;932352;;;;;;
200108,735;165088;3205;168448;703264;703866;764416;868352;707071;932864;;;;;;
200118,864;164485;4056;167936;703866;704706;764416;868351;708762;932352;;;;;;
200135,902;165336;2510;168448;704706;705810;764416;870042;708320;932864;;;;;;
200144,321;164302;4536;168448;705810;706496;764416;870112;711032;932864;;;;;;
200150,427;166328;1379;168448;706496;708141;764416;872824;709520;932864;;;;;;
200161,752;163171;5393;167424;708141;708619;764416;871312;714012;931840;;;;;;
200174,862;167185;960;167936;708619;710265;764416;875804;711225;932352;;;;;;
200179,494;161728;992;167936;710265;710561;764416;871993;711553;932352;;;;;;
200186,999;161760;3040;167936;710561;710833;764416;872321;713873;932352;;;;;;
200205,303;163808;3040;167936;710833;711322;764416;874641;714362;932352;;;;;;
200237,075;163808;4307;168448;711322;712388;764416;875130;716695;932864;;;;;;
200287,069;166099;6232;168448;712388;713744;764416;878487;719976;932864;;;;;;
200466,624;168024;688;166400;713744;715681;764416;881768;716369;930816;;;;;;
200502,787;160432;5976;165888;715681;716074;764416;876113;722050;930304;;;;;;
200513,199;165720;1056;166912;716074;717937;764416;881794;718993;931328;;;;;;
200517,545;159776;881;166912;717937;718385;764416;877713;719266;931328;;;;;;
200526,144;159601;3280;167424;718385;718553;764416;877986;721833;931840;;;;;;
200543,673;162512;4214;166912;718553;719336;764416;881065;723550;931328;;;;;;
200549,759;163446;4387;167424;719336;719696;764416;882782;724083;931840;;;;;;
200569,233;164131;800;167424;719696;721195;764416;883827;721995;931840;;;;;;
200580,256;160544;4114;167424;721195;721515;764416;881739;725629;931840;;;;;;
200596,683;163858;2208;167424;721515;722480;764416;885373;724688;931840;;;;;;
200602,403;161952;1248;167936;722480;723521;764416;884432;724769;932352;;;;;;
200617,637;161504;4192;167424;723521;723753;764416;885025;727945;931840;;;;;;
200705,814;164448;3572;167936;723753;724945;764416;888201;728517;932352;;;;;;
200768,645;164340;2224;167936;724945;725696;764416;889285;727920;932352;;;;;;
200802,797;162992;3108;168448;725696;726312;764416;888688;729420;932864;;;;;;
200978,551;164388;2431;167936;726312;726880;764416;890700;729311;932352;;;;;;
201011,996;163711;3444;168960;726880;727629;764416;890591;731073;933376;;;;;;
201041,741;166260;896;168960;727629;729093;764416;893889;729989;933376;;;;;;
201088,511;163712;4771;167936;729093;729333;764416;892805;734104;932352;;;;;;
201106,525;166563;881;168448;729333;731238;764416;895896;732119;932864;;;;;;
201131,437;162673;704;168448;731238;731541;764416;893911;732245;932864;;;;;;
201158,422;162496;4419;166400;731541;731662;764416;894037;736081;930816;;;;;;
201180,372;166211;864;167936;731662;733310;764416;897873;734174;932352;;;;;;
201190,801;161632;768;167936;733310;733614;764416;894942;734382;932352;;;;;;
201211,706;161536;5337;166400;733614;733966;764416;895150;739303;930816;;;;;;
201236,285;165081;1760;167424;733966;734898;764416;899047;736658;931840;;;;;;
201248,848;161504;800;167936;734898;736050;764416;896402;736850;932352;;;;;;
201256,774;161568;4420;167936;736050;736219;764416;897618;740639;932352;;;;;;
201269,275;165188;4585;166912;736219;736862;764416;901407;741447;931328;;;;;;
201282,233;164329;3733;167424;736862;737917;764416;901191;741650;931840;;;;;;
201313,850;163477;1379;167936;737917;739210;764416;901394;740589;932352;;;;;;
201387,623;161635;800;167424;739210;739490;764416;900845;740290;931840;;;;;;
201436,319;161056;1408;167936;739490;739930;764416;900546;741338;932352;;;;;;
201461,884;162176;5544;166400;739930;740478;764416;902106;746022;930816;;;;;;
201512,444;166312;3667;167424;740478;741573;764416;906790;745240;931840;;;;;;
201526,526;163411;5043;164864;741573;742084;764416;904984;747127;929280;;;;;;
201542,709;164787;2576;167424;742084;742884;764416;906871;745460;931840;;;;;;
201549,130;161808;896;166912;742884;744080;764416;904692;744976;931328;;;;;;
201554,654;160128;4104;167424;744080;744255;764416;904208;748359;931840;;;;;;
201604,220;163848;6350;166400;744255;745490;764416;908103;751840;930816;;;;;;
201639,719;166094;544;166912;745490;747341;764416;911584;747885;931328;;;;;;
201877,508;159206;2329;166912;747342;747534;764416;906548;749863;931328;;;;;;
201959,071;161049;5752;165888;747534;748429;764416;908583;754181;930304;;;;;;
202006,277;163447;3033;166400;748429;750036;764416;911876;753069;930816;;;;;;
202022,666;160729;4887;166912;750036;750864;764416;910765;755751;931328;;;;;;
202026,206;163607;1024;166912;750864;752287;764416;914471;753311;931328;;;;;;
202039,696;159744;3677;167424;752287;752536;764416;912031;756213;931840;;;;;;
202053,872;162909;1699;166912;752536;753952;764416;915445;755651;931328;;;;;;
202064,909;160931;3997;167424;753952;754416;764416;914883;758413;931840;;;;;;
202073,780;163741;4757;167424;754416;755410;764416;918157;760167;931840;;;;;;
202080,850;164501;2353;167424;755410;757099;764416;919911;759452;931840;;;;;;
202087,336;162097;2100;167424;757099;758098;764416;919196;760198;931840;;;;;;
202089,134;161844;3056;168448;758098;758986;764416;919942;762042;932864;;;;;;
202119,002;164336;2448;167936;758986;760434;764416;923322;762882;932352;;;;;;
202128,756;163728;2660;168960;760434;761423;764416;924162;764083;933376;;;;;;
202138,797;164964;2560;168448;761423;761839;764416;926387;764399;932864;;;;;;
202145,348;164864;864;168960;761839;762990;764416;926703;763854;933376;;;;;;
202145,361;864;0;168960;762990;699342;801280;763854;699342;970240;189698;185445;786432;953552;884787;1756672
202173,874;162816;5571;168448;699342;699343;801280;862158;704914;969728;;;;;;
202194,272;168387;960;167424;699343;701027;801280;867730;701987;968704;;;;;;
202202,708;161728;4005;167936;701027;701355;801280;862755;705360;969216;;;;;;
202218,760;164773;5204;166912;701355;702067;801280;866128;707271;968192;;;;;;
202230,642;164948;1473;167424;702067;703840;801280;867015;705313;968704;;;;;;
202241,162;161217;1344;167936;703840;704192;801280;865057;705536;969216;;;;;;
202256,067;162112;2208;167936;704192;704624;801280;866304;706832;969216;;;;;;
202269,380;162976;1333;168448;704624;706354;801280;867600;707687;969728;;;;;;
202312,030;163125;6630;168448;706354;706901;801280;869479;713531;969728;;;;;;
202346,001;168422;4123;165376;706901;708077;801280;875323;712200;966656;;;;;;
202356,678;162843;2976;166912;708077;708815;801280;870920;711791;968192;;;;;;
202406,854;161696;1542;167936;708815;710060;801280;870511;711602;969216;;;;;;
202415,372;161798;4372;167424;710060;710430;801280;871858;714802;968704;;;;;;
202464,455;164628;6332;166400;710430;711343;801280;875058;717675;967680;;;;;;
202488,793;165052;6108;164864;711343;712827;801280;876395;718935;966144;;;;;;
202507,010;164814;4579;166400;712827;713966;801280;877641;718545;967680;;;;;;
202510,155;162275;7888;165888;713966;714859;801280;876241;722747;967168;;;;;;
202517,946;165584;5133;164864;714859;715746;801280;880443;720879;966144;;;;;;
202525,941;160781;1280;165376;715746;717857;801280;876527;719137;966656;;;;;;
202532,836;156928;1776;165888;717857;718146;801280;874785;719922;967168;;;;;;
202540,873;157936;2784;165376;718146;719190;801280;876082;721974;966656;;;;;;
202547,259;158944;896;165888;719190;720471;801280;878134;721367;967168;;;;;;
202561,153;157568;2976;165888;720471;720847;801280;878039;723823;967168;;;;;;
202583,108;159648;3343;166912;720847;721821;801280;880495;725164;968192;;;;;;
202593,323;161551;2176;166400;721821;722604;801280;883372;724780;967680;;;;;;
202638,695;160384;5739;166400;722604;723718;801280;882988;729457;967680;;;;;;
202648,210;164459;7351;166400;723718;724900;801280;888177;732251;967680;;;;;;
202674,245;166071;3122;166400;724900;726227;801280;890971;729349;967680;;;;;;
202709,819;160818;3360;166400;726227;726704;801280;887045;730064;967680;;;;;;
202718,258;160976;1214;166400;726705;727833;801280;887681;729047;967680;;;;;;
202735,244;158910;927;166400;727833;728633;801280;886743;729560;967680;;;;;;
202752,063;158623;3437;166912;728633;729064;801280;887256;732501;968192;;;;;;
202799,300;162157;4963;166912;729064;729841;801280;891221;734804;968192;;;;;;
202807,251;163683;2540;167424;729841;730544;801280;893524;733084;968704;;;;;;
202824,298;161772;5566;166912;730544;731129;801280;892316;736695;968192;;;;;;
202853,118;164798;1226;166912;731129;732969;801280;895927;734195;968192;;;;;;
202871,434;159946;5777;164864;732969;733449;801280;892915;739226;966144;;;;;;
202896,242;164497;1088;166400;733449;734982;801280;897946;736070;967680;;;;;;
202952,983;158784;1008;166400;734982;735366;801280;893766;736374;967680;;;;;;
203005,320;158704;4239;166912;735366;735774;801280;894070;740013;968192;;;;;;
203060,324;162447;3587;166400;735774;736388;801280;898221;739975;967680;;;;;;
203134,392;161795;5148;166912;736388;736388;801280;898183;741536;968192;;;;;;
203237,863;163868;5429;164352;736388;736388;801280;900256;741817;965632;;;;;;
203258,040;164149;3874;166912;736388;736388;801280;900537;740262;968192;;;;;;
203276,691;162082;3378;166400;736388;737076;801280;898470;740454;967680;;;;;;
203288,560;161586;2831;167424;737076;737721;801280;898662;740552;968704;;;;;;
203322,384;162575;1504;167424;737721;739360;801280;900296;740864;968704;;;;;;
203350,377;161248;5489;167424;739360;739849;801280;900608;745338;968704;;;;;;
203372,956;165233;4016;167424;739849;740225;801280;905082;744241;968704;;;;;;
203385,299;163760;2656;167424;740225;741608;801280;903985;744264;968704;;;;;;
203404,734;162400;7007;166912;741608;742497;801280;904008;749504;968192;;;;;;
203418,544;166751;2609;166912;742497;743639;801280;909248;746248;968192;;;;;;
203427,026;161329;1984;166912;743639;744232;801280;904968;746216;968192;;;;;;
203436,747;160704;6349;165888;744232;744970;801280;904936;751319;967168;;;;;;
203464,745;164045;2103;166400;744970;747046;801280;909015;749149;967680;;;;;;
203482,583;159799;4051;166912;747046;747765;801280;906845;751816;968192;;;;;;
203496,018;162259;2961;166400;747765;749183;801280;910024;752144;967680;;;;;;
203530,075;161169;4298;167424;749183;749582;801280;910352;753880;968704;;;;;;
203552,974;164042;608;167424;749582;751224;801280;913624;751832;968704;;;;;;
203580,380;160352;4485;167424;751224;751465;801280;911576;755950;968704;;;;;;
203602,196;164229;5597;165376;751465;752221;801280;915694;757818;966656;;;;;;
203626,359;165341;5016;166912;752221;753376;801280;917562;758392;968192;;;;;;
203648,162;163736;800;166912;753376;755075;801280;917112;755875;968192;;;;;;
203674,556;159520;4243;166912;755075;755420;801280;914595;759663;968192;;;;;;
203684,204;162963;4604;166912;755420;755963;801280;918383;760567;968192;;;;;;
203690,313;163324;4528;166912;755963;756718;801280;919287;761246;968192;;;;;;
203708,068;163248;5297;166912;756718;758086;801280;919966;763383;968192;;;;;;
203726,732;164017;3877;167424;758086;759764;801280;922103;763641;968704;;;;;;
203743,795;162880;4049;166912;759764;761124;801280;922644;765173;968192;;;;;;
203770,943;163281;5544;167424;761124;763811;801280;924405;769355;968704;;;;;;
203783,591;165288;848;160768;763811;765355;801280;929099;766203;962048;;;;;;
203790,555;160592;672;166912;765355;765939;801280;925947;766611;968192;;;;;;
203805,386;159392;5064;166912;765939;766259;801280;925331;771323;968192;;;;;;
203839,318;163784;928;166912;766259;767849;801280;930043;768777;968192;;;;;;
203852,571;159648;4156;166912;767849;768042;801280;927497;772198;968192;;;;;;
203896,728;162876;1165;166912;768042;769450;801280;930918;770615;968192;;;;;;
203940,762;159885;7508;166400;769450;769579;801280;929335;777087;967680;;;;;;
203969,060;166228;3614;166400;769579;770815;801280;935807;774429;967680;;;;;;
203974,532;161297;5276;166400;770910;771638;801280;932207;776914;967680;;;;;;
203977,663;162972;4610;166400;771640;773295;801280;934612;777905;967680;;;;;;
203987,027;162306;7362;165376;773295;774895;801280;935601;782257;966656;;;;;;
203992,821;165058;5106;165888;774895;777035;801280;939953;782141;967168;;;;;;
204004,002;161778;2577;165888;777035;778942;801280;938813;781519;967168;;;;;;
204016,257;159249;576;165888;778942;780517;801280;938191;781093;967168;;;;;;
204017,738;157248;3056;165888;780517;780813;801280;937765;783869;967168;;;;;;
204026,254;159728;2144;166400;780813;783569;801280;940541;785713;967680;;;;;;
204038,312;159840;2672;166400;783569;784989;801280;943409;787661;967680;;;;;;
204091,039;160368;3000;167424;784989;785797;801280;945357;788797;968704;;;;;;
204131,651;162232;7650;166912;785797;787330;801280;948029;794980;968192;;;;;;
204143,452;166882;1161;163840;787330;789195;801280;954212;790356;965120;;;;;;
204162,679;156809;816;165376;789195;789643;801280;946004;790459;966656;;;;;;
204174,227;156464;3044;165888;789643;789755;801280;946107;792799;967168;;;;;;
204180,549;159204;5927;165376;789755;790179;801280;948959;796106;966656;;;;;;
204195,552;162087;4004;165888;790179;790996;801280;952266;795000;967168;;;;;;
204210,141;160676;4628;165888;790996;791716;801280;951672;796344;967168;;;;;;
204227,225;161300;5586;165376;791716;792219;801280;953016;797805;966656;;;;;;
204237,141;162258;2161;165888;792219;793163;801280;954477;795324;967168;;;;;;
204266,232;158833;8691;162304;793163;794081;801280;951996;802772;963584;;;;;;
204279,996;162291;3732;164352;794081;795260;801280;956372;798992;965632;;;;;;
204287,093;157332;3579;165376;795260;795700;801280;952592;799279;966656;;;;;;
204291,765;158715;2930;164864;795700;796796;801280;954415;799726;966144;;;;;;
204306,754;158066;2033;165888;796796;798089;801280;954862;800122;967168;;;;;;
204321,011;158705;4159;165888;798089;799286;801280;956794;803445;967168;;;;;;
204321,033;4159;0;165888;799286;719371;820224;803445;719371;986112;190643;186185;786432;994088;905556;1772544
204344,676;156672;7157;164352;719371;719371;820224;876043;726528;984576;;;;;;
204382,880;162805;5109;165376;719371;720987;820224;882176;726096;985600;;;;;;
204405,472;160757;2933;165888;720987;721515;820224;881744;724448;986112;;;;;;
204421,596;159605;3555;165888;721515;722178;820224;881120;725733;986112;;;;;;
204433,291;160227;3446;166912;722178;722529;820224;882405;725975;987136;;;;;;
204443,153;161654;3698;166400;722529;723081;820224;884183;726779;986624;;;;;;
204447,581;161906;1745;166912;723081;724426;820224;884987;726171;987136;;;;;;
204452,851;160465;3204;166912;724426;724658;820224;884891;727862;987136;;;;;;
204468,995;161924;6217;166400;724658;725314;820224;886582;731531;986624;;;;;;
204482,709;164937;4645;166912;725314;727120;820224;890251;731765;987136;;;;;;
204487,006;163365;7031;165888;727120;729000;820224;890485;736031;986112;;;;;;
204494,551;164727;3332;166400;729000;733040;820224;893727;736372;986624;;;;;;
204500,710;161028;4400;166912;733040;733744;820224;894068;738144;987136;;;;;;
204507,110;162608;5838;166400;733744;734968;820224;896352;740806;986624;;;;;;
204509,912;164046;1409;166400;734968;736612;820224;899014;738021;986624;;;;;;
204513,007;159105;1456;166400;736612;737733;820224;895717;739189;986624;;;;;;
204528,390;159152;6610;165376;737733;738061;820224;896885;744671;985600;;;;;;
204545,841;163282;2130;165888;738061;740237;820224;901343;742367;986112;;;;;;
204558,863;158802;3825;166400;740237;740605;820224;899039;744430;986624;;;;;;
204596,996;161009;4019;165888;740605;743133;820224;901614;747152;986112;;;;;;
204617,240;161203;1361;166912;743133;744668;820224;904336;746029;987136;;;;;;
204624,881;160081;3070;166912;744668;744940;820224;904749;748010;987136;;;;;;
204640,568;161790;3588;167424;744940;745500;820224;906730;749088;987648;;;;;;
204648,432;163332;3932;167424;745500;746132;820224;908832;750064;987648;;;;;;
204659,337;163676;3027;167936;746132;747048;820224;909808;750075;988160;;;;;;
204682,462;163795;5092;167936;747048;747798;820224;910843;752890;988160;;;;;;
204700,123;165860;2677;167936;747798;749676;820224;913658;752353;988160;;;;;;
204712,100;163445;1120;167936;749676;750083;820224;913121;751203;988160;;;;;;
204728,471;161888;1779;167936;750083;750564;820224;911971;752343;988160;;;;;;
204751,545;162547;5864;166912;750564;751228;820224;913111;757092;987136;;;;;;
204767,561;166632;864;167424;751228;752683;820224;917860;753547;987648;;;;;;
204774,121;160608;928;167424;752683;752971;820224;913291;753899;987648;;;;;;
204780,109;160672;4351;167424;752971;753219;820224;913643;757570;987648;;;;;;
204794,209;164095;3796;167424;753219;753804;820224;917314;757600;987648;;;;;;
204804,517;163540;7250;165376;753804;754651;820224;917344;761901;985600;;;;;;
204807,948;164946;1713;166400;754651;757037;820224;919597;758750;986624;;;;;;
204817,049;159409;5523;166400;757037;757197;820224;916446;762720;986624;;;;;;
204830,921;163219;4843;166400;757197;758661;820224;920416;763504;986624;;;;;;
204837,968;162539;5187;166400;758661;759307;820224;921200;764494;986624;;;;;;
204848,600;162883;4372;166400;759307;760218;820224;922190;764590;986624;;;;;;
204857,526;162068;3439;166912;760218;761170;820224;922286;764609;987136;;;;;;
204872,199;161647;1024;166400;761170;762490;820224;922817;763514;986624;;;;;;
204878,732;159232;2867;166912;762490;763034;820224;921722;765901;987136;;;;;;
204897,226;161587;4072;166912;763034;763652;820224;924621;767724;987136;;;;;;
204913,481;162792;3552;167936;763652;764299;820224;926444;767851;988160;;;;;;
204944,891;163808;5476;167424;764299;765425;820224;928107;770901;987648;;;;;;
204954,142;165620;2240;167424;765425;767090;820224;931045;769330;987648;;;;;;
204960,824;161984;4833;167424;767090;767890;820224;929074;772723;987648;;;;;;
204973,929;164577;4668;167424;767890;768570;820224;932467;773238;987648;;;;;;
204995,734;164412;1250;167424;768570;770317;820224;932982;771567;987648;;;;;;
205005,338;160994;4586;167424;770317;770637;820224;931311;775223;987648;;;;;;
205021,291;164330;1024;167424;770637;772325;820224;934967;773349;987648;;;;;;
205030,960;160768;864;167424;772325;772757;820224;933093;773621;987648;;;;;;
205035,188;160608;896;167424;772757;773069;820224;933365;773965;987648;;;;;;
205063,683;160640;6424;165376;773069;773365;820224;933709;779789;985600;;;;;;
205087,671;164120;6357;164352;773365;774790;820224;937485;781147;984576;;;;;;
205101,065;164053;5600;165888;774790;775820;820224;938843;781420;986112;;;;;;
205109,535;162272;3008;165888;775820;777871;820224;938092;780879;986112;;;;;;
205128,782;159680;1040;165888;777871;780155;820224;937551;781195;986112;;;;;;
205138,287;157712;3663;165888;780155;780615;820224;937867;784278;986112;;;;;;
205151,326;160335;1004;166400;780615;782087;820224;940950;783091;986624;;;;;;
205156,748;158700;864;166400;782087;782398;820224;940787;783262;986624;;;;;;
205169,304;158452;2934;167424;782399;782719;820224;940851;785653;987648;;;;;;
205179,904;162166;4636;166912;782719;783151;820224;944885;787787;987136;;;;;;
205190,047;163868;1440;167424;783151;784633;820224;947019;786073;987648;;;;;;
205201,796;160672;1892;166912;784633;785372;820224;945305;787264;987136;;;;;;
205206,979;161124;5039;167424;785372;785603;820224;946496;790642;987648;;;;;;
205213,565;164783;5160;165376;785603;786524;820224;950386;791684;985600;;;;;;
205220,007;164904;5779;165888;786524;787627;820224;951428;793406;986112;;;;;;
205231,234;163475;7748;165888;787627;788553;820224;951102;796301;986112;;;;;;
205246,671;165444;1380;164864;788553;790428;820224;953997;791808;985088;;;;;;
205250,403;157028;3983;165376;790428;791072;820224;947456;795055;985600;;;;;;
205263,545;159631;4963;165888;791072;792452;820224;950703;797415;986112;;;;;;
205270,342;161635;7857;164864;792452;793712;820224;954087;801569;985088;;;;;;
205291,047;164529;4666;165376;793712;795645;820224;958241;800311;985600;;;;;;
205341,456;159802;3284;164864;795645;796806;820224;955447;800090;985088;;;;;;
205471,019;158420;1558;165888;796806;797886;820224;955226;799444;986112;;;;;;
205489,619;158230;5806;162816;797886;798574;820224;956116;804380;983040;;;;;;
205523,762;162478;3332;165888;798574;799321;820224;961052;802653;986112;;;;;;
205547,196;159492;4950;165376;799321;799824;820224;958813;804774;985600;;;;;;
205563,237;161110;3986;166400;799824;800608;820224;960934;804594;986624;;;;;;
205582,110;161170;3106;165888;800608;801977;820224;961778;805083;986112;;;;;;
205591,021;160290;1169;166912;801977;802553;820224;962267;803722;987136;;;;;;
205611,784;159889;3964;166912;802553;802961;820224;962442;806925;987136;;;;;;
205619,425;162684;1218;166912;802961;804571;820224;965645;805789;987136;;;;;;
205667,168;159938;7720;166912;804571;805120;820224;964509;812840;987136;;;;;;
205707,878;166440;6264;163840;805120;806482;820224;971560;812746;984064;;;;;;
205735,600;161912;1072;165376;806482;807876;820224;968394;808948;985600;;;;;;
205749,847;156720;992;165376;807876;808220;820224;964596;809212;985600;;;;;;
205790,933;156640;6269;165376;808220;808469;820224;964860;814738;985600;;;;;;
205829,272;161761;848;165376;808468;810068;820224;970229;810916;985600;;;;;;
205873,182;156496;4146;165376;810068;810442;820224;966564;814588;985600;;;;;;
205931,583;159794;2342;165888;810442;811164;820224;970236;813506;986112;;;;;;
205945,173;158502;6990;165376;811164;811452;820224;969666;818442;985600;;;;;;
205965,088;163150;4131;165888;811452;812604;820224;974602;816735;986112;;;;;;
205977,292;160291;1120;165376;812604;814443;820224;972895;815563;985600;;;;;;
205985,623;157280;1120;165888;814443;814787;820224;971723;815907;986112;;;;;;
206022,916;157792;4166;165888;814787;815363;820224;972579;819529;986112;;;;;;
206065,709;160838;3460;166400;815363;816160;820224;976201;819620;986624;;;;;;
206104,885;160644;1235;165888;816160;817536;820224;976804;818771;986112;;;;;;
206127,626;158419;3741;166912;817536;817793;820224;975955;821534;987136;;;;;;
206149,760;162461;5267;166912;817793;818489;820224;980254;823756;987136;;;;;;
206149,779;5267;0;166912;818489;739602;838656;823756;739602;1005568;190874;186069;786432;1014630;925671;1792000
206169,673;158720;2214;166912;739602;739602;838656;898322;741816;1005568;;;;;;
206180,690;160934;1472;166912;739602;740634;838656;900536;742106;1005568;;;;;;
206189,710;160192;3995;167424;740634;741362;838656;900826;745357;1006080;;;;;;
206201,043;163227;4288;166912;741362;742226;838656;904589;746514;1005568;;;;;;
206209,379;163520;5890;166400;742226;744327;838656;905746;750217;1005056;;;;;;
206216,681;164610;3791;166912;744327;744591;838656;908937;748382;1005568;;;;;;
206228,986;162511;928;166400;744591;746364;838656;907102;747292;1005056;;;;;;
206236,714;159648;960;166912;746364;746667;838656;906012;747627;1005568;;;;;;
206254,888;159680;6485;165888;746667;747027;838656;906347;753512;1004544;;;;;;
206304,502;164181;4518;166400;747027;748198;838656;911208;752716;1005056;;;;;;
206323,187;162214;2448;166912;748198;749806;838656;910412;752254;1005568;;;;;;
206332,876;160656;3679;166400;749806;750382;838656;910462;754061;1005056;;;;;;
206349,171;161887;768;166912;750382;751781;838656;912269;752549;1005568;;;;;;
206367,186;159488;2784;166912;751781;752133;838656;911269;754917;1005568;;;;;;
206395,942;161504;832;167424;752133;753412;838656;913637;754244;1006080;;;;;;
206411,328;160576;2880;167424;753412;753684;838656;913988;756564;1006080;;;;;;
206450,779;162624;4673;167936;753684;754258;838656;916308;758931;1006592;;;;;;
206461,244;165441;3387;167936;754258;754919;838656;919699;758306;1006592;;;;;;
206489,456;164155;3793;167936;754919;756927;838656;919074;760720;1006592;;;;;;
206502,622;164561;7156;167936;756927;758333;838656;921488;765489;1006592;;;;;;
206512,347;167924;4085;165888;758333;759567;838656;926257;763652;1004544;;;;;;
206522,845;162805;832;166912;759567;761007;838656;922372;761839;1005568;;;;;;
206539,662;159552;2482;166912;761007;761271;838656;920559;763753;1005568;;;;;;
206553,938;161202;1168;166912;761271;761903;838656;922473;763071;1005568;;;;;;
206601,866;159888;3360;167424;761903;762263;838656;921791;765623;1006080;;;;;;
206633,243;162592;960;166912;762263;763776;838656;924855;764736;1005568;;;;;;
206642,750;160192;4238;167424;763776;764161;838656;923968;768399;1006080;;;;;;
206660,443;163982;7249;167424;764161;764746;838656;928143;771995;1006080;;;;;;
206666,900;166993;2670;166400;764746;766632;838656;931739;769302;1005056;;;;;;
206693,240;161390;1408;166912;766632;767022;838656;928022;768430;1005568;;;;;;
206719,654;160128;1648;166912;767022;767566;838656;927150;769214;1005568;;;;;;
206734,966;160368;3428;166912;767566;767926;838656;927934;771354;1005568;;;;;;
206816,220;162148;3411;167936;767926;768541;838656;930074;771952;1006592;;;;;;
206823,374;163667;5759;166400;768541;768845;838656;932208;774604;1005056;;;;;;
206835,169;166015;3952;167424;768845;769668;838656;934860;773620;1006080;;;;;;
206844,765;163184;768;166912;769668;771657;838656;932852;772425;1005568;;;;;;
206866,150;160000;3987;167424;771657;771858;838656;931657;775845;1006080;;;;;;
206881,281;163731;4515;167424;771858;772354;838656;935589;776869;1006080;;;;;;
206891,588;164259;4516;167424;772354;773329;838656;936613;777845;1006080;;;;;;
206901,983;164260;1492;167424;773329;774585;838656;937589;776077;1006080;;;;;;
206909,177;161140;4627;167424;774585;775097;838656;935725;779724;1006080;;;;;;
206918,763;164371;2304;167424;775097;775880;838656;939468;778184;1006080;;;;;;
206923,300;162048;5247;167424;775880;777104;838656;937928;782351;1006080;;;;;;
206937,940;164991;832;167424;777104;778851;838656;942095;779683;1006080;;;;;;
206949,209;160576;1888;167424;778851;778891;838656;939427;780779;1006080;;;;;;
206986,264;161632;6838;166912;778891;779155;838656;940523;785993;1005568;;;;;;
207005,895;166582;4900;165888;779155;781057;838656;945737;785957;1004544;;;;;;
207023,113;162596;1536;166400;781057;781692;838656;943653;783228;1005056;;;;;;
207040,840;159232;832;166400;781692;781924;838656;940924;782756;1005056;;;;;;
207070,637;158528;2448;166400;781924;782284;838656;940452;784732;1005056;;;;;;
207087,215;160144;2576;167424;782284;782822;838656;942428;785398;1006080;;;;;;
207127,449;161808;3868;166912;782822;784300;838656;944630;788168;1005568;;;;;;
207149,348;163100;560;167424;784300;784892;838656;947400;785452;1006080;;;;;;
207183,136;160304;7168;167424;784892;785125;838656;945196;792293;1006080;;;;;;
207247,479;166912;1246;165376;785125;786836;838656;952037;788082;1004032;;;;;;
207304,646;158942;992;166400;786836;787347;838656;945778;788339;1005056;;;;;;
207334,459;158688;8183;163840;787347;787508;838656;946035;795691;1002496;;;;;;
207396,084;163831;6128;161792;787508;788832;838656;951339;794960;1000448;;;;;;
207408,576;161776;4451;165376;788832;788832;838656;950608;793283;1004032;;;;;;
207415,546;159587;3171;164864;788832;790289;838656;948419;793460;1003520;;;;;;
207421,445;158307;3053;165888;790289;790863;838656;948596;793916;1004544;;;;;;
207435,144;159725;944;165888;790863;792433;838656;950588;793377;1004544;;;;;;
207523,493;157616;3831;166400;792433;792720;838656;950049;796551;1005056;;;;;;
207618,431;161237;7398;165376;792721;794745;838656;953958;802143;1004032;;;;;;
207631,565;165094;5985;165376;794745;796104;838656;959839;802089;1004032;;;;;;
207641,925;161633;3651;165376;796104;798449;838656;957737;802100;1004032;;;;;;
207675,145;159299;4640;165888;798449;799627;838656;957748;804267;1004544;;;;;;
207700,494;161312;1216;165888;799627;800837;838656;960939;802053;1004544;;;;;;
207705,399;157888;1104;165888;800837;801489;838656;958725;802593;1004544;;;;;;
207716,712;157776;1820;165888;801489;801921;838656;959265;803741;1004544;;;;;;
207742,022;158492;4528;166400;801921;802444;838656;960413;806972;1005056;;;;;;
207772,528;162224;4020;166400;802444;803212;838656;964668;807232;1005056;;;;;;
207833,220;161716;4640;166912;803212;803868;838656;964928;808508;1005568;;;;;;
207863,467;163360;992;166912;803868;805449;838656;967228;806441;1005568;;;;;;
207885,365;159712;2724;166912;805449;805625;838656;965161;808349;1005568;;;;;;
207899,484;161444;3520;166912;805625;806087;838656;967069;809607;1005568;;;;;;
207912,859;162240;4571;167424;806087;806794;838656;968327;811365;1006080;;;;;;
207923,843;164315;2784;167424;806794;807789;838656;971109;810573;1006080;;;;;;
207943,575;162528;1207;167936;807789;809095;838656;970317;810302;1006592;;;;;;
207956,183;161975;3428;167936;809095;809679;838656;971070;813107;1006592;;;;;;
208048,339;164196;1327;167936;809679;811007;838656;973875;812334;1006592;;;;;;
208101,234;162095;4823;167936;811007;811383;838656;973102;816206;1006592;;;;;;
208105,396;165591;1072;167936;811383;813049;838656;976974;814121;1006592;;;;;;
208123,654;161840;975;167936;813049;813581;838656;974889;814556;1006592;;;;;;
208156,646;161684;4829;166912;813581;814061;838656;975265;818890;1005568;;;;;;
208224,124;164573;4698;167424;814061;814805;838656;978634;819503;1006080;;;;;;
208243,349;164196;2321;167424;814805;816302;838656;979001;818623;1006080;;;;;;
208258,888;162065;4118;167424;816302;816765;838656;978367;820883;1006080;;;;;;
208271,007;163862;896;167424;816765;818072;838656;980627;818968;1006080;;;;;;
208286,073;160640;4559;167424;818072;818392;838656;978712;822951;1006080;;;;;;
208357,531;164303;1331;167424;818392;819798;838656;982695;821129;1006080;;;;;;
208379,143;161075;2162;167424;819798;820127;838656;980873;822289;1006080;;;;;;
208406,438;161906;3360;167936;820127;820505;838656;982033;823865;1006592;;;;;;
208418,901;164128;4907;167936;820505;821105;838656;984633;826012;1006592;;;;;;
208438,517;165675;1800;167936;821105;822404;838656;986780;824204;1006592;;;;;;
208451,164;162568;3956;167936;822404;822998;838656;984972;826954;1006592;;;;;;
208500,137;164724;1072;167936;822998;824318;838656;987722;825390;1006592;;;;;;
208541,438;161840;4177;167936;824318;824894;838656;986158;829071;1006592;;;;;;
208586,939;164945;928;167936;824894;826285;838656;989839;827213;1006592;;;;;;
208700,958;161696;4627;167936;826285;826486;838656;987981;831113;1006592;;;;;;
208715,575;165395;4899;166912;826486;826486;838656;991881;831385;1005568;;;;;;
208771,053;164643;3211;167424;826486;827366;838656;991129;830577;1006080;;;;;;
208864,909;162955;6747;165888;827366;828194;838656;990321;834941;1004544;;;;;;
208881,019;165467;6149;165376;828194;828195;838656;993661;834344;1004032;;;;;;
208888,938;164869;3200;166912;828195;828586;838656;993064;831786;1005568;;;;;;
208893,879;161408;1694;166400;828586;830866;838656;989994;832560;1005056;;;;;;
208907,738;159902;5076;166912;830866;831426;838656;990768;836502;1005568;;;;;;
208912,118;163796;1024;166912;831426;832969;838656;995222;833993;1005568;;;;;;
208916,863;159744;1184;166912;832969;833233;838656;992713;834417;1005568;;;;;;
208922,955;159904;3716;166912;833233;833785;838656;993137;837501;1005568;;;;;;
208930,879;162436;2688;167424;833785;834737;838656;996221;837425;1006080;;;;;;
208946,679;161920;1184;166912;834737;836112;838656;996657;837296;1005568;;;;;;
208962,481;160416;1201;167424;836112;836672;838656;996528;837873;1006080;;;;;;
208962,500;1201;0;167424;836672;730906;828416;837873;730906;995840;191505;185862;786432;1029378;916768;1782272
208981,830;159744;1574;167424;730906;730906;828416;890650;732480;995840;;;;;;
209018,249;161318;6765;165888;730906;731825;828416;892224;738590;994304;;;;;;
209042,847;165485;1266;166912;731825;733474;828416;897310;734740;995328;;;;;;
209056,972;159986;3700;167424;733474;734026;828416;893460;737726;995840;;;;;;
209067,826;162932;992;166912;734026;735330;828416;896958;736322;995328;;;;;;
209077,172;160224;1026;167424;735330;735833;828416;895554;736859;995840;;;;;;
209122,933;160770;912;167424;735833;735994;828416;896603;736906;995840;;;;;;
209143,854;160656;802;167936;735994;736338;828416;896650;737140;996352;;;;;;
209158,515;161058;608;167424;736338;736522;828416;897396;737130;995840;;;;;;
209206,187;160864;3734;167936;736522;736690;828416;897386;740424;996352;;;;;;
209213,540;164502;2942;167936;736690;738066;828416;901192;741008;996352;;;;;;
209257,762;163710;3902;167936;738066;738653;828416;901776;742555;996352;;;;;;
209317,464;164670;4180;167936;738653;739356;828416;903323;743536;996352;;;;;;
209336,652;164948;1024;167936;739356;740819;828416;904304;741843;996352;;;;;;
209347,596;161792;4996;165888;740819;741051;828416;902611;746047;994304;;;;;;
209383,067;165764;4097;167424;741051;741660;828416;906815;745757;995840;;;;;;
209396,474;163841;6171;166400;741660;742188;828416;905501;748359;994816;;;;;;
209403,989;165915;1890;166912;742188;744054;828416;908103;745944;995328;;;;;;
209411,362;160610;1634;166912;744054;744342;828416;904664;745976;995328;;;;;;
209420,884;160354;5535;166400;744342;745126;828416;904696;750661;994816;;;;;;
209435,268;164255;2828;166912;745126;745937;828416;909381;748765;995328;;;;;;
209462,950;161548;1152;167424;745937;747953;828416;907485;749105;995840;;;;;;
209472,319;160384;2948;166912;747953;748401;828416;908337;751349;995328;;;;;;
209484,682;162180;2290;167936;748401;750989;828416;910581;753279;996352;;;;;;
209494,173;163058;1024;167936;750989;751342;828416;914047;752366;996352;;;;;;
209500,785;161792;1220;168448;751342;751661;828416;913134;752881;996864;;;;;;
209511,929;162500;5424;166912;751661;752014;828416;914161;757438;995328;;;;;;
209518,274;166704;940;167936;752014;754070;828416;918718;755010;996352;;;;;;
209526,471;161196;864;167424;754070;754325;828416;915266;755189;995840;;;;;;
209535,672;161120;1904;168448;754325;754413;828416;915445;756317;996864;;;;;;
209556,955;163184;5012;166400;754413;756102;828416;917597;761114;994816;;;;;;
209579,454;166276;2229;167936;756102;758362;828416;922378;760591;996352;;;;;;
209589,390;162485;3947;167424;758362;758914;828416;920847;762861;995840;;;;;;
209601,969;164203;6394;165888;758914;759661;828416;923117;766055;994304;;;;;;
209608,939;165114;1088;166912;759661;761855;828416;924775;762943;995328;;;;;;
209623,329;159808;3604;167424;761855;762544;828416;921663;766148;995840;;;;;;
209633,223;162836;3599;166912;762544;763320;828416;925380;766919;995328;;;;;;
209647,847;162831;2625;167936;763320;765099;828416;926151;767724;996352;;;;;;
209661,168;162881;640;167424;765099;765978;828416;927980;766618;995840;;;;;;
209700,031;160896;3615;167936;765978;766219;828416;926874;769834;996352;;;;;;
209716,135;164383;5076;165888;766219;766787;828416;930602;771863;994304;;;;;;
209741,543;165844;5056;167424;766787;767643;828416;932631;772699;995840;;;;;;
209748,558;164567;1186;167424;767643;769011;828416;932210;770197;995840;;;;;;
209766,103;160930;3827;167424;769011;769547;828416;929941;773374;995840;;;;;;
209778,401;163571;3472;167424;769547;770227;828416;933118;773699;995840;;;;;;
209783,706;163216;4979;166912;770227;770827;828416;933443;775806;995328;;;;;;
209797,469;164723;5056;167424;770827;771619;828416;935550;776675;995840;;;;;;
209799,634;164800;1248;167424;771619;773586;828416;936419;774834;995840;;;;;;
209801,600;160992;1440;167424;773586;774634;828416;934578;776074;995840;;;;;;
209808,204;161184;896;167424;774634;775242;828416;935818;776138;995840;;;;;;
209861,763;160640;3903;167424;775242;775723;828416;935882;779626;995840;;;;;;
209882,010;163647;4739;167424;775723;776435;828416;939370;781174;995840;;;;;;
209900,514;164483;4931;164864;776435;777003;828416;940918;781934;993280;;;;;;
209909,698;164675;960;166912;777003;778941;828416;941678;779901;995328;;;;;;
209919,703;159680;4588;166912;778941;779173;828416;938621;783761;995328;;;;;;
209932,517;163308;1408;167424;779173;780761;828416;942481;782169;995840;;;;;;
210011,971;160640;4460;166912;780761;781274;828416;941401;785734;995328;;;;;;
210023,829;163692;608;166912;781274;782794;828416;944966;783402;995328;;;;;;
210061,612;159328;3423;166912;782794;783034;828416;942122;786457;995328;;;;;;
210085,967;161852;5397;166400;783034;783674;828416;944886;789071;994816;;;;;;
210100,507;164117;4894;166912;783674;784308;828416;947791;789202;995328;;;;;;
210116,985;163614;960;166912;784308;785828;828416;947922;786788;995328;;;;;;
210124,473;159680;5171;164352;785828;786373;828416;945508;791544;992768;;;;;;
210150,227;163891;5312;166400;786373;786924;828416;950264;792236;994816;;;;;;
210156,010;163008;1008;166400;786924;788236;828416;949932;789244;994816;;;;;;
210179,398;158704;3460;166912;788236;788484;828416;946940;791944;995328;;;;;;
210199,005;161668;1056;166400;788484;789996;828416;950152;791052;994816;;;;;;
210217,687;159264;3348;167424;789996;790372;828416;949260;793720;995840;;;;;;
210223,282;162580;1122;166912;790372;791812;828416;952952;792934;995328;;;;;;
210253,163;160354;1616;167936;791812;792004;828416;952166;793620;996352;;;;;;
210273,148;161872;3458;167424;792004;792404;828416;953876;795862;995840;;;;;;
210280,837;163714;1025;167936;792404;793724;828416;956118;794749;996352;;;;;;
210299,735;161793;5192;166400;793724;794076;828416;955517;799268;994816;;;;;;
210308,716;165960;1120;167424;794076;795707;828416;960036;796827;995840;;;;;;
210327,040;160864;3652;167424;795707;796108;828416;956571;799760;995840;;;;;;
210344,412;163396;1313;167936;796108;797487;828416;959504;798800;996352;;;;;;
210357,709;162081;3394;167936;797487;797960;828416;959568;801354;996352;;;;;;
210363,492;164162;3826;167936;797960;798744;828416;962122;802570;996352;;;;;;
210375,074;164594;1200;167936;798744;799832;828416;963338;801032;996352;;;;;;
210386,722;161968;3727;167936;799832;800385;828416;961800;804112;996352;;;;;;
210390,435;164495;992;167936;800385;801768;828416;964880;802760;996352;;;;;;
210423,339;161760;3556;168448;801768;802169;828416;963528;805725;996864;;;;;;
210456,674;165348;1679;168448;802169;803641;828416;967517;805320;996864;;;;;;
210471,492;163471;5039;167424;803641;804217;828416;967112;809256;995840;;;;;;
210519,013;165807;4484;167936;804217;805209;828416;970024;809693;996352;;;;;;
210548,367;165252;2995;167936;805209;806610;828416;970461;809605;996352;;;;;;
210587,162;163763;3168;167936;806610;807049;828416;970373;810217;996352;;;;;;
210617,768;163936;4885;167424;807049;807522;828416;970985;812407;995840;;;;;;
210632,541;165653;896;167936;807522;808849;828416;973175;809745;996352;;;;;;
210658,184;161664;3508;168448;808849;809193;828416;970513;812701;996864;;;;;;
210666,464;164788;896;167936;809193;810657;828416;973981;811553;996352;;;;;;
210673,892;162176;1156;168448;810657;810826;828416;972833;811982;996864;;;;;;
210708,433;162948;4428;166400;810826;811170;828416;973774;815598;994816;;;;;;
210721,243;166220;964;167936;811170;812786;828416;977390;813750;996352;;;;;;
210795,351;161732;3252;167936;812786;812946;828416;974518;816198;996352;;;;;;
210802,224;164020;768;168448;812946;814305;828416;976966;815073;996864;;;;;;
210876,168;162560;3603;168448;814305;814657;828416;976865;818260;996864;;;;;;
210929,892;165395;966;168448;814657;816224;828416;980052;817190;996864;;;;;;
210956,715;162758;608;168448;816224;816640;828416;978982;817248;996864;;;;;;
210963,926;162400;2895;168960;816640;816880;828416;979040;819775;997376;;;;;;
211039,306;165199;2240;168448;816880;817248;828416;982079;819488;996864;;;;;;
211069,104;164544;3653;168960;817248;817664;828416;981792;821317;997376;;;;;;
211082,055;166469;2272;168960;817664;818000;828416;984133;820272;997376;;;;;;
211104,624;165088;1330;169472;818000;819369;828416;983088;820699;997888;;;;;;
211124,115;165170;1252;169472;819369;819481;828416;984539;820733;997888;;;;;;
211132,930;165092;3616;169472;819481;819841;828416;984573;823457;997888;;;;;;
211152,363;167456;1184;169472;819841;821209;828416;987297;822393;997888;;;;;;
211174,390;165024;5186;167424;821209;821601;828416;986233;826787;995840;;;;;;
211193,902;166978;1875;168448;821601;823033;828416;988579;824908;996864;;;;;;
211204,802;163667;1501;168960;823033;823273;828416;986700;824774;997376;;;;;;
211220,681;164317;4055;168960;823273;823641;828416;987590;827696;997376;;;;;;
211233,225;166871;4329;167936;823641;824524;828416;990512;828853;996352;;;;;;
211247,032;166121;6653;168448;824524;825213;828416;990645;831866;996864;;;;;;
211256,450;168445;1859;166400;825213;826929;828416;993658;828788;994816;;;;;;
211256,466;1859;0;166400;826929;733835;829952;828788;733835;996352;186909;185577;786432;1015697;919412;1782784
211290,576;159744;1685;167424;733835;733836;829952;893579;735521;997376;;;;;;
211327,250;161429;4354;167424;733836;734700;829952;895265;739054;997376;;;;;;
211340,139;164098;2908;167424;734700;735964;829952;898798;738872;997376;;;;;;
211345,039;162652;832;167936;735964;736507;829952;898616;737339;997888;;;;;;
211358,642;161600;1120;167936;736507;736700;829952;898107;737820;997888;;;;;;
211385,325;161888;3663;167936;736700;737076;829952;898588;740739;997888;;;;;;
211417,759;164431;608;167936;737076;738563;829952;901507;739171;997888;;;;;;
211436,050;161376;3216;168448;738563;738812;829952;899939;742028;998400;;;;;;
211494,307;164496;1152;167936;738812;740389;829952;903308;741541;997888;;;;;;
211514,723;162432;1232;168448;740389;741001;829952;902821;742233;998400;;;;;;
211523,165;163024;960;168448;741001;741690;829952;904025;742650;998400;;;;;;
211554,666;162752;4948;166912;741690;741962;829952;904442;746910;996864;;;;;;
211718,835;165716;3651;167936;741962;742634;829952;907678;746285;997888;;;;;;
211760,323;164419;5732;166912;742634;742634;829952;907053;748366;996864;;;;;;
211776,273;165476;5648;165888;742634;742633;829952;908110;748281;995840;;;;;;
211791,209;165392;2976;167424;742633;743465;829952;908025;746441;997376;;;;;;
211801,136;162208;2967;166912;743465;744025;829952;905673;746992;996864;;;;;;
211843,843;162199;3828;167936;744025;744689;829952;906224;748517;997888;;;;;;
211854,470;164596;704;167936;744689;746384;829952;909285;747088;997888;;;;;;
211883,459;161472;3716;167936;746384;746553;829952;907856;750269;997888;;;;;;
211898,695;164484;7156;167936;746553;747848;829952;911037;755004;997888;;;;;;
211914,930;167924;992;164864;747848;749803;829952;915772;750795;994816;;;;;;
211964,745;158688;3828;166400;749803;750068;829952;908491;753896;996352;;;;;;
211985,790;161499;2656;166912;750068;750923;829952;911567;753579;996864;;;;;;
212009,783;161376;4965;166912;750923;751450;829952;912299;756415;996864;;;;;;
212024,828;163685;3492;167424;751450;752299;829952;915135;755791;997376;;;;;;
212037,729;162724;1218;166912;752299;753499;829952;915023;754717;996864;;;;;;
212085,295;160450;3887;167424;753499;753963;829952;913949;757850;997376;;;;;;
212106,893;163631;4337;167424;753963;754482;829952;917594;758819;997376;;;;;;
212124,676;164081;1730;167424;754482;755947;829952;918563;757677;997376;;;;;;
212142,748;161474;4116;167424;755947;756299;829952;917421;760415;997376;;;;;;
212167,345;163860;1056;167936;756299;758270;829952;920159;759326;997888;;;;;;
212187,322;161824;1216;167936;758270;758955;829952;920094;760171;997888;;;;;;
212203,285;161984;3556;167936;758955;759091;829952;920939;762647;997888;;;;;;
212213,245;164318;960;167936;759091;760851;829952;923409;761811;997888;;;;;;
212216,926;161728;1062;167936;760851;761115;829952;922579;762177;997888;;;;;;
212222,242;161830;4160;167936;761115;761363;829952;922945;765523;997888;;;;;;
212250,208;164928;4066;167936;761363;762043;829952;926291;766109;997888;;;;;;
212259,628;164834;1971;167936;762043;763355;829952;926877;765326;997888;;;;;;
212266,974;162739;944;168448;763355;763715;829952;926094;764659;998400;;;;;;
212278,238;162224;1280;167936;763715;763947;829952;925939;765227;997888;;;;;;
212324,015;162560;6177;166400;763947;764356;829952;926507;770533;996352;;;;;;
212349,589;165921;1084;167424;764356;765856;829952;930277;766940;997376;;;;;;
212383,232;160828;3716;167424;765856;766201;829952;926684;769917;997376;;;;;;
212464,221;163460;3420;167424;766201;766753;829952;929661;770173;997376;;;;;;
212487,942;163164;2882;168448;766753;767832;829952;929917;770714;998400;;;;;;
212497,303;164162;1120;167936;767832;768225;829952;931994;769345;997888;;;;;;
212501,245;162400;896;168448;768225;768489;829952;930625;769385;998400;;;;;;
212519,535;162688;3509;168448;768489;768673;829952;931177;772182;998400;;;;;;
212533,489;165060;1298;168448;768673;769713;829952;933733;771011;998400;;;;;;
212562,917;163090;6561;168448;769713;770449;829952;932803;777010;998400;;;;;;
212583,104;168353;993;166400;770449;772065;829952;938802;773058;996352;;;;;;
212646,484;160595;1770;167424;773363;773522;829952;933958;775292;997376;;;;;;
212672,754;161514;3280;167936;773527;774152;829952;935041;777432;997888;;;;;;
212686,309;164048;4114;167936;774152;774768;829952;938200;778882;997888;;;;;;
212694,444;164882;3935;167936;774768;775304;829952;939650;779239;997888;;;;;;
212701,198;164703;1089;167936;775304;776940;829952;940007;778029;997888;;;;;;
212708,518;161857;2080;168448;776940;777203;829952;938797;779283;998400;;;;;;
212751,176;163360;1280;167936;777203;778758;829952;940563;780038;997888;;;;;;
212796,249;162560;4319;168448;778758;779594;829952;941318;783913;998400;;;;;;
212852,131;166111;800;168448;779594;781098;829952;945705;781898;998400;;;;;;
212924,558;162592;4384;167424;781098;781443;829952;943690;785827;997376;;;;;;
212952,246;165152;4271;167936;781443;781442;829952;946595;785713;997888;;;;;;
212973,494;165039;2432;167936;781442;781442;829952;946481;783874;997888;;;;;;
212984,597;163200;5135;167936;781442;781443;829952;944642;786578;997888;;;;;;
213033,381;165903;3968;167936;781443;781979;829952;947346;785947;997888;;;;;;
213037,700;164736;2576;167936;781979;782387;829952;946715;784963;997888;;;;;;
213063,623;163344;2512;168448;782387;783131;829952;945731;785643;998400;;;;;;
213090,910;163792;5424;167936;783131;783561;829952;946923;788985;997888;;;;;;
213121,360;166463;4282;167936;783561;784529;829952;950024;788811;997888;;;;;;
213133,209;165050;3728;167936;784529;785313;829952;949579;789041;997888;;;;;;
213167,984;164496;4047;167936;785313;786354;829952;949809;790401;997888;;;;;;
213197,512;164815;4015;167936;786354;787343;829952;951169;791358;997888;;;;;;
213230,682;164783;1567;168448;787343;788671;829952;952126;790238;998400;;;;;;
213255,896;163359;4456;166400;788671;789266;829952;952030;793722;996352;;;;;;
213263,129;166248;3551;168448;789266;790041;829952;955514;793592;998400;;;;;;
213292,696;164831;2816;167936;790041;790697;829952;954872;793513;997888;;;;;;
213387,342;164096;2692;168960;790697;792080;829952;954793;794772;998912;;;;;;
213515,267;164996;5336;168448;792080;792424;829952;957076;797760;998400;;;;;;
213568,523;167640;5929;167424;792424;792424;829952;960064;798353;997376;;;;;;
213603,178;166697;3256;167936;792424;792424;829952;959121;795680;997888;;;;;;
213650,308;164024;7138;165888;792424;792817;829952;956448;799955;995840;;;;;;
213686,550;165858;6757;165888;792817;793873;829952;958675;800630;995840;;;;;;
213722,478;165477;3455;166400;793873;793873;829952;959350;797328;996352;;;;;;
213742,926;161151;3807;166400;793873;793873;829952;955024;797680;996352;;;;;;
213767,423;161503;4943;166912;793873;793873;829952;955376;798816;996864;;;;;;
213932,225;163663;8009;166912;794521;794522;829952;958184;802531;996864;;;;;;
213952,829;166729;7121;163840;794526;794526;829952;961255;801647;993792;;;;;;
213968,122;162769;6145;165376;794526;794526;829952;957295;800671;995328;;;;;;
213988,453;161793;5873;165376;794526;794662;829952;956319;800535;995328;;;;;;
214042,494;161521;6674;165376;794662;795530;829952;956183;802204;995328;;;;;;
214110,876;162322;4863;165888;795530;796289;829952;957852;801152;995840;;;;;;
214147,274;161023;5143;165376;796289;796289;829952;957312;801432;995328;;;;;;
214256,503;161303;8504;164864;796289;796289;829952;957592;804793;994816;;;;;;
214267,524;164152;8198;164352;796289;796289;829952;960441;804487;994304;;;;;;
214298,576;163846;5983;164864;796289;796529;829952;960135;802512;994816;;;;;;
214418,281;160519;8300;163328;796529;797386;829952;957048;805686;993280;;;;;;
214617,310;162924;6262;164864;797386;797971;829952;960310;804233;994816;;;;;;
214643,333;160374;5919;164352;797971;797970;829952;958345;803889;994304;;;;;;
214672,007;160031;8227;164352;797970;797970;829952;958001;806197;994304;;;;;;
214703,712;162851;6609;164864;797970;797970;829952;960821;804579;994816;;;;;;
214727,937;161233;6942;165376;797970;797971;829952;959203;804913;995328;;;;;;
214795,885;162078;7331;164864;797971;798506;829952;960049;805837;994816;;;;;;
214805,005;162467;7088;165376;798506;798875;829952;960973;805963;995328;;;;;;
214809,759;162736;6622;165376;798875;799179;829952;961611;805801;995328;;;;;;
214848,203;162270;7842;165376;799179;799627;829952;961449;807469;995328;;;;;;
214858,417;19989;4497;165376;799626;800594;829952;819615;805091;995328;;;;;;
214858,442;4497;0;165376;800594;742546;829952;805091;742546;995328;188429;186033;786432;993520;928579;1781760
214890,717;155648;1392;164352;742546;742546;829952;898194;743938;994304;;;;;;
214902,957;156016;3841;164864;742546;742546;829952;898562;746387;994816;;;;;;
214938,268;158465;3104;164864;742546;742546;829952;901011;745650;994816;;;;;;
214981,748;157728;5823;164864;742546;742546;829952;900274;748369;994816;;;;;;
215036,382;160447;3711;165376;742546;742546;829952;902993;746257;995328;;;;;;
215067,598;158847;3793;164864;742546;742546;829952;901393;746339;994816;;;;;;
215090,654;158929;3969;165376;742546;742546;829952;901475;746515;995328;;;;;;
215149,722;159617;6766;165376;742546;742858;829952;902163;749624;995328;;;;;;
215254,573;162414;4193;165376;742858;742858;829952;905272;747051;995328;;;;;;
215284,349;159841;7769;163840;742858;742858;829952;902699;750627;993792;;;;;;
215305,845;163417;6070;165376;742858;742858;829952;906275;748928;995328;;;;;;
215358,445;161206;8227;164864;742858;743303;829952;904064;751530;994816;;;;;;
215415,411;163363;7227;163840;743303;743303;829952;906666;750530;993792;;;;;;
215488,494;160827;7613;164352;743303;743304;829952;904130;750917;994304;;;;;;
215503,148;161213;10282;162304;743304;743303;829952;904517;753585;992256;;;;;;
215533,585;161834;8049;163328;743303;743624;829952;905137;751673;993280;;;;;;
215541,945;159601;6931;163328;743624;743903;829952;903225;750834;993280;;;;;;
215556,041;158483;7345;163328;743903;744176;829952;902386;751521;993280;;;;;;
215564,090;158897;9700;162816;744176;744480;829952;903073;754180;992768;;;;;;
215573,854;161252;6667;163328;744480;744664;829952;905732;751331;993280;;;;;;
215582,011;158219;6830;163840;744664;745943;829952;902883;752773;993792;;;;;;
215593,837;158894;4273;163328;745943;746796;829952;904837;751069;993280;;;;;;
215615,437;156337;3967;163840;746796;747372;829952;903133;751339;993792;;;;;;
215628,388;156543;6063;163840;747372;747947;829952;903915;754010;993792;;;;;;
215636,392;158639;3369;164352;747947;748589;829952;906586;751958;994304;;;;;;
215653,390;156969;5375;164352;748589;748968;829952;905558;754343;994304;;;;;;
215687,677;158975;4031;164352;748968;749456;829952;907943;753487;994304;;;;;;
215711,328;157631;3552;164352;749456;750302;829952;907087;753854;994304;;;;;;
215726,418;157152;4014;164864;750302;750964;829952;907454;754978;994816;;;;;;
215753,479;158638;3404;164864;750964;751389;829952;909602;754793;994816;;;;;;
215809,739;158028;848;164864;751389;752637;829952;909417;753485;994816;;;;;;
215863,606;155472;624;155648;752637;752909;829952;908109;753533;985600;;;;;;
215899,381;155248;800;164352;752909;753101;829952;908157;753901;994304;;;;;;
215961,529;154400;6725;164352;753101;753102;829952;907501;759827;994304;;;;;;
215987,157;160325;4445;164864;753102;753102;829952;913427;757547;994816;;;;;;
216007,178;158557;5528;164352;753102;753101;829952;911659;758629;994304;;;;;;
216025,326;159640;4002;165376;753101;753101;829952;912741;757103;995328;;;;;;
216037,318;159138;6051;164864;753101;753270;829952;912239;759321;994816;;;;;;
216071,028;161187;3311;165376;753270;754439;829952;914457;757750;995328;;;;;;
216093,897;158959;3823;165376;754439;755167;829952;913398;758990;995328;;;;;;
216109,787;159471;4148;166400;755167;756054;829952;914638;760202;996352;;;;;;
216119,601;161332;3759;165888;756054;757124;829952;917386;760883;995840;;;;;;
216135,504;160943;1091;166400;757124;758508;829952;918067;759599;996352;;;;;;
216151,739;158787;3983;166400;758508;758820;829952;917295;762803;996352;;;;;;
216164,611;161679;3444;167424;758820;759500;829952;920499;762944;997376;;;;;;
216171,676;162676;5108;166912;759500;760109;829952;922176;765217;996864;;;;;;
216184,018;164340;1332;166912;760109;761752;829952;924449;763084;996864;;;;;;
216240,033;160052;4159;166912;761752;762185;829952;921804;766344;996864;;;;;;
216282,057;162879;4943;167424;762185;762880;829952;925064;767823;997376;;;;;;
216300,471;164687;4145;167424;762880;763775;829952;927567;767920;997376;;;;;;
216311,823;163889;3276;167936;763775;764589;829952;927664;767865;997888;;;;;;
216320,000;163532;4717;167424;764589;765060;829952;928121;769777;997376;;;;;;
216334,599;164973;1792;167936;765060;766760;829952;930033;768552;997888;;;;;;
216345,059;162560;1188;162304;766760;767168;829952;929320;768356;992256;;;;;;
216352,304;161956;3148;167936;767168;767512;829952;929124;770660;997888;;;;;;
216380,621;163404;1184;167424;767512;768888;829952;930916;770072;997376;;;;;;
216432,297;161440;3380;168448;768888;769360;829952;930328;772740;998400;;;;;;
216448,275;164660;944;167936;769360;770896;829952;934020;771840;997888;;;;;;
216536,930;162224;3700;168448;770896;771176;829952;933120;774876;998400;;;;;;
216564,651;164980;4225;167936;771176;771688;829952;936156;775913;997888;;;;;;
216580,214;165505;1873;168448;771688;773112;829952;937193;774985;998400;;;;;;
216589,155;163665;864;168448;773112;773344;829952;936777;774208;998400;;;;;;
216605,347;162656;2292;168448;773344;773656;829952;936000;775948;998400;;;;;;
216626,408;164084;2656;168448;773656;774189;829952;937740;776845;998400;;;;;;
216663,508;164400;4670;167936;774189;774926;829952;938589;779596;997888;;;;;;
216674,878;166462;5506;167424;774926;775461;829952;941388;780967;997376;;;;;;
216682,336;167298;4449;167936;775461;776672;829952;942759;781121;997888;;;;;;
216701,352;165217;2034;167936;776672;778700;829952;941889;780734;997888;;;;;;
216714,547;162802;3780;167936;778700;779732;829952;941502;783512;997888;;;;;;
216724,326;164548;1580;167936;779732;781036;829952;944280;782616;997888;;;;;;
216730,281;162348;1970;168448;781036;781379;829952;943384;783349;998400;;;;;;
216742,592;163250;2545;167936;781379;782068;829952;944629;784613;997888;;;;;;
216759,547;163825;976;168448;782068;782276;829952;945893;783252;998400;;;;;;
216772,952;162768;1584;168448;782276;782804;829952;945044;784388;998400;;;;;;
216983,277;163376;992;168960;782804;783084;829952;946180;784076;998912;;;;;;
217053,184;163808;1324;168960;783084;783388;829952;946892;784712;998912;;;;;;
217073,145;164140;1024;168960;783388;783748;829952;947528;784772;998912;;;;;;
217116,624;163840;908;168960;783748;784108;829952;947588;785016;998912;;;;;;
217131,078;163724;2034;169472;784108;784364;829952;947832;786398;999424;;;;;;
217145,450;165874;800;169472;784364;785011;829952;950238;785811;999424;;;;;;
217192,975;164640;2118;169984;785011;785252;829952;949651;787370;999936;;;;;;
217203,597;166470;848;169472;785252;785483;829952;951722;786331;999424;;;;;;
217247,757;165200;3620;168960;785483;785827;829952;950683;789447;998912;;;;;;
217273,600;167460;928;169472;785827;787059;829952;953287;787987;999424;;;;;;
217286,695;164768;1088;169984;787059;787315;829952;951827;788403;999936;;;;;;
217423,122;165952;1229;169984;787315;787739;829952;953267;788968;999936;;;;;;
217435,378;166093;3339;169984;787739;787739;829952;953832;791078;999936;;;;;;
217465,335;168203;1270;169984;787739;788082;829952;955942;789352;999936;;;;;;
217483,701;166134;928;169984;788082;788442;829952;954216;789370;999936;;;;;;
217545,580;165792;1456;169984;788442;788547;829952;954234;790003;999936;;;;;;
217558,775;166320;1600;170496;788547;788547;829952;954867;790147;1000448;;;;;;
217576,861;167488;1408;170496;788547;788923;829952;956035;790331;1000448;;;;;;
217660,597;167296;4085;168960;788923;789193;829952;956219;793278;998912;;;;;;
217686,450;168949;5108;169984;789193;789972;829952;958142;795080;999936;;;;;;
217702,194;169972;3843;167936;789972;790948;829952;959944;794791;997888;;;;;;
217713,274;166659;2336;168960;790948;791722;829952;957607;794058;998912;;;;;;
217734,071;165152;944;168960;791722;792971;829952;956874;793915;998912;;;;;;
217758,320;163760;3284;168960;792971;793307;829952;956731;796591;998912;;;;;;
217783,781;166100;3636;168960;793307;793963;829952;959407;797599;998912;;;;;;
217801,834;166452;640;168960;793963;795355;829952;960415;795995;998912;;;;;;
217810,186;163383;752;168960;795355;795515;829952;958738;796267;998912;;;;;;
217815,127;163568;1056;168960;795515;795715;829952;959083;796771;998912;;;;;;
217818,468;163872;865;169472;795715;796067;829952;959587;796932;999424;;;;;;
217907,514;164705;4294;168448;796067;796235;829952;960772;800529;998400;;;;;;
217923,640;168134;800;168960;796235;797803;829952;964369;798603;998912;;;;;;
217934,410;163616;851;168960;797803;798347;829952;961419;799198;998912;;;;;;
218009,717;163667;672;169472;798347;798507;829952;962014;799179;999424;;;;;;
218036,604;164000;1311;168960;798507;798627;829952;962507;799938;998912;;;;;;
218076,035;164639;3636;169472;798627;799179;829952;963266;802815;999424;;;;;;
218097,931;167476;1763;169472;799179;800506;829952;966655;802269;999424;;;;;;
218180,731;165603;1982;169984;800506;800842;829952;966109;802824;999936;;;;;;
218203,661;166334;1056;169472;800842;800842;829952;967176;801898;999424;;;;;;
218258,908;165384;4084;168960;800843;800843;829952;966227;804927;998912;;;;;;
218285,188;167924;2688;169472;800843;800842;829952;968767;803530;999424;;;;;;
218313,579;166528;2960;169472;800842;800843;829952;967370;803803;999424;;;;;;
218374,294;166800;3280;169472;800843;800842;829952;967643;804122;999424;;;;;;
218385,031;167120;3264;169472;800842;800842;829952;967962;804106;999424;;;;;;
218432,241;167104;3328;169472;800842;801074;829952;967946;804402;999424;;;;;;
218461,518;143781;3344;169472;801074;801074;829952;944855;804418;999424;;;;;;
218461,538;3344;0;169472;801074;744272;829952;804418;744272;999424;188880;185341;786432;993298;929613;1785856
218510,595;163840;960;169472;744272;744272;829952;908112;745232;999424;;;;;;
218528,077;164800;1184;169472;744272;744272;829952;909072;745456;999424;;;;;;
218591,787;165024;2129;169472;744272;744273;829952;909296;746402;999424;;;;;;
218605,070;165969;1456;169984;744273;744272;829952;910242;745728;999936;;;;;;
218617,085;166320;1841;169984;744272;744273;829952;910592;746114;999936;;;;;;
218633,425;166705;2080;170496;744273;744273;829952;910978;746353;1000448;;;;;;
218656,057;167456;2338;169984;744273;744273;829952;911729;746611;999936;;;;;;
218689,650;167714;2608;170496;744273;744273;829952;911987;746881;1000448;;;;;;
218754,249;168496;2464;170496;744273;744272;829952;912769;746736;1000448;;;;;;
218768,289;168352;2977;170496;744272;744272;829952;912624;747249;1000448;;;;;;
218814,346;168865;3136;170496;744272;744272;829952;913137;747408;1000448;;;;;;
218840,083;169024;3152;170496;744272;744272;829952;913296;747424;1000448;;;;;;
218847,257;169040;3392;170496;744272;744272;829952;913312;747664;1000448;;;;;;
218856,878;169280;4063;169472;744272;744273;829952;913552;748336;999424;;;;;;
218922,440;168927;5099;169984;744273;746164;829952;913200;751263;999936;;;;;;
218956,821;169963;5102;165888;746164;746917;829952;916127;752019;995840;;;;;;
218999,143;165870;7137;167936;746917;747582;829952;912787;754719;997888;;;;;;
219009,446;167905;6885;163840;747582;747998;829952;915487;754883;993792;;;;;;
219040,593;163557;5054;165888;747998;748479;829952;911555;753533;995840;;;;;;
219044,908;161726;4799;166400;748479;749030;829952;910205;753829;996352;;;;;;
219061,514;161983;8174;165376;749030;749726;829952;911013;757900;995328;;;;;;
219076,436;165358;4784;165888;749726;750469;829952;915084;755253;995840;;;;;;
219095,391;160944;6433;165376;750469;751389;829952;911413;757822;995328;;;;;;
219156,650;162591;5343;165888;751389;752181;829952;913980;757524;995840;;;;;;
219220,780;161503;7744;165376;752181;753149;829952;913684;760893;995328;;;;;;
219241,174;163904;3167;165376;753149;754656;829952;917053;757823;995328;;;;;;
219276,029;158815;640;156672;754656;756769;829952;913471;757409;986624;;;;;;
219296,647;156288;800;164864;756769;756985;829952;913057;757785;994816;;;;;;
219379,428;155424;784;164864;756985;757225;829952;912409;758009;994816;;;;;;
219386,438;155408;1171;164864;757225;757226;829952;912633;758397;994816;;;;;;
219402,006;155795;1187;164864;757226;757609;829952;913021;758796;994816;;;;;;
219454,618;155811;1008;165376;757609;757849;829952;913420;758857;995328;;;;;;
219468,274;156656;960;165376;757849;758145;829952;914505;759105;995328;;;;;;
219519,710;156608;919;165888;758145;758394;829952;914753;759313;995840;;;;;;
219561,197;157462;1354;165888;758394;758394;829952;915856;759748;995840;;;;;;
219609,336;158026;2288;166912;758394;758393;829952;916420;760681;996864;;;;;;
219640,057;160496;1264;166400;758393;758393;829952;918889;759657;996352;;;;;;
219726,600;159472;3057;167424;758393;758394;829952;917865;761451;997376;;;;;;
219795,851;162765;2207;167424;758394;758393;829952;921159;760600;997376;;;;;;
219846,765;161951;3071;168448;758393;758393;829952;920344;761464;998400;;;;;;
219868,696;164351;3010;167936;758393;758393;829952;922744;761403;997888;;;;;;
219885,118;164290;2830;168960;758393;758394;829952;922683;761224;998912;;;;;;
219915,725;165134;4771;168448;758394;758394;829952;923528;763165;998400;;;;;;
219941,477;167075;5724;166400;758394;758394;829952;925469;764118;996352;;;;;;
219945,920;165468;5627;165376;758394;758394;829952;923862;764021;995328;;;;;;
219963,811;165185;7553;164864;758393;758722;829952;923578;766275;994816;;;;;;
219985,987;164225;5068;165888;758722;758953;829952;922947;764021;995840;;;;;;
220000,684;161740;5056;165888;758953;759194;829952;920693;764250;995840;;;;;;
220047,052;161728;5361;165888;759194;759786;829952;920922;765147;995840;;;;;;
220053,503;162033;5362;165888;759786;760297;829952;921819;765659;995840;;;;;;
220060,218;162034;4680;165888;760297;761121;829952;922331;765801;995840;;;;;;
220072,172;161352;3468;166400;761121;761745;829952;922473;765213;996352;;;;;;
220092,343;161164;3266;166400;761745;762186;829952;922909;765452;996352;;;;;;
220115,996;160962;1440;166912;762186;763655;829952;923148;765095;996864;;;;;;
220136,948;160160;2832;166912;763655;764399;829952;923815;767231;996864;;;;;;
220141,388;161552;992;166912;764399;765781;829952;925951;766773;996864;;;;;;
220160,306;159712;672;166912;765781;766125;829952;925493;766797;996864;;;;;;
220178,773;159392;3840;166912;766125;766157;829952;925517;769997;996864;;;;;;
220220,542;162560;784;166912;766157;767462;829952;928717;768246;996864;;;;;;
220236,998;159504;913;167424;767462;767654;829952;926966;768567;997376;;;;;;
220256,573;160657;3171;167424;767654;767814;829952;928311;770985;997376;;;;;;
220290,817;162915;4174;167424;767814;768600;829952;930729;772774;997376;;;;;;
220309,950;163918;3919;167424;768600;769463;829952;932518;773382;997376;;;;;;
220353,027;163663;1650;167936;769463;770871;829952;933126;772521;997888;;;;;;
220371,809;161906;1024;167424;770871;771463;829952;932777;772487;997376;;;;;;
220436,170;161280;5462;166912;771463;771751;829952;932743;777213;996864;;;;;;
220448,452;165206;2512;167424;771751;771751;829952;936957;774263;997376;;;;;;
220500,795;162256;1056;167936;771751;773301;829952;934007;774357;997888;;;;;;
220533,065;161824;1472;167936;773301;773301;829952;935125;774773;997888;;;;;;
220590,231;162240;4931;166912;773301;773302;829952;935541;778233;996864;;;;;;
220665,545;164675;3843;167424;773302;773302;829952;937977;777145;997376;;;;;;
220691,583;163587;4575;167424;773302;773302;829952;936889;777877;997376;;;;;;
220757,588;164319;4803;167424;773302;773301;829952;937621;778104;997376;;;;;;
220776,097;164547;5406;166400;773301;773302;829952;937848;778708;996352;;;;;;
220814,034;163923;5358;166912;773301;773302;829952;937224;778660;996864;;;;;;
220840,067;164078;7407;164864;773302;773302;829952;937380;780709;994816;;;;;;
220846,057;164079;5850;162816;773302;773302;829952;937381;779152;992768;;;;;;
220861,234;162522;7203;164352;773302;773909;829952;935824;781112;994304;;;;;;
220898,333;161827;7171;162304;773909;774749;829952;935736;781920;992256;;;;;;
220901,718;161795;5418;164864;774749;775462;829952;936544;780880;994816;;;;;;
220907,116;159530;4573;164352;775462;776485;829952;934992;781058;994304;;;;;;
220927,178;158685;3968;165888;776485;777052;829952;935170;781020;995840;;;;;;
220946,301;160128;4980;165376;777052;777844;829952;937180;782824;995328;;;;;;
220967,072;161140;4883;166400;777844;778629;829952;938984;783512;996352;;;;;;
220977,214;162067;5541;165888;778629;779293;829952;940696;784834;995840;;;;;;
220989,482;162725;3768;166400;779293;780332;829952;942018;784100;996352;;;;;;
220997,498;161464;2125;166400;780332;782236;829952;941796;784361;996352;;;;;;
221003,677;159612;2765;166400;782236;783340;829952;941848;786105;996352;;;;;;
221046,597;160461;3683;166400;783340;784444;829952;943801;788127;996352;;;;;;
221064,593;161379;3364;166912;784444;785283;829952;945823;788647;996864;;;;;;
221086,431;162084;928;166912;785283;786643;829952;947367;787571;996864;;;;;;
221099,782;159648;1024;166912;786643;786932;829952;946291;787956;996864;;;;;;
221108,533;159744;864;166912;786932;787091;829952;946676;787955;996864;;;;;;
221117,891;159584;1729;166912;787091;787435;829952;946675;789164;996864;;;;;;
221313,294;160449;1392;166912;787435;787635;829952;947884;789027;996864;;;;;;
221372,130;160112;1123;167424;787635;788315;829952;947747;789438;997376;;;;;;
221426,065;160867;768;167424;788315;788491;829952;949182;789259;997376;;;;;;
221463,839;160512;2773;167936;788491;788491;829952;949003;791264;997888;;;;;;
221472,360;163029;1538;167424;788491;788491;829952;951520;790029;997376;;;;;;
221517,435;161794;4004;167936;788491;788739;829952;950285;792743;997888;;;;;;
221536,491;164772;2416;167936;788739;789003;829952;953511;791419;997888;;;;;;
221549,828;163184;2642;168960;789003;789275;829952;952187;791917;998912;;;;;;
221588,342;164946;1554;168448;789275;790595;829952;954221;792149;998400;;;;;;
221614,824;163858;896;168960;790595;790907;829952;954453;791803;998912;;;;;;
221631,367;163712;3395;168960;790907;791068;829952;954619;794463;998912;;;;;;
221667,955;166211;4299;167936;791068;791228;829952;957279;795527;997888;;;;;;
221692,879;166091;4387;168448;791228;791364;829952;957319;795751;998400;;;;;;
221723,852;166179;3407;168448;791364;791363;829952;957543;794770;998400;;;;;;
221737,544;165199;5635;167936;791363;791364;829952;956562;796999;997888;;;;;;
221765,177;167427;4048;167936;791364;791947;829952;958791;795995;997888;;;;;;
221787,680;164816;6193;167424;791947;792147;829952;956763;798340;997376;;;;;;
221793,298;166961;3298;167424;792147;792923;829952;959108;796221;997376;;;;;;
221839,993;163042;2336;167424;792923;793682;829952;955965;796018;997376;;;;;;
221849,614;162080;1248;167936;793682;795242;829952;955762;796490;997888;;;;;;
221861,299;162016;3748;167936;795242;795531;829952;957258;799279;997888;;;;;;
221900,427;164516;736;167936;795531;797082;829952;960047;797818;997888;;;;;;
221922,880;161504;3904;167936;797082;797563;829952;958586;801467;997888;;;;;;
221946,401;164672;976;167936;797563;798898;829952;962235;799874;997888;;;;;;
221988,874;161744;736;167936;798898;799314;829952;960642;800050;997888;;;;;;
222029,532;161504;4222;167936;799314;799675;829952;960818;803897;997888;;;;;;
222059,756;164990;2737;167936;799675;799674;829952;964665;802411;997888;;;;;;
222064,944;12218;2623;168448;799675;799674;829952;811893;802297;998400;;;;;;
222064,962;2623;0;168448;799674;750382;829952;802297;750382;998400;186387;185382;786432;988684;935764;1784832
222094,798;161792;1744;168448;750382;750382;829952;912174;752126;998400;;;;;;
222124,514;163536;2880;168960;750382;750382;829952;913918;753262;998912;;;;;;
222158,099;165696;2656;168960;750382;750383;829952;916078;753039;998912;;;;;;
222192,568;165472;3019;169472;750383;750382;829952;915855;753401;999424;;;;;;
222221,949;166859;5603;169472;750382;751111;829952;917241;756714;999424;;;;;;
222234,783;169443;5517;166400;752247;752247;829952;921690;757764;996352;;;;;;
222257,765;166285;7150;163328;752265;755573;829952;918550;762723;993280;;;;;;
222279,334;163310;7675;160768;755573;758025;829952;918883;765700;990720;;;;;;
222290,921;160763;6137;159232;758025;758657;829952;918788;764794;989184;;;;;;
222346,885;159225;6756;163840;758657;759681;829952;917882;766437;993792;;;;;;
222402,377;159332;3172;163840;759681;761664;829952;919013;764836;993792;;;;;;
222431,705;155748;4323;164864;761664;762016;829952;917412;766339;994816;;;;;;
222492,094;158435;4883;164352;762016;762016;829952;920451;766899;994304;;;;;;
222507,932;158995;5936;165376;762016;762016;829952;921011;767952;995328;;;;;;
222516,454;161516;6133;165376;762016;762672;829952;923532;768805;995328;;;;;;
222527,263;161781;3920;165376;762672;763400;829952;924453;767320;995328;;;;;;
222550,795;159568;3135;165376;763400;764192;829952;922968;767327;995328;;;;;;
222567,955;158783;1683;165376;764192;766256;829952;922975;767939;995328;;;;;;
222636,910;157331;3366;165376;766256;766927;829952;923587;770293;995328;;;;;;
222707,764;159014;3620;166400;766927;767424;829952;925941;771044;996352;;;;;;
222721,616;160804;2464;165888;767424;767423;829952;928228;769887;995840;;;;;;
222787,291;159648;4143;166912;767423;768096;829952;927071;772239;996864;;;;;;
222843,062;162351;5256;166400;768096;768095;829952;930447;773351;996352;;;;;;
222854,071;163464;6099;165888;768095;768096;829952;931559;774195;995840;;;;;;
222866,105;163795;4513;166400;768096;768431;829952;931891;772944;996352;;;;;;
222874,043;162209;5923;165888;768431;769648;829952;930640;775571;995840;;;;;;
222884,297;163619;4019;166400;769648;770448;829952;933267;774467;996352;;;;;;
222901,160;161715;2928;166912;770448;772215;829952;932163;775143;996864;;;;;;
222923,039;161648;816;166912;772215;773551;829952;933863;774367;996864;;;;;;
222959,073;159536;800;165888;773551;773807;829952;933087;774607;995840;;;;;;
222977,003;158496;3568;166400;773807;774200;829952;932303;777768;996352;;;;;;
223019,063;161264;1587;166912;774200;775440;829952;935464;777027;996864;;;;;;
223039,853;160307;4255;166912;775440;775967;829952;935747;780222;996864;;;;;;
223055,449;162952;1349;167424;775967;777456;829952;938919;778805;997376;;;;;;
223063,990;161093;1856;167424;777456;777895;829952;938549;779751;997376;;;;;;
223135,611;161600;3702;167424;777895;778159;829952;939495;781861;997376;;;;;;
223156,655;163446;5264;167424;778159;778611;829952;941605;783875;997376;;;;;;
223167,902;165008;800;167424;778611;780179;829952;943619;780979;997376;;;;;;
223191,132;160544;7256;167424;780179;780539;829952;940723;787795;997376;;;;;;
223211,142;167000;3161;165376;780539;781723;829952;947539;784884;995328;;;;;;
223239,390;160857;992;166400;781723;783155;829952;942580;784147;996352;;;;;;
223363,032;158688;976;166912;783155;783803;829952;941843;784779;996864;;;;;;
223573,706;159696;3245;166912;783803;784171;829952;943499;787416;996864;;;;;;
223582,229;18742;7282;164352;784171;784171;829952;802913;791453;994304;;;;;;
223582,248;7282;0;164352;784171;762373;829952;791453;762373;994304;185588;185417;786432;977041;947790;1780736
223701,575;156672;5787;165888;762373;762373;829952;919045;768160;995840;;;;;;
223733,157;162459;4913;165888;762373;762374;829952;924832;767287;995840;;;;;;
223790,635;161585;6007;162816;762374;762373;829952;923959;768380;992768;;;;;;
223965,982;162679;3839;165888;762373;762373;829952;925052;766212;995840;;;;;;
224009,755;159999;5176;165376;762373;762373;829952;922372;767549;995328;;;;;;
224039,534;161336;3922;166400;762373;762374;829952;923709;766296;996352;;;;;;
224071,959;161106;3858;165888;762374;762373;829952;923480;766231;995840;;;;;;
224111,662;161042;6022;165888;762373;762374;829952;923415;768396;995840;;;;;;
224126,141;163718;5846;166400;762374;762374;829952;926092;768220;996352;;;;;;
224151,461;163542;7621;164352;762374;762373;829952;925916;769994;994304;;;;;;
224171,408;163269;6306;165376;762373;762373;829952;925642;768679;995328;;;;;;
224185,357;161954;5874;165376;762373;762373;829952;924327;768247;995328;;;;;;
224217,299;161522;5375;165376;762373;763808;829952;923895;769183;995328;;;;;;
224233,218;161023;4447;166400;763808;764584;829952;924831;769031;996352;;;;;;
224252,969;161631;4287;165888;764584;764856;829952;926215;769143;995840;;;;;;
224277,582;161471;3921;166400;764856;765592;829952;926327;769513;996352;;;;;;
224291,213;161617;3892;166400;765592;765847;829952;927209;769739;996352;;;;;;
224319,546;161588;3330;166912;765847;767335;829952;927435;770665;996864;;;;;;
224330,800;162050;2351;166912;767335;767615;829952;929385;769966;996864;;;;;;
224341,386;161071;3266;166912;767615;768063;829952;928686;771329;996864;;;;;;
224350,018;161155;3586;166912;768063;768439;829952;929218;772025;996864;;;;;;
224361,766;162306;2818;167424;768439;768998;829952;930745;771816;997376;;;;;;
224383,153;162562;4670;167424;768998;769503;829952;931560;774173;997376;;;;;;
224405,730;164414;2048;167424;769503;770134;829952;933917;772182;997376;;;;;;
224419,176;161790;1922;167424;770134;771503;829952;931924;773425;997376;;;;;;
224427,841;161666;3748;167936;771503;771711;829952;933169;775459;997888;;;;;;
224446,262;164004;4350;167424;771711;772175;829952;935715;776525;997376;;;;;;
224456,689;164606;899;167936;772175;774014;829952;936781;774913;997888;;;;;;
224483,144;161667;816;161792;774014;774221;829952;935681;775037;991744;;;;;;
224509,732;161584;608;167424;774221;774429;829952;935805;775037;997376;;;;;;
224601,452;160352;4223;167424;774429;774694;829952;934781;778917;997376;;;;;;
224704,965;163967;1264;167424;774694;776085;829952;938661;777349;997376;;;;;;
224738,564;161008;1056;167424;776085;776085;829952;937093;777141;997376;;;;;;
224784,360;160800;1967;167936;776085;776086;829952;936885;778053;997888;;;;;;
224807,706;162735;5149;166400;776086;776086;829952;938821;781235;996352;;;;;;
224816,528;165913;5914;166400;776086;776637;829952;941999;782551;996352;;;;;;
224829,562;164634;2528;166912;776637;777269;829952;941271;779797;996864;;;;;;
224834,348;161248;1056;167424;777269;779149;829952;938517;780205;997376;;;;;;
224844,209;160800;983;167424;779149;779566;829952;939949;780549;997376;;;;;;
224868,415;160727;1041;167424;779566;779781;829952;940293;780822;997376;;;;;;
224900,493;160785;1877;167424;779781;780142;829952;940566;782019;997376;;;;;;
224938,561;161621;1426;168448;780142;780229;829952;941763;781655;998400;;;;;;
224966,318;162706;576;167936;780229;780421;829952;942935;780997;997888;;;;;;
224996,102;161856;2488;168448;780421;780582;829952;942277;783070;998400;;;;;;
225038,441;164280;2273;168448;780582;780694;829952;944862;782967;998400;;;;;;
225070,537;164065;768;168960;780694;780869;829952;944759;781637;998912;;;;;;
225091,471;163584;6136;168960;780869;781482;829952;944453;787618;998912;;;;;;
225109,605;168952;1485;166912;781482;783585;829952;950434;785070;996864;;;;;;
225125,777;162253;1232;167936;783585;784074;829952;945838;785306;997888;;;;;;
225150,453;162000;2932;168448;784074;784455;829952;946074;787387;998400;;;;;;
225172,911;164724;2669;168448;784455;784959;829952;949179;787628;998400;;;;;;
225196,157;164461;1249;168960;784959;786367;829952;949420;787616;998912;;;;;;
225226,877;164065;1375;168960;786367;786575;829952;950432;787950;998912;;;;;;
225275,016;164191;1534;169472;786575;786575;829952;950766;788109;999424;;;;;;
225311,344;164862;1470;168960;786575;786575;829952;951437;788045;998912;;;;;;
225319,706;164798;1582;169984;786575;786575;829952;951373;788157;999936;;;;;;
225339,845;165934;4142;169472;786575;787063;829952;952509;791205;999424;;;;;;
225374,741;168494;5459;167424;787063;787151;829952;955557;792610;997376;;;;;;
225387,233;167251;4415;166400;787151;787198;829952;954402;791613;996352;;;;;;
225410,492;166207;3459;168448;787198;787877;829952;953405;791336;998400;;;;;;
225425,034;164739;5167;167936;787877;788902;829952;952616;794069;997888;;;;;;
225444,881;166447;1408;167936;788902;790814;829952;955349;792222;997888;;;;;;
225487,633;162176;4708;165888;790814;791294;829952;952990;796002;995840;;;;;;
225511,238;165476;4263;167424;791294;791869;829952;956770;796132;997376;;;;;;
225523,904;163867;3052;167424;791869;793489;829952;955736;796541;997376;;;;;;
225555,815;162796;3988;167936;793489;793929;829952;956285;797917;997888;;;;;;
225570,576;164756;1024;167936;793929;795369;829952;958685;796393;997888;;;;;;
225576,336;161792;1104;167936;795369;795849;829952;957161;796953;997888;;;;;;
225596,295;161872;3855;167936;795849;796322;829952;957721;800177;997888;;;;;;
225610,760;164623;2080;168448;796322;796961;829952;960945;799041;998400;;;;;;
225630,098;163360;5872;167424;796961;798264;829952;960321;804136;997376;;;;;;
225666,175;167152;2754;167936;798264;798934;829952;965416;801688;997888;;;;;;
225695,756;163010;3605;167424;798934;799062;829952;961944;802667;997376;;;;;;
225734,986;163861;1592;168448;799062;800542;829952;962923;802134;998400;;;;;;
225767,074;162872;544;167936;800542;800686;829952;963414;801230;997888;;;;;;
225804,139;161824;880;168448;800686;800686;829952;962510;801566;998400;;;;;;
225821,440;162160;1472;167936;800686;800686;829952;962846;802158;997888;;;;;;
225878,638;162752;896;168448;800686;800686;829952;963438;801582;998400;;;;;;
225898,363;162688;4599;166400;800686;800686;829952;963374;805285;996352;;;;;;
225935,433;166391;3778;167936;800686;800686;829952;967077;804464;997888;;;;;;
225947,367;164546;2962;167936;800686;800686;829952;965232;803648;997888;;;;;;
225962,439;163730;2992;168448;800686;800846;829952;964416;803838;998400;;;;;;
226013,637;164784;5932;167936;800846;800950;829952;965630;806882;997888;;;;;;
226033,325;167724;5347;166912;800950;800950;829952;968674;806297;996864;;;;;;
226043,810;165091;5123;165376;800950;801054;829952;966041;806177;995328;;;;;;
226053,663;164867;4368;167424;801054;801502;829952;965921;805870;997376;;;;;;
226060,989;163600;6179;165888;801502;801887;829952;965102;808066;995840;;;;;;
226070,307;165411;5999;166400;801887;802893;829952;967298;808892;996352;;;;;;
226081,993;163695;3728;166400;802893;803686;829952;966588;807414;996352;;;;;;
226089,167;161424;3357;166912;803686;804525;829952;965110;807882;996864;;;;;;
226108,145;162077;1440;166912;804525;806133;829952;966602;807573;996864;;;;;;
226127,181;160160;5939;165888;806133;807205;829952;966293;813144;995840;;;;;;
226135,838;163635;1141;166400;807205;809029;829952;970840;810170;996352;;;;;;
226149,106;158837;4189;166912;809029;809485;829952;967866;813674;996864;;;;;;
226168,337;162397;2652;166400;809485;810255;829952;971882;812907;996352;;;;;;
226200,098;160860;864;166912;810255;811503;829952;971115;812367;996864;;;;;;
226328,573;159584;896;166912;811503;811847;829952;971087;812743;996864;;;;;;
226356,109;159616;864;166912;811847;812144;829952;971463;813008;996864;;;;;;
226436,451;159584;1026;166912;812144;812375;829952;971728;813401;996864;;;;;;
226508,796;159746;1298;167424;812375;812375;829952;972121;813673;997376;;;;;;
226551,249;161042;4341;167424;812375;812375;829952;973417;816716;997376;;;;;;
226684,148;164085;4643;166400;812375;812376;829952;976460;817019;996352;;;;;;
226742,654;163363;3455;166912;812376;812375;829952;975739;815830;996864;;;;;;
226759,504;162175;7660;164352;812375;813216;829952;974550;820876;994304;;;;;;
226796,673;164332;6693;163840;813216;813535;829952;977548;820228;993792;;;;;;
226830,214;163365;6819;164352;813535;813535;829952;976900;820354;994304;;;;;;
226850,323;161443;6078;160768;813535;813536;829952;974978;819614;990720;;;;;;
226870,125;160702;6222;164352;813536;813536;829952;974238;819758;994304;;;;;;
226906,436;159822;8936;162816;813536;814088;829952;973358;823024;992768;;;;;;
226938,781;162536;5215;163840;814088;814879;829952;976624;820094;993792;;;;;;
226943,461;157081;8365;163328;814879;814879;829952;971960;823244;993280;;;;;;
226973,357;160429;7058;163328;814879;816015;829952;975308;823073;993280;;;;;;
226982,455;158610;4320;163328;816015;817055;829952;974625;821375;993280;;;;;;
227008,772;155872;5251;164352;817055;817743;829952;972927;822994;994304;;;;;;
227021,757;158304;4209;163840;817743;818599;829952;976047;822808;993792;;;;;;
227057,970;157297;5113;164864;818599;819263;829952;975896;824376;994816;;;;;;
227084,702;159225;4051;164352;819263;820118;829952;978488;824169;994304;;;;;;
227151,876;158163;6104;165376;820118;821038;829952;978281;827142;995328;;;;;;
227176,774;161752;2368;165376;821038;821389;829952;982790;823757;995328;;;;;;
227184,382;114745;1056;165376;821389;822797;829952;936134;823853;995328;;;;;;
227184,398;1056;0;165376;822797;762256;829952;823853;762256;995328;185649;185478;786432;1009502;947734;1781760
227222,607;155648;4351;165376;762256;762257;829952;917904;766608;995328;;;;;;
227239,754;159999;2823;165888;762257;762256;829952;922256;765079;995840;;;;;;
227269,937;158983;1440;165376;762256;763656;829952;921239;765096;995328;;;;;;
227369,253;157600;1456;165888;763656;764096;829952;921256;765552;995840;;;;;;
227422,507;158128;1552;165888;764096;764096;829952;922224;765648;995840;;;;;;
227528,290;158224;7693;163840;764096;764096;829952;922320;771789;993792;;;;;;
227543,631;162317;3297;164864;764096;764096;829952;926413;767393;994816;;;;;;
227637,862;157921;3352;165888;764096;764096;829952;922017;767448;995840;;;;;;
227769,653;159512;5606;165376;764096;764096;829952;923608;769702;995328;;;;;;
227798,073;161766;4428;165888;764096;764095;829952;925862;768523;995840;;;;;;
227907,485;161100;4801;165888;764095;764096;829952;925195;768897;995840;;;;;;
227933,890;161473;7107;165376;764096;764096;829952;925569;771203;995328;;;;;;
227942,425;163779;5924;162816;764096;764096;829952;927875;770020;992768;;;;;;
228013,504;162596;5582;165888;764096;764624;829952;926692;770206;995840;;;;;;
228105,574;161742;7230;165376;764624;764952;829952;926366;772182;995328;;;;;;
228123,572;163390;9698;162304;764952;765100;829952;928342;774798;992256;;;;;;
228156,338;162274;5934;163840;765100;765886;829952;927374;771820;993792;;;;;;
228238,562;158510;6398;164352;765886;766262;829952;924396;772660;994304;;;;;;
228503,577;159998;7490;164352;766262;766262;829952;926260;773752;994304;;;;;;
228518,557;161090;9539;162304;766262;766261;829952;927352;775800;992256;;;;;;
228547,481;161091;9082;160768;766261;766670;829952;927352;775752;990720;;;;;;
228560,696;160634;8819;161792;766670;766877;829952;927304;775696;991744;;;;;;
228568,071;158323;6879;162304;766877;767821;829952;925200;774700;992256;;;;;;
228591,994;156383;9864;161792;767821;768517;829952;924204;778381;991744;;;;;;
228613,404;159368;5936;162304;768517;769837;829952;927885;775773;992256;;;;;;
228631,583;155440;5763;162816;769837;770643;829952;925277;776406;992768;;;;;;
228651,089;156291;7536;162816;770643;771427;829952;926934;778963;992768;;;;;;
228671,516;158064;5476;163328;771427;772274;829952;929491;777750;993280;;;;;;
228768,309;157028;3552;163328;772274;773553;829952;929302;777105;993280;;;;;;
228783,286;155053;6446;163840;773553;773833;829952;928606;780279;993792;;;;;;
228792,159;158510;7499;163328;773833;774770;829952;932343;782269;993280;;;;;;
228816,100;159563;4983;164352;774770;775714;829952;934333;780697;994304;;;;;;
228906,925;158071;4682;163840;775714;777081;829952;933785;781763;993792;;;;;;
228916,116;157770;4180;164352;777081;778272;829952;934851;782452;994304;;;;;;
228943,909;157780;2532;164352;778272;778688;829952;936052;781220;994304;;;;;;
228954,968;156132;6112;164352;778688;779328;829952;934820;785440;994304;;;;;;
228976,421;159712;2977;164352;779328;780264;829952;939040;783241;994304;;;;;;
228988,774;156577;880;164352;780264;781588;829952;936841;782468;994304;;;;;;
228997,971;154480;992;164352;781588;781964;829952;936068;782956;994304;;;;;;
229003,441;154592;1184;164352;781964;782324;829952;936556;783508;994304;;;;;;
229026,079;154784;4694;164352;782324;782564;829952;937108;787258;994304;;;;;;
229043,700;158294;1280;164864;782564;784003;829952;940858;785283;994816;;;;;;
229069,805;155904;3581;164864;784003;784347;829952;939907;787928;994816;;;;;;
229098,899;158205;4768;165376;784347;785046;829952;942552;789814;995328;;;;;;
229114,891;160416;1777;165376;785046;786318;829952;945462;788095;995328;;;;;;
229118,456;157425;1024;165888;786318;786686;829952;943743;787710;995840;;;;;;
229125,077;157696;4328;165888;786686;786878;829952;944382;791206;995840;;;;;;
229156,984;160928;1024;165888;786878;788134;829952;947806;789158;995840;;;;;;
229209,525;157696;800;165888;788134;788454;829952;945830;789254;995840;;;;;;
229224,993;157472;5580;165376;788454;788702;829952;945926;794282;995328;;;;;;
229234,747;162252;2432;165888;788702;789486;829952;950954;791918;995840;;;;;;
229286,806;159104;1333;166400;789486;790742;829952;948590;792075;996352;;;;;;
229319,750;159029;4189;166400;790742;791058;829952;949771;795247;996352;;;;;;
229372,385;161885;4443;166400;791058;791627;829952;952943;796070;996352;;;;;;
229392,788;162139;5620;166400;791627;792451;829952;953766;798071;996352;;;;;;
229409,382;163316;896;166400;792451;794106;829952;955767;795002;996352;;;;;;
229414,511;158592;896;166400;794106;794275;829952;952698;795171;996352;;;;;;
229420,301;158592;640;166400;794275;794515;829952;952867;795155;996352;;;;;;
229453,255;158336;720;166400;794515;794530;829952;952851;795250;996352;;;;;;
229595,755;158416;3876;166912;794530;794587;829952;952946;798463;996864;;;;;;
229624,100;162596;2369;166912;794911;796455;829952;957507;798824;996864;;;;;;
229639,598;161089;5105;166400;796460;797030;829952;957549;802135;996352;;;;;;
229650,120;163825;1280;166912;797030;798470;829952;960855;799750;996864;;;;;;
229664,146;160000;1024;167424;798470;799158;829952;958470;800182;997376;;;;;;
229682,175;160256;928;166912;799158;799406;829952;959414;800334;996864;;;;;;
229721,183;160160;2003;167936;799406;799662;829952;959566;801665;997888;;;;;;
229730,140;162259;1219;167424;799662;800125;829952;961921;801344;997376;;;;;;
229809,004;161475;816;168448;800125;800397;829952;961600;801213;998400;;;;;;
229862,389;162608;4078;165888;800397;800582;829952;963005;804660;995840;;;;;;
229960,351;165870;5240;166912;800582;802157;829952;966452;807397;996864;;;;;;
230051,411;164872;4980;164864;802157;802157;829952;967029;807137;994816;;;;;;
230199,212;164724;2957;167424;802157;802157;829952;966881;805114;997376;;;;;;
230229,484;162189;6521;165888;802157;802157;829952;964346;808678;995840;;;;;;
230262,365;165753;3681;166912;802157;802157;829952;967910;805838;996864;;;;;;
230294,151;161889;7364;165888;802157;802157;829952;964046;809521;995840;;;;;;
230312,717;165572;4672;165888;802157;802157;829952;967729;806829;995840;;;;;;
230328,146;161261;7302;164352;802158;802157;829952;963419;809459;994304;;;;;;
230350,413;163974;4911;165376;802157;802589;829952;966131;807500;995328;;;;;;
230385,013;160559;7316;163328;802589;803061;829952;963148;810377;993280;;;;;;
230408,805;162964;7333;163840;803061;803262;829952;966025;810595;993792;;;;;;
230428,452;160933;5089;164352;803262;804021;829952;964195;809110;994304;;;;;;
230577,296;158689;7932;163840;804021;804285;829952;962710;812217;993792;;;;;;
230786,382;161532;6384;164352;804285;804285;829952;965817;810669;994304;;;;;;
230786,959;29076;5566;164864;804285;804285;829952;833361;809851;994816;;;;;;
230786,976;5566;0;164864;804285;764559;829952;809851;764559;994816;185868;185438;786432;995719;949997;1781248
230901,043;154112;995;164352;764559;764560;829952;918671;765555;994304;;;;;;
231190,785;155107;5237;164864;764560;764560;829952;919667;769797;994816;;;;;;
231232,371;159349;5063;164352;764560;764560;829952;923909;769623;994304;;;;;;
231252,459;159175;8741;163328;764560;764560;829952;923735;773301;993280;;;;;;
231271,269;162341;6819;164352;764560;764560;829952;926901;771379;994304;;;;;;
231278,682;160419;6149;164352;764560;764560;829952;924979;770709;994304;;;;;;
231285,157;159749;8280;162304;764560;764559;829952;924309;772839;992256;;;;;;
231333,091;161880;8388;162816;764559;764560;829952;926439;772948;992768;;;;;;
231352,180;159940;6719;163328;764560;764560;829952;924500;771279;993280;;;;;;
231386,509;158271;9531;162816;764560;764560;829952;922831;774091;992768;;;;;;
231409,411;161032;9827;161792;764559;764855;829952;925591;774682;991744;;;;;;
231428,826;161379;8137;162304;764855;766175;829952;926234;774312;992256;;;;;;
231485,008;157641;8893;162304;766175;767583;829952;923816;776476;992256;;;;;;
231513,262;158397;7984;162304;767583;768592;829952;925980;776576;992256;;;;;;
231583,352;157488;8987;162304;768592;769503;829952;926080;778490;992256;;;;;;
231622,429;158491;9467;162304;769503;769919;829952;927994;779386;992256;;;;;;
231631,972;158971;7591;162304;769919;770407;829952;928890;777998;992256;;;;;;
231641,276;157095;4869;162816;770407;771895;829952;927502;776764;992768;;;;;;
231668,220;155397;7413;162816;771895;773689;829952;927292;781102;992768;;;;;;
231680,401;157941;6492;163328;773689;774448;829952;931630;780940;993280;;;;;;
231692,310;157532;4582;162816;774448;775672;829952;931980;780254;992768;;;;;;
231699,732;155622;2284;162304;775672;777208;829952;931294;779492;992256;;;;;;
231706,609;152812;1219;162816;777208;778440;829952;930020;779659;992768;;;;;;
231716,701;151747;736;161792;778440;778991;829952;930187;779727;991744;;;;;;
231728,284;150240;1058;162304;778991;779192;829952;929231;780250;992256;;;;;;
231738,429;150562;4149;162816;779192;779568;829952;929754;783717;992768;;;;;;
231757,923;154165;4643;162304;779568;780505;829952;933733;785148;992256;;;;;;
231790,931;154659;2915;163840;780505;782064;829952;935164;784979;993792;;;;;;
231802,779;154979;3308;163328;782064;783884;829952;937043;787192;993280;;;;;;
231815,622;155372;3809;164864;783884;784444;829952;939256;788253;994816;;;;;;
231824,667;157921;2991;164352;784444;785132;829952;942365;788123;994304;;;;;;
231842,102;157103;4854;165376;785132;785956;829952;942235;790810;995328;;;;;;
231853,586;159990;4038;164864;785956;786515;829952;945946;790553;994816;;;;;;
231872,472;159174;2833;165888;786515;787107;829952;945689;789940;995840;;;;;;
231886,304;159505;3520;165888;787107;787931;829952;946612;791451;995840;;;;;;
231889,792;160192;2193;166400;787931;790436;829952;948123;792629;996352;;;;;;
231896,641;159889;1024;166400;790436;791755;829952;950325;792779;996352;;;;;;
231916,807;158720;3919;166912;791755;792172;829952;950475;796091;996864;;;;;;
231932,132;162127;1045;166400;792172;793715;829952;954299;794760;996352;;;;;;
231944,088;159253;6105;165888;793715;794033;829952;952968;800138;995840;;;;;;
231952,813;163801;4034;166400;794033;795601;829952;957834;799635;996352;;;;;;
231965,809;161730;4053;166912;795601;796939;829952;957331;800992;996864;;;;;;
231993,691;162261;3767;166400;796939;798532;829952;959200;802299;996352;;;;;;
231999,364;161975;672;167424;798532;801397;829952;960507;802069;997376;;;;;;
232031,339;160416;3348;167424;801397;801677;829952;961813;805025;997376;;;;;;
232042,373;163092;1856;167936;801677;803261;829952;964769;805117;997888;;;;;;
232053,773;162112;3231;167424;803261;803421;829952;965373;806652;997376;;;;;;
232105,384;163487;4738;167936;803421;803805;829952;966908;808543;997888;;;;;;
232118,446;165506;6563;167424;803805;804573;829952;969311;811136;997376;;;;;;
232137,702;167331;960;166400;804573;806612;829952;971904;807572;996352;;;;;;
232171,704;159680;6158;165376;806612;807132;829952;966292;813290;995328;;;;;;
232204,919;164878;4744;166400;807132;807909;829952;972010;812653;996352;;;;;;
232232,399;162440;2736;166400;807909;809008;829952;970349;811744;996352;;;;;;
232246,815;160432;4175;166912;809008;809488;829952;969440;813663;996864;;;;;;
232282,483;162895;4341;166912;809488;810072;829952;972383;814413;996864;;;;;;
232316,476;163061;5696;166400;810072;810576;829952;973133;816272;996352;;;;;;
232323,941;164416;3776;166912;810576;812343;829952;974992;816119;996864;;;;;;
232350,331;162496;2308;167424;812343;814148;829952;974839;816456;997376;;;;;;
232363,878;162005;2892;167424;814148;814436;829952;976153;817328;997376;;;;;;
232389,327;162636;1996;167424;814436;815740;829952;977072;817736;997376;;;;;;
232404,599;161740;1885;167424;815740;816284;829952;977480;818169;997376;;;;;;
232421,611;161629;3871;167936;816284;816871;829952;977913;820742;997888;;;;;;
232432,624;164639;4319;167936;816871;817655;829952;981510;821974;997888;;;;;;
232444,633;165087;3732;168448;817655;818422;829952;982742;822154;998400;;;;;;
232471,990;165012;5688;167936;818422;819262;829952;983434;824950;997888;;;;;;
232485,157;166968;1411;166912;819262;820686;829952;986230;822097;996864;;;;;;
232506,627;161155;4020;167424;820686;821198;829952;981841;825218;997376;;;;;;
232524,931;163764;3028;167936;821198;821974;829952;984962;825002;997888;;;;;;
232554,382;163796;1152;167936;821974;823390;829952;985770;824542;997888;;;;;;
232563,558;161920;3765;167936;823390;823982;829952;985310;827747;997888;;;;;;
232575,656;164533;3390;167936;823982;825471;829952;988515;828861;997888;;;;;;
232588,465;164158;3924;168448;825471;825862;829952;989629;829786;998400;;;;;;
232605,913;165716;2480;168448;825862;826190;829952;991578;828670;998400;;;;;;
232614,532;164272;1001;167936;826190;827743;829952;990462;828744;997888;;;;;;
232614,553;1001;0;167936;827743;782125;876544;828744;782125;1044480;186207;185537;786432;1014951;967662;1830912
232676,423;161792;6279;168448;782125;782125;876544;943917;788404;1044992;;;;;;
232760,927;168071;2320;167424;782125;783464;876544;950196;785784;1043968;;;;;;
232825,281;163088;944;167936;783464;784640;876544;946552;785584;1044480;;;;;;
232846,716;161712;1216;167936;784640;784640;876544;946352;785856;1044480;;;;;;
233009,301;161984;6514;167424;784640;784640;876544;946624;791154;1043968;;;;;;
233137,820;167282;4916;166400;784640;784640;876544;951922;789556;1042944;;;;;;
233146,228;163636;5855;164864;784640;784640;876544;948276;790495;1041408;;;;;;
233290,367;164575;5251;166400;784640;785336;876544;949215;790587;1042944;;;;;;
233309,205;162947;5923;163840;785336;785336;876544;948283;791259;1040384;;;;;;
233318,263;163614;4252;166400;785336;786064;876544;948950;790316;1042944;;;;;;
233354,082;161436;3743;165888;786064;787184;876544;947500;790927;1042432;;;;;;
233375,156;160927;4739;166912;787184;787712;876544;948111;792451;1043456;;;;;;
233419,954;163459;4899;166912;787712;788400;876544;951171;793299;1043456;;;;;;
233471,477;163619;3651;167424;788400;788712;876544;952019;792363;1043968;;;;;;
233563,536;162883;4995;166912;788712;788712;876544;951595;793707;1043456;;;;;;
233592,090;164227;7649;164352;788712;790182;876544;952939;797831;1040896;;;;;;
233614,537;164321;6632;163328;790182;790990;876544;954503;797622;1039872;;;;;;
233667,521;163304;7007;165376;790990;790990;876544;954294;797997;1041920;;;;;;
233719,761;162655;7265;163328;790990;790990;876544;953645;798255;1039872;;;;;;
233750,038;162913;9628;162816;790990;790990;876544;953903;800618;1039360;;;;;;
233763,440;162204;8486;161280;790990;790990;876544;953194;799476;1037824;;;;;;
233769,708;161062;6159;163840;790990;791950;876544;952052;798109;1040384;;;;;;
233781,536;158223;5183;163328;791950;793254;876544;950173;798437;1039872;;;;;;
233828,724;157247;4241;164352;793254;794718;876544;950501;798959;1040896;;;;;;
233916,200;157841;3376;164352;794718;795829;876544;952559;799205;1040896;;;;;;
233962,611;156976;4900;164864;795829;796525;876544;952805;801425;1041408;;;;;;
233987,016;159012;5043;164352;796525;796822;876544;955537;801865;1040896;;;;;;
233997,318;159155;4095;165376;796822;797175;876544;955977;801270;1041920;;;;;;
234068,506;159743;3184;165376;797175;797935;876544;956918;801119;1041920;;;;;;
234091,402;158832;6051;165376;797935;798351;876544;956767;804402;1041920;;;;;;
234099,807;161699;3609;165376;798351;798583;876544;960050;802192;1041920;;;;;;
234105,813;159257;3542;165888;798583;799582;876544;957840;803124;1042432;;;;;;
234110,791;160214;4121;165888;799582;800336;876544;959796;804457;1042432;;;;;;
234115,826;160793;4892;166400;800336;801009;876544;961129;805901;1042944;;;;;;
234123,592;162076;1488;165888;801009;802664;876544;963085;804152;1042432;;;;;;
234133,264;158625;4269;166400;802664;803153;876544;961289;807422;1042944;;;;;;
234139,232;161965;1352;166400;803153;805233;876544;965118;806585;1042944;;;;;;
234144,737;159048;2624;166400;805233;805641;876544;964281;808265;1042944;;;;;;
234172,452;160320;4269;166400;805641;808169;876544;965961;812438;1042944;;;;;;
234187,364;161965;4352;167424;808169;809425;876544;970134;813777;1043968;;;;;;
234189,726;163584;2488;166912;809425;810954;876544;973009;813442;1043456;;;;;;
234200,227;161720;3459;167424;810954;812478;876544;972674;815937;1043968;;;;;;
234206,917;163203;3620;167424;812478;813157;876544;975681;816777;1043968;;;;;;
234211,494;163364;4297;167936;813157;813821;876544;976521;818118;1044480;;;;;;
234238,978;165065;5152;167936;813821;814582;876544;978886;819734;1044480;;;;;;
234284,565;165920;4132;167936;814582;815573;876544;980502;819705;1044480;;;;;;
234307,147;164900;2965;167936;815573;817456;876544;980473;820421;1044480;;;;;;
234323,281;163733;1830;167424;817456;818177;876544;981189;820007;1043968;;;;;;
234348,621;162598;3051;167936;818177;818489;876544;980775;821540;1044480;;;;;;
234379,301;163819;3485;168448;818489;819083;876544;982308;822568;1044992;;;;;;
234404,592;165277;3427;168448;819083;820260;876544;984360;823687;1044992;;;;;;
234412,667;165219;5592;167936;820260;820660;876544;985479;826252;1044480;;;;;;
234433,192;167384;2738;168448;820660;822244;876544;988044;824982;1044992;;;;;;
234458,530;164530;2258;168448;822244;822620;876544;986774;824878;1044992;;;;;;
234494,001;164050;3216;168448;822620;823076;876544;986670;826292;1044992;;;;;;
234499,703;165008;864;168448;823076;824443;876544;988084;825307;1044992;;;;;;
234505,328;162656;4015;168448;824443;824604;876544;987099;828619;1044992;;;;;;
234526,441;165807;4084;168448;824604;825052;876544;990411;829136;1044992;;;;;;
234552,532;165876;2064;168448;825052;826788;876544;990928;828852;1044992;;;;;;
234563,599;163856;1795;168448;826788;827164;876544;990644;828959;1044992;;;;;;
234576,373;163587;800;168448;827164;827612;876544;990751;828412;1044992;;;;;;
234646,549;162592;4765;168448;827612;827772;876544;990204;832537;1044992;;;;;;
234668,328;166557;832;162816;827772;829526;876544;994329;830358;1039360;;;;;;
234861,770;162602;1024;168448;829526;829758;876544;992128;830782;1044992;;;;;;
234874,157;162304;1216;167936;829758;829759;876544;992062;830975;1044480;;;;;;
234891,440;162496;6150;166400;829759;830078;876544;992255;836228;1042944;;;;;;
234896,744;165894;6214;166400;830078;830247;876544;995972;836461;1042944;;;;;;
234919,203;165958;2241;166912;830247;832634;876544;996205;834875;1043456;;;;;;
234922,936;160961;3060;166912;832634;833034;876544;993595;836094;1043456;;;;;;
234929,229;161780;2240;167936;833034;833474;876544;994814;835714;1044480;;;;;;
234950,076;162496;672;167424;833474;834625;876544;995970;835297;1043968;;;;;;
234964,212;160840;4028;167936;834626;835018;876544;995466;839046;1044480;;;;;;
235005,379;164796;5911;166912;835018;835825;876544;999814;841736;1043456;;;;;;
235024,784;166679;1723;167424;835825;837409;876544;1002504;839132;1043968;;;;;;
235031,535;160955;960;166912;837409;838324;876544;998364;839284;1043456;;;;;;
235052,232;160192;2428;167936;838324;838725;876544;998516;841153;1044480;;;;;;
235057,850;162684;5828;166400;838725;840521;876544;1001409;846349;1042944;;;;;;
235078,829;166084;5749;165888;840521;841205;876544;1006605;846954;1042432;;;;;;
235086,967;163445;2014;166400;841205;842728;876544;1004650;844742;1042944;;;;;;
235117,944;159710;1056;166912;842728;842984;876544;1002438;844040;1043456;;;;;;
235211,634;159776;1313;166912;842984;843344;876544;1002760;844657;1043456;;;;;;
235309,055;160033;7347;164864;843344;843952;876544;1003377;851299;1041408;;;;;;
235337,081;164019;992;165888;843952;845831;876544;1007971;846823;1042432;;;;;;
235341,808;157664;1605;166400;845831;845831;876544;1003495;847436;1042944;;;;;;
235426,745;158789;3715;165888;845831;846384;876544;1004620;850099;1042432;;;;;;
235443,925;160899;688;166912;846384;847911;876544;1007283;848599;1043456;;;;;;
235535,280;159408;5254;164352;847911;848231;876544;1007319;853485;1040896;;;;;;
235544,368;163974;976;166400;848231;849575;876544;1012205;850551;1042944;;;;;;
235575,854;158672;8565;166400;849575;849735;876544;1008247;858300;1042944;;;;;;
235590,351;166261;2048;164352;849735;851834;876544;1015996;853882;1040896;;;;;;
235600,820;157696;1088;165376;851834;852490;876544;1009530;853578;1041920;;;;;;
235609,817;156736;881;165888;852490;853227;876544;1009226;854108;1042432;;;;;;
235626,221;157553;5208;165888;853227;853323;876544;1010780;858531;1042432;;;;;;
235639,590;161880;3775;165888;853323;854155;876544;1015203;857930;1042432;;;;;;
235654,020;160447;1517;165888;854155;855491;876544;1014602;857008;1042432;;;;;;
235663,731;158189;4261;166400;855491;855860;876544;1013680;860121;1042944;;;;;;
235691,876;161957;2001;166400;855860;857382;876544;1017817;859383;1042944;;;;;;
235751,481;159697;1264;166912;857382;858015;876544;1017079;859279;1043456;;;;;;
235758,519;159984;2980;166912;858015;858535;876544;1017999;861515;1043456;;;;;;
235805,729;161700;5359;166400;858535;858767;876544;1020235;864126;1042944;;;;;;
235817,545;164079;960;166912;858767;860423;876544;1022846;861383;1043456;;;;;;
235836,621;159680;3908;166912;860423;860767;876544;1020103;864675;1043456;;;;;;
235857,689;162628;3260;166912;860767;861503;876544;1023395;864763;1043456;;;;;;
235862,830;161980;1251;167424;861503;862743;876544;1023483;863994;1043968;;;;;;
235881,413;160995;3992;167424;862743;863170;876544;1023738;867162;1043968;;;;;;
235897,584;163736;4532;167424;863170;863655;876544;1026906;868187;1043968;;;;;;
235910,733;164276;1184;167424;863655;865159;876544;1027931;866343;1043968;;;;;;
235919,406;160928;4495;167424;865159;865487;876544;1026087;869982;1043968;;;;;;
235929,800;164239;3329;167424;865487;866183;876544;1029726;869512;1043968;;;;;;
235939,604;163073;3774;167936;866183;867283;876544;1029256;871057;1044480;;;;;;
235955,142;164542;3880;167936;867283;868131;876544;1031825;872011;1044480;;;;;;
235986,739;164648;1104;167936;868131;869339;876544;1032779;870443;1044480;;;;;;
236006,964;161872;5900;166912;869339;869764;876544;1031211;875664;1043456;;;;;;
236045,470;166668;3583;167424;869764;870549;876544;1036432;874132;1043968;;;;;;
236083,136;163327;4027;167424;870549;871384;876544;1033876;875411;1043968;;;;;;
236168,108;163771;6909;165888;871384;872209;876544;1035155;879118;1042432;;;;;;
236176,604;165629;5212;166912;872209;873292;876544;1037838;878504;1043456;;;;;;
236184,643;163932;4204;166912;873292;874082;876544;1037224;878286;1043456;;;;;;
236196,786;162924;4481;166912;874082;874851;876544;1037006;879332;1043456;;;;;;
236203,611;163201;928;166400;874851;876438;876544;1038052;877366;1042944;;;;;;
236203,629;928;0;166400;876438;792302;884736;877366;792302;1051136;185729;185678;786432;1063095;977980;1837568
236210,023;158720;1248;166912;792302;792302;884736;951022;793550;1051648;;;;;;
236224,718;159968;3316;167424;792302;793102;884736;952270;796418;1052160;;;;;;
236245,492;162548;992;166912;793102;794422;884736;955650;795414;1051648;;;;;;
236265,630;160224;3520;167936;794422;794791;884736;954646;798311;1052672;;;;;;
236300,111;163776;5236;167424;794791;796062;884736;958567;801298;1052160;;;;;;
236322,125;165492;1184;167424;796062;796318;884736;961554;797502;1052160;;;;;;
236343,685;160928;6133;165888;796318;796702;884736;957246;802835;1050624;;;;;;
236351,176;165877;688;166912;796702;798774;884736;962579;799462;1051648;;;;;;
236357,423;159408;928;166912;798774;799014;884736;958182;799942;1051648;;;;;;
236388,971;159648;4044;166912;799014;799230;884736;958662;803274;1051648;;;;;;
236404,318;162764;2114;166912;799230;800830;884736;961994;802944;1051648;;;;;;
236420,190;160834;5665;166400;800830;801464;884736;961664;807129;1051136;;;;;;
236429,870;164308;2183;166912;801464;803041;884736;965772;805224;1051648;;;;;;
236433,646;160903;1346;167424;803041;803739;884736;963944;805085;1052160;;;;;;
236443,382;160578;1060;166912;803739;804299;884736;964317;805359;1051648;;;;;;
236448,569;160292;1284;167424;804299;804635;884736;964591;805919;1052160;;;;;;
236458,698;161028;6387;166400;804635;804908;884736;965663;811295;1051136;;;;;;
236477,397;166131;3180;166912;804908;806164;884736;971039;809344;1051648;;;;;;
236484,944;161388;4100;166400;806164;806819;884736;967552;810919;1051136;;;;;;
236498,220;162308;3953;167424;806819;807699;884736;969127;811652;1052160;;;;;;
236512,158;163185;3508;166912;807699;808571;884736;970884;812079;1051648;;;;;;
236523,076;162522;1651;167936;808571;809980;884736;971093;811631;1052672;;;;;;
236538,713;161907;3748;167424;809980;810516;884736;971887;814264;1052160;;;;;;
236553,778;164004;4080;167936;810516;811364;884736;974520;815444;1052672;;;;;;
236572,579;164848;833;167936;811364;813379;884736;976212;814212;1052672;;;;;;
236585,442;161601;3185;168448;813379;813539;884736;974980;816724;1053184;;;;;;
236597,785;164465;1056;167936;813539;814983;884736;978004;816039;1052672;;;;;;
236632,947;162336;5532;166400;814983;815272;884736;977319;820804;1051136;;;;;;
236637,423;165276;4357;167424;815272;815816;884736;980548;820173;1052160;;;;;;
236649,934;164101;3676;167936;815816;816519;884736;979917;820195;1052672;;;;;;
236659,904;163932;3281;167424;816519;817023;884736;980451;820304;1052160;;;;;;
236673,149;163531;5170;167936;817076;817544;884736;980607;822714;1052672;;;;;;
236685,204;165938;6469;167424;817548;818457;884736;983486;824926;1052160;;;;;;
236690,257;167237;1548;166400;818457;820249;884736;985694;821797;1051136;;;;;;
236694,284;160268;800;166912;820249;820897;884736;980517;821697;1051648;;;;;;
236701,481;159520;2640;167424;820897;821249;884736;980417;823889;1052160;;;;;;
236724,716;161872;3737;166912;821249;821729;884736;983121;825466;1051648;;;;;;
236743,866;162969;3536;167936;821729;822507;884736;984698;826043;1052672;;;;;;
236770,721;163671;4576;167424;822508;823124;884736;986179;827700;1052160;;;;;;
236780,978;164832;1088;167936;823124;824763;884736;987956;825851;1052672;;;;;;
236838,621;161856;704;167936;824763;825147;884736;986619;825851;1052672;;;;;;
236870,430;161472;3108;167936;825147;825532;884736;986619;828640;1052672;;;;;;
236927,122;163876;1343;167936;825532;826660;884736;989408;828003;1052672;;;;;;
236948,050;162111;4408;167424;826660;827143;884736;988771;831551;1052160;;;;;;
236953,976;165176;2563;167936;827143;827600;884736;992319;830163;1052672;;;;;;
236981,554;163331;2624;168448;827600;828150;884736;990931;830774;1053184;;;;;;
237026,110;164416;4452;168448;828150;828583;884736;992566;833035;1053184;;;;;;
237085,686;166244;5908;166400;828583;829171;884736;994827;835079;1051136;;;;;;
237110,322;165652;4115;167424;829171;829754;884736;994823;833869;1052160;;;;;;
237124,354;163859;4609;166912;829754;830897;884736;993613;835506;1051648;;;;;;
237136,652;164353;2290;167424;830897;832442;884736;995250;834732;1052160;;;;;;
237152,304;162034;4580;167936;832442;832980;884736;994476;837560;1052672;;;;;;
237234,541;165348;2655;167936;832980;834248;884736;998328;836903;1052672;;;;;;
237257,355;163423;4867;167936;834248;835072;884736;997671;839939;1052672;;;;;;
237271,380;165635;1308;167936;835072;836407;884736;1000707;837715;1052672;;;;;;
237307,047;162076;2848;167936;836407;836903;884736;998483;839751;1052672;;;;;;
237480,623;163616;2506;167936;836903;838215;884736;1000519;840721;1052672;;;;;;
237520,437;163274;1728;168448;838215;838215;884736;1001489;839943;1053184;;;;;;
237620,072;163520;1840;168448;838215;838215;884736;1001735;840055;1053184;;;;;;
237858,803;163632;6655;165376;838215;839514;884736;1001847;846169;1050112;;;;;;
237884,646;165375;8177;166912;839514;841253;884736;1004889;849430;1051648;;;;;;
237902,911;166897;2382;163840;841253;842596;884736;1008150;844978;1048576;;;;;;
237911,145;158030;6228;162304;842596;842596;884736;1000626;848824;1047040;;;;;;
237985,912;161870;7969;163840;842596;843300;884736;1004466;851269;1048576;;;;;;
237999,846;161569;6463;160256;843300;844336;884736;1004869;850799;1044992;;;;;;
238017,428;160063;2333;164352;844336;846790;884736;1004399;849123;1049088;;;;;;
238033,420;155421;864;163840;846790;847342;884736;1002211;848206;1048576;;;;;;
238044,107;153952;1472;164352;847342;847654;884736;1001294;849126;1049088;;;;;;
238052,541;155072;1888;164352;847654;847910;884736;1002726;849798;1049088;;;;;;
238070,137;155488;1120;164864;847910;848182;884736;1003398;849302;1049600;;;;;;
238098,279;155744;2376;164864;848182;848375;884736;1003926;850751;1049600;;;;;;
238109,814;157000;3939;165888;848375;848794;884736;1005375;852733;1050624;;;;;;
238135,274;160099;4435;165376;848794;849530;884736;1008893;853965;1050112;;;;;;
238159,757;160595;1092;165888;849530;851161;884736;1010125;852253;1050624;;;;;;
238167,625;157764;3555;165888;851161;851537;884736;1008925;855092;1050624;;;;;;
238182,984;160227;4468;166400;851537;852232;884736;1011764;856700;1051136;;;;;;
238186,941;162164;3047;166400;852232;853569;884736;1014396;856616;1051136;;;;;;
238197,415;160743;4358;166912;853569;854281;884736;1014312;858639;1051648;;;;;;
238208,565;163078;2724;166912;854281;855545;884736;1017359;858269;1051648;;;;;;
238222,556;161444;3740;167936;855545;855881;884736;1016989;859621;1052672;;;;;;
238243,849;163996;3748;167424;855885;857000;884736;1019881;860748;1052160;;;;;;
238251,319;164004;768;167936;857000;858303;884736;1021004;859071;1052672;;;;;;
238260,187;161536;4142;167936;858303;858656;884736;1019839;862798;1052672;;;;;;
238268,054;164910;4824;166912;858656;859087;884736;1023566;863911;1051648;;;;;;
238273,813;164568;7665;167424;859087;860678;884736;1023655;868343;1052160;;;;;;
238279,071;167409;7662;162816;860678;862779;884736;1028087;870441;1047552;;;;;;
238316,171;162798;2581;158208;862779;865351;884736;1025577;867932;1042944;;;;;;
238322,266;157717;576;164352;865351;866507;884736;1023068;867083;1049088;;;;;;
238323,974;154176;1968;164352;866507;866611;884736;1020683;868579;1049088;;;;;;
238335,608;155568;817;164864;866611;866883;884736;1022179;867700;1049600;;;;;;
238361,136;155350;8369;163328;866883;866995;884736;1022233;875364;1048064;;;;;;
238393,953;162993;8381;161792;866995;868558;884736;1029988;876939;1046528;;;;;;
238419,787;158909;1641;162816;868558;870730;884736;1027467;872371;1047552;;;;;;
238439,110;152018;4773;163840;871540;872028;884736;1023558;876801;1048576;;;;;;
238453,382;156837;3731;163328;872033;872739;884736;1028870;876470;1048064;;;;;;
238620,508;155795;7193;163328;872739;873586;884736;1028534;880779;1048064;;;;;;
238637,905;159769;2125;163840;873586;876141;884736;1033355;878266;1048576;;;;;;
238650,467;154701;6050;163840;876141;876397;884736;1030842;882447;1048576;;;;;;
238661,468;158626;736;163840;876397;879227;884736;1035023;879963;1048576;;;;;;
238665,686;153312;4744;164352;879227;879579;884736;1032539;884323;1049088;;;;;;
238687,329;157832;5556;163840;879579;880236;884736;1037411;885792;1048576;;;;;;
238698,457;158644;1538;164864;880236;882210;884736;1038880;883748;1049600;;;;;;
238698,473;1538;0;164864;882210;811971;904704;883748;811971;1069568;186683;185714;786432;1070431;997685;1856000
238709,945;154112;4673;164352;811971;811972;904704;966083;816645;1069056;;;;;;
238735,363;158785;1698;165376;811972;814024;904704;970757;815722;1070080;;;;;;
238873,668;156834;3731;164864;814024;814552;904704;970858;818283;1069568;;;;;;
238905,749;158867;3471;166400;814552;815215;904704;973419;818686;1071104;;;;;;
238943,837;160655;6691;165888;815215;815863;904704;975870;822554;1070592;;;;;;
238969,541;163875;2145;165888;815863;817827;904704;979738;819972;1070592;;;;;;
238973,263;158817;3976;165888;817827;818831;904704;976644;822807;1070592;;;;;;
238992,896;160648;5271;166400;818831;819287;904704;979479;824558;1071104;;;;;;
239003,884;162967;1442;166400;819287;821321;904704;982254;822763;1071104;;;;;;
239010,565;159138;4299;166400;821321;821993;904704;980459;826292;1071104;;;;;;
239023,109;161995;4804;166400;821993;822636;904704;983988;827440;1071104;;;;;;
239034,444;162500;928;166400;822636;824028;904704;985136;824956;1071104;;;;;;
239045,455;158624;864;166400;824028;824260;904704;982652;825124;1071104;;;;;;
239053,518;158560;2096;166912;824260;824604;904704;982820;826700;1071616;;;;;;
239078,995;160304;8177;166400;824604;826838;904704;984908;835015;1071104;;;;;;
239095,136;166385;1762;163328;826838;829636;904704;993223;831398;1068032;;;;;;
239113,751;156386;1169;164864;829636;830267;904704;986022;831436;1069568;;;;;;
239143,033;155793;4374;165376;830267;830811;904704;986060;835185;1070080;;;;;;
239148,834;159510;1728;164864;830811;832397;904704;990321;834125;1069568;;;;;;
239167,789;156864;5768;164864;832397;833433;904704;989261;839201;1069568;;;;;;
239182,622;161416;1088;165376;833433;836009;904704;994849;837097;1070080;;;;;;
239260,826;156736;4273;165888;836009;836491;904704;992745;840764;1070592;;;;;;
239326,796;160433;3652;165376;836491;837235;904704;996924;840887;1070080;;;;;;
239354,069;159812;1885;166400;837235;838755;904704;997047;840640;1071104;;;;;;
239370,274;159581;3638;166400;838755;839074;904704;998336;842712;1071104;;;;;;
239385,044;161334;2082;166912;839074;840579;904704;1000408;842661;1071616;;;;;;
239446,705;160802;1568;166912;840579;840970;904704;1001381;842538;1071616;;;;;;
239615,241;160288;6651;165376;840970;841395;904704;1001258;848046;1070080;;;;;;
239627,452;164347;5820;163840;841395;841395;904704;1005742;847215;1068544;;;;;;
239648,737;163516;4099;166400;841395;842986;904704;1004911;847085;1071104;;;;;;
239677,724;161283;5697;165888;842986;843506;904704;1004269;849203;1070592;;;;;;
239696,954;162881;1644;166400;843506;845445;904704;1006387;847089;1071104;;;;;;
239712,029;158828;1152;165888;845445;845877;904704;1004273;847029;1070592;;;;;;
239751,716;158336;1008;166400;845877;846356;904704;1004213;847364;1071104;;;;;;
239797,648;158704;1970;166400;846356;846962;904704;1005060;848932;1071104;;;;;;
239847,917;159666;1328;166912;846962;846961;904704;1006628;848289;1071616;;;;;;
239919,442;160048;2478;166912;846961;846962;904704;1007009;849440;1071616;;;;;;
239979,237;161198;2751;167936;846962;846962;904704;1008160;849713;1072640;;;;;;
240023,585;163007;5116;167424;846962;846961;904704;1009969;852077;1072128;;;;;;
240036,209;165372;4592;167424;846961;846962;904704;1012333;851554;1072128;;;;;;
240084,921;164336;3487;167424;846962;846961;904704;1011298;850448;1072128;;;;;;
240122,144;163231;6307;166400;846961;846962;904704;1010192;853269;1071104;;;;;;
240169,594;165027;5873;164864;846962;846962;904704;1011989;852835;1069568;;;;;;
240284,896;164593;7715;164352;846962;846961;904704;1011555;854676;1069056;;;;;;
240368,929;163363;4734;165376;846961;846962;904704;1010324;851696;1070080;;;;;;
240489,383;160382;5815;165888;846962;846962;904704;1007344;852777;1070592;;;;;;
240532,270;162487;8447;165376;846962;846961;904704;1009449;855408;1070080;;;;;;
240559,180;165119;9591;161792;846961;846961;904704;1012080;856552;1066496;;;;;;
240567,127;161655;10666;162816;846961;846961;904704;1008616;857627;1067520;;;;;;
240585,331;162730;8160;160768;846961;847417;904704;1009691;855577;1065472;;;;;;
240596,037;156640;7150;161792;847417;847890;904704;1004057;855040;1066496;;;;;;
240601,432;155630;6542;162816;847890;848738;904704;1003520;855280;1067520;;;;;;
240624,222;156558;7236;162304;848738;849313;904704;1005296;856549;1067008;;;;;;
240637,117;157252;8131;162816;849313;849713;904704;1006565;857844;1067520;;;;;;
240655,756;158659;8548;162816;849713;850185;904704;1008372;858733;1067520;;;;;;
240674,293;159076;5504;162816;850185;851465;904704;1009261;856969;1067520;;;;;;
240689,720;156032;6662;162816;851465;852785;904704;1007497;859447;1067520;;;;;;
240705,705;157190;5513;163840;852785;853281;904704;1009975;858794;1068544;;;;;;
240724,680;157577;7190;163328;853281;854220;904704;1010858;861410;1068032;;;;;;
240739,574;159254;6225;164352;854220;855068;904704;1013474;861293;1069056;;;;;;
240770,278;159313;6184;163840;855068;856324;904704;1014381;862508;1068544;;;;;;
240791,674;159272;4191;164864;856324;857518;904704;1015596;861709;1069568;;;;;;
240801,334;158815;1887;156672;857518;859713;904704;1016333;861600;1061376;;;;;;
240807,656;156511;1404;163328;859713;859945;904704;1016224;861349;1068032;;;;;;
240819,908;153980;927;163840;859945;860401;904704;1013925;861328;1068544;;;;;;
240824,509;153503;4477;164352;860401;860968;904704;1013904;865445;1069056;;;;;;
240849,204;157565;5685;163840;860968;861161;904704;1018533;866846;1068544;;;;;;
240933,956;158773;1289;164352;861161;863116;904704;1019934;864405;1069056;;;;;;
241004,644;154889;7089;164352;863116;863666;904704;1018005;870755;1069056;;;;;;
241022,407;160689;7432;163328;863666;865805;904704;1024355;873237;1068032;;;;;;
241072,140;160008;3700;163840;865805;868557;904704;1025813;872257;1068544;;;;;;
241123,795;156276;832;163328;868557;869852;904704;1024833;870684;1068032;;;;;;
241153,558;153408;3937;163840;869852;870117;904704;1023260;874054;1068544;;;;;;
241187,732;156513;1408;164352;870117;871332;904704;1026630;872740;1069056;;;;;;
241200,176;155008;5060;164352;871332;871837;904704;1026340;876897;1069056;;;;;;
241221,817;158660;4982;165376;871837;873031;904704;1030497;878013;1070080;;;;;;
241224,619;160118;1873;164864;873031;874496;904704;1033149;876369;1069568;;;;;;
241230,860;157009;4910;165376;874496;875136;904704;1031505;880046;1070080;;;;;;
241251,680;160558;3562;165376;875136;876784;904704;1035694;880346;1070080;;;;;;
241264,333;159210;2016;165888;876784;877594;904704;1035994;879610;1070592;;;;;;
241283,166;158688;1088;165888;877594;877938;904704;1036282;879026;1070592;;;;;;
241302,844;157760;2265;166400;877938;878227;904704;1035698;880492;1071104;;;;;;
241319,800;159449;3040;165888;878227;878778;904704;1037676;881818;1070592;;;;;;
241348,128;160224;864;166912;878778;880199;904704;1039002;881063;1071616;;;;;;
241353,175;159584;1031;166912;880199;880415;904704;1039783;881446;1071616;;;;;;
241374,993;159751;5067;165888;880415;880583;904704;1040166;885650;1070592;;;;;;
241398,275;162763;4840;166400;880583;881630;904704;1043346;886470;1071104;;;;;;
241404,672;162536;2753;166912;881630;882537;904704;1044166;885290;1071616;;;;;;
241423,866;160956;2500;166400;882536;883768;904704;1043492;886268;1071104;;;;;;
241434,969;160708;5223;166400;883768;884347;904704;1044476;889570;1071104;;;;;;
241447,904;163943;2291;166912;884347;885763;904704;1048290;888054;1071616;;;;;;
241471,308;160930;5665;166400;885763;886443;904704;1046693;892108;1071104;;;;;;
241478,812;164385;3123;166912;886443;887435;904704;1050828;890558;1071616;;;;;;
241515,755;161843;1938;167424;887435;888842;904704;1049278;890780;1072128;;;;;;
241522,303;161061;914;166912;888843;889483;904704;1049904;890397;1071616;;;;;;
241541,511;160146;2342;167424;889483;889731;904704;1049629;892073;1072128;;;;;;
241559,336;162086;4572;167424;889731;890172;904704;1051817;894744;1072128;;;;;;
241568,793;164316;3152;167936;890172;891134;904704;1054488;894286;1072640;;;;;;
241573,347;163408;3124;167424;891134;891572;904704;1054542;894696;1072128;;;;;;
241576,794;163380;5224;167424;891572;892188;904704;1054952;897412;1072128;;;;;;
241592,724;165992;4586;167936;892188;893044;904704;1058180;897630;1072640;;;;;;
241607,204;165354;1997;167936;893044;894555;904704;1058398;896552;1072640;;;;;;
241616,891;162765;1404;167936;894555;895348;904704;1057320;896752;1072640;;;;;;
241632,983;162172;1917;167936;895348;895698;904704;1057520;897615;1072640;;;;;;
241654,020;162685;1377;167936;895698;896081;904704;1058383;897458;1072640;;;;;;
241660,312;162145;1480;168448;896081;896586;904704;1058226;898066;1073152;;;;;;
241672,185;162760;5234;167936;896586;896770;904704;1059346;902004;1072640;;;;;;
241683,717;166514;1168;167936;896770;898386;904704;1063284;899554;1072640;;;;;;
241701,056;161884;3167;167936;899359;899967;904704;1061243;903134;1072640;;;;;;
241706,299;163935;3360;168448;899971;900632;904704;1063906;903992;1073152;;;;;;
241735,954;164575;1564;167936;900632;902120;904704;1065207;903684;1072640;;;;;;
241796,550;162844;6639;164352;902120;904965;905216;1064964;911604;1069568;;;;;;
241796,610;6639;0;164352;904965;828990;919552;911604;828990;1083904;186639;185866;786432;1098243;1014856;1870336
241806,881;157696;2289;166400;828990;828991;919552;986686;831280;1085952;;;;;;
241813,875;159985;1206;166912;828991;830659;919552;988976;831865;1086464;;;;;;
241838,212;159926;3700;166912;830659;831211;919552;990585;834911;1086464;;;;;;
241852,646;162420;4211;166912;831211;832051;919552;993631;836262;1086464;;;;;;
241883,888;162931;3970;166912;832051;833822;919552;994982;837792;1086464;;;;;;
241891,134;162690;928;167424;833822;835266;919552;996512;836194;1086976;;;;;;
241907,275;160672;3044;167424;835266;835866;919552;995938;838910;1086976;;;;;;
241935,951;162788;3960;167936;835866;836347;919552;998654;840307;1087488;;;;;;
241962,132;164728;3280;167936;836347;837114;919552;1001075;840394;1087488;;;;;;
241978,852;164048;4035;168448;837114;837642;919552;1001162;841677;1088000;;;;;;
241988,313;165315;3441;167936;837642;838242;919552;1002957;841683;1087488;;;;;;
242014,187;164721;1388;168448;838242;839762;919552;1002963;841150;1088000;;;;;;
242026,225;163180;1884;168448;839762;840370;919552;1002942;842254;1088000;;;;;;
242059,033;163676;4104;168448;840370;841074;919552;1004046;845178;1088000;;;;;;
242105,412;165896;4276;168448;841074;841844;919552;1006970;846120;1088000;;;;;;
242133,010;166068;6631;165376;841844;843119;919552;1007912;849750;1084928;;;;;;
242155,665;165351;1824;166912;843119;845310;919552;1008470;847134;1086464;;;;;;
242192,341;160544;1983;167424;845310;845623;919552;1005854;847606;1086976;;;;;;
242203,436;161215;2056;166912;845623;846046;919552;1006838;848102;1086464;;;;;;
242241,434;161288;1072;167424;846046;846758;919552;1007334;847830;1086976;;;;;;
242246,848;160816;4580;167424;846758;846911;919552;1007574;851491;1086976;;;;;;
242263,664;164324;3651;167424;846911;847703;919552;1011235;851354;1086976;;;;;;
242281,285;163395;4577;167424;847703;849246;919552;1011098;853823;1086976;;;;;;
242314,500;164321;3976;167424;849246;850014;919552;1013567;853990;1086976;;;;;;
242351,572;163720;3688;167424;850014;850454;919552;1013734;854142;1086976;;;;;;
242374,330;163432;4738;167936;850454;851317;919552;1013886;856055;1087488;;;;;;
242440,257;165506;1056;167936;851317;853133;919552;1016823;854189;1087488;;;;;;
242480,402;161824;5794;166912;853133;853622;919552;1014957;859416;1086464;;;;;;
242493,632;165485;3919;167424;853622;853622;919552;1019107;857541;1086976;;;;;;
242499,102;163663;6533;166400;853622;854662;919552;1017285;861195;1085952;;;;;;
242504,126;165253;7604;166400;854662;856269;919552;1019915;863873;1085952;;;;;;
242526,103;166324;1089;165376;856269;862273;919552;1022593;863362;1084928;;;;;;
242547,575;157761;3856;165888;862273;862641;919552;1020034;866497;1085440;;;;;;
242564,051;160528;3107;166400;862641;865202;919552;1023169;868309;1085952;;;;;;
242586,567;160803;2560;166400;865202;865958;919552;1026005;868518;1085952;;;;;;
242610,498;160256;1491;166912;865958;867270;919552;1026214;868761;1086464;;;;;;
242638,436;160211;5600;164352;867270;867702;919552;1027481;873302;1083904;;;;;;
242646,314;164320;1616;166400;867702;869862;919552;1032022;871478;1085952;;;;;;
242656,110;159312;2433;166400;869862;870422;919552;1029174;872855;1085952;;;;;;
242676,502;160129;960;166912;870422;871941;919552;1030551;872901;1086464;;;;;;
242788,515;159680;912;166912;871941;872245;919552;1031621;873157;1086464;;;;;;
242858,912;159632;3524;167424;872245;872842;919552;1031877;876366;1086976;;;;;;
242886,920;162756;3209;166912;872842;874274;919552;1035598;877483;1086464;;;;;;
242910,704;162441;2308;167936;874274;874521;919552;1036715;876829;1087488;;;;;;
242949,809;163076;800;167936;874521;874609;919552;1037597;875409;1087488;;;;;;
242989,589;161568;1811;168448;874609;874609;919552;1036177;876420;1088000;;;;;;
243016,713;163091;1248;167936;874609;874609;919552;1037700;875857;1087488;;;;;;
243036,558;162528;2416;168960;874609;874609;919552;1037137;877025;1088512;;;;;;
243071,275;164720;1552;168448;874609;874609;919552;1039329;876161;1088000;;;;;;
243112,130;163856;1792;169472;874609;874609;919552;1038465;876401;1089024;;;;;;
243130,067;165120;5029;168448;874609;874610;919552;1039729;879639;1088000;;;;;;
243145,123;168357;4045;168448;874610;874610;919552;1042967;878655;1088000;;;;;;
243161,438;165837;6632;168448;874610;877490;919552;1040447;884122;1088000;;;;;;
243168,216;168424;4529;164352;877490;877875;919552;1045914;882404;1083904;;;;;;
243177,899;162225;4495;166400;877875;878075;919552;1040100;882570;1085952;;;;;;
243187,246;162191;5457;166400;878075;878907;919552;1040266;884364;1085952;;;;;;
243199,464;163153;4644;166400;878907;879834;919552;1042060;884478;1085952;;;;;;
243219,634;162340;3391;166912;879834;880626;919552;1042174;884017;1086464;;;;;;
243250,870;161599;2207;166400;880626;881274;919552;1042225;883481;1085952;;;;;;
243264,253;160415;784;166912;881274;882844;919552;1041689;883628;1086464;;;;;;
243311,131;159504;2080;166912;882844;883148;919552;1042348;885228;1086464;;;;;;
243353,382;160800;4132;167424;883148;883407;919552;1043948;887539;1086976;;;;;;
243403,839;163364;1619;166912;883407;884720;919552;1046771;886339;1086464;;;;;;
243426,067;160851;3985;167424;884720;885112;919552;1045571;889097;1086976;;;;;;
243453,295;163729;2743;167424;885112;886296;919552;1048841;889039;1086976;;;;;;
243483,073;162487;3956;167936;886296;887002;919552;1048783;890958;1087488;;;;;;
243501,010;164718;2346;167936;887002;888346;919552;1051720;890692;1087488;;;;;;
243533,059;163114;800;167936;888346;888634;919552;1051460;889434;1087488;;;;;;
243572,839;161568;4087;167936;888634;888634;919552;1050202;892721;1087488;;;;;;
243623,994;164855;2580;168448;888634;888634;919552;1053489;891214;1088000;;;;;;
243757,205;163860;3522;167936;888634;888634;919552;1052494;892156;1087488;;;;;;
243771,730;164802;6652;164352;888634;891451;919552;1053436;898103;1083904;;;;;;
243780,693;164348;5636;166400;891451;891947;919552;1055799;897583;1085952;;;;;;
243789,921;163332;3550;166400;891947;892515;919552;1055279;896065;1085952;;;;;;
243796,186;161246;1056;166400;892515;895161;919552;1053761;896217;1085952;;;;;;
243803,071;158752;863;166400;895161;895713;919552;1053913;896576;1085952;;;;;;
243823,783;158559;4597;166400;895713;896129;919552;1054272;900726;1085952;;;;;;
243848,017;162293;4003;166912;896129;896609;919552;1058422;900612;1086464;;;;;;
243871,837;162211;4406;166400;896609;897536;919552;1058820;901942;1085952;;;;;;
243890,062;162614;992;166912;897536;899256;919552;1060150;900248;1086464;;;;;;
243908,688;159712;866;166912;899256;899616;919552;1058968;900482;1086464;;;;;;
243943,657;159586;2531;167424;899616;899889;919552;1059202;902420;1086976;;;;;;
243980,481;161763;5724;166912;899889;900200;919552;1061652;905924;1086464;;;;;;
244043,912;164956;6899;164864;900200;901376;919552;1065156;908275;1084416;;;;;;
244076,569;163571;1186;165888;901376;903245;919552;1064947;904431;1085440;;;;;;
244152,796;157858;3520;166400;903245;903538;919552;1061103;907058;1085952;;;;;;
244221,230;160704;5549;165888;903538;903539;919552;1064242;909088;1085440;;;;;;
244255,708;162733;6211;165376;903539;903539;919552;1066272;909750;1084928;;;;;;
244257,299;162883;9215;161280;903539;906627;919552;1066422;915842;1080832;;;;;;
244289,253;161279;9604;159744;906627;907522;919552;1067906;917126;1079296;;;;;;
244353,375;159620;9985;160256;907522;910450;919552;1067142;920435;1079808;;;;;;
244465,319;160001;4722;161792;910450;915626;919552;1070451;920348;1081344;;;;;;
244465,355;4722;0;161792;915626;819365;910336;920348;819365;1072128;186540;185633;786432;1106888;1004998;1858560
244489,808;147968;2961;161280;819365;819365;910336;967333;822326;1071616;;;;;;
244524,174;150929;4932;162816;819365;819733;910336;970294;824665;1073152;;;;;;
244526,861;154436;9152;161792;819733;822453;910336;974169;831605;1072128;;;;;;
244610,481;158656;5445;162816;822453;825014;910336;981109;830459;1073152;;;;;;
244651,383;154949;2925;161792;825014;825389;910336;979963;828314;1072128;;;;;;
244704,071;152429;1232;162816;825389;826861;910336;977818;828093;1073152;;;;;;
244779,972;151590;6391;162816;826861;827150;910336;978451;833541;1073152;;;;;;
244802,980;156919;992;162816;827150;829057;910336;984069;830049;1073152;;;;;;
244806,891;151520;1582;162816;829057;829497;910336;980577;831079;1073152;;;;;;
244810,675;152110;866;163328;829497;829585;910336;981607;830451;1073664;;;;;;
244873,099;152418;3695;163328;829585;829753;910336;982003;833448;1073664;;;;;;
244878,663;155247;8427;161792;829753;830642;910336;985000;839069;1072128;;;;;;
244894,977;158955;2880;162816;830642;831704;910336;989597;834584;1073152;;;;;;
244907,717;153408;1523;163840;831704;833209;910336;985112;834732;1074176;;;;;;
244925,788;153587;1024;163328;833209;833884;910336;986796;834908;1073664;;;;;;
245000,546;153088;2800;164352;833884;834148;910336;986972;836948;1074688;;;;;;
245030,326;155888;4658;163840;834148;835072;910336;990036;839730;1074176;;;;;;
245101,325;157746;3718;165376;835072;836217;910336;992818;839935;1075712;;;;;;
245125,387;158854;6874;164864;836217;836930;910336;995071;843804;1075200;;;;;;
245140,485;162010;1200;164864;836930;838961;910336;998940;840161;1075200;;;;;;
245149,984;155824;992;164864;838961;839489;910336;994785;840481;1075200;;;;;;
245156,085;155616;608;165376;839489;839857;910336;995105;840465;1075712;;;;;;
245193,762;155744;2338;164864;839857;840129;910336;995601;842467;1075200;;;;;;
245304,618;157474;3955;165888;840129;840514;910336;997603;844469;1076224;;;;;;
245338,464;160627;1008;165888;840514;842312;910336;1001141;843320;1076224;;;;;;
245381,814;157680;1024;166400;842312;842688;910336;999992;843712;1076736;;;;;;
245464,410;158720;1840;166400;842688;842688;910336;1001408;844528;1076736;;;;;;
245734,067;159536;6045;164864;842688;842689;910336;1002224;848734;1075200;;;;;;
245748,067;162717;3809;165888;842689;842689;910336;1005406;846498;1076224;;;;;;
246029,027;160481;3790;166912;842689;843201;910336;1003170;846991;1077248;;;;;;
246113,067;161998;8160;166400;843201;844738;910336;1005199;852898;1076736;;;;;;
246137,557;166368;8384;161792;844738;846089;910336;1011106;854473;1072128;;;;;;
246151,505;161472;4017;164352;846089;846089;910336;1007561;850106;1074688;;;;;;
246160,569;157105;4271;164864;846089;846233;910336;1003194;850504;1075200;;;;;;
246170,877;158383;5168;164352;846233;847369;910336;1004616;852537;1074688;;;;;;
246190,155;159280;5122;165376;847369;848365;910336;1006649;853487;1075712;;;;;;
246203,560;160770;3469;165376;848365;849212;910336;1009135;852681;1075712;;;;;;
246249,996;159117;4660;165888;849212;850389;910336;1008329;855049;1076224;;;;;;
246305,095;161332;3284;165888;850389;851044;910336;1011721;854328;1076224;;;;;;
246328,140;159956;1024;166400;851044;852532;910336;1011000;853556;1076736;;;;;;
246467,394;158720;5896;163840;852532;852972;910336;1011252;858868;1074176;;;;;;
246545,843;163592;3875;166400;852972;852972;910336;1016564;856847;1076736;;;;;;
246592,577;161059;4737;165888;852972;852972;910336;1014031;857709;1076224;;;;;;
246675,022;161921;5198;166400;852972;852972;910336;1014893;858170;1076736;;;;;;
246737,232;162894;8464;166400;852972;852972;910336;1015866;861436;1076736;;;;;;
246759,751;166160;5762;164352;852972;852972;910336;1019132;858734;1074688;;;;;;
246776,069;161367;5582;165376;852973;852972;910336;1014340;858554;1075712;;;;;;
246790,685;161230;8887;163840;852972;853764;910336;1014202;862651;1074176;;;;;;
246811,675;163450;6528;164864;853764;854581;910336;1017214;861109;1075200;;;;;;
246843,914;161152;4752;164864;854581;855636;910336;1015733;860388;1075200;;;;;;
246992,025;159376;10169;164864;855636;856004;910336;1015012;866173;1075200;;;;;;
247318,989;164793;9653;160768;856004;856004;910336;1020797;865657;1071104;;;;;;
247344,305;160181;6762;162816;856004;856004;910336;1016185;862766;1073152;;;;;;
247352,157;157290;8389;162304;856004;856005;910336;1013294;864394;1072640;;;;;;
247385,115;158917;7908;162816;856005;857348;910336;1014922;865256;1073152;;;;;;
247414,643;158436;4994;163328;857348;858323;910336;1015784;863317;1073664;;;;;;
247428,859;156034;3751;162816;858323;860129;910336;1014357;863880;1073152;;;;;;
247481,095;154791;2928;163328;860129;860681;910336;1014920;863609;1073664;;;;;;
247504,571;154480;7341;163328;860681;861225;910336;1015161;868566;1073664;;;;;;
247515,791;158893;6063;163840;861225;861617;910336;1020118;867680;1074176;;;;;;
247524,780;158127;4685;163328;861617;861881;910336;1019744;866566;1073664;;;;;;
247546,666;156749;4567;164352;861881;863049;910336;1018630;867616;1074688;;;;;;
247595,060;157655;3969;163840;863049;864361;910336;1020704;868330;1074176;;;;;;
247608,012;157057;3636;164864;864361;865011;910336;1021418;868647;1075200;;;;;;
247624,313;157748;1248;164352;865011;866395;910336;1022759;867643;1074688;;;;;;
247740,453;155191;2223;164352;866395;866939;910336;1021586;869162;1074688;;;;;;
247775,724;155823;3928;164352;866939;867698;910336;1022762;871626;1074688;;;;;;
247854,443;157519;3644;165376;867697;868154;910336;1025216;871798;1075712;;;;;;
247898,334;158780;3007;164864;868154;868153;910336;1026934;871160;1075200;;;;;;
247951,798;158143;8281;164352;868153;868154;910336;1026296;876435;1074688;;;;;;
248058,361;162905;6643;161280;868154;868154;910336;1031059;874797;1071616;;;;;;
248068,285;58193;6384;164352;868153;868153;910336;926346;874537;1074688;;;;;;
248068,305;6384;0;164352;868153;819404;910336;874537;819404;1074688;186317;185646;786432;1060854;1005050;1861120
248149,956;153600;2304;164352;819404;819404;910336;973004;821708;1074688;;;;;;
248171,864;155904;1520;164352;819404;819404;910336;975308;820924;1074688;;;;;;
248393,555;155120;4215;164352;819404;819404;910336;974524;823619;1074688;;;;;;
248457,115;157815;6361;164864;819404;819405;910336;977219;825766;1075200;;;;;;
248536,396;160985;7132;161792;819405;819405;910336;980390;826537;1072128;;;;;;
248618,259;161749;4684;164864;819405;819404;910336;981154;824088;1075200;;;;;;
248904,450;158796;9676;163840;819404;819404;910336;978200;829080;1074176;;;;;;
248966,893;163788;8486;162816;819404;819404;910336;983192;827890;1073152;;;;;;
248991,383;160038;7335;163328;819404;819405;910336;979442;826740;1073664;;;;;;
249031,752;158887;9503;161280;819405;819405;910336;978292;828908;1071616;;;;;;
249127,048;159007;9668;159232;819405;819405;910336;978412;829073;1069568;;;;;;
249168,227;159172;11552;159744;819405;819405;910336;978577;830957;1070080;;;;;;
249190,062;157984;10022;156672;819405;819405;910336;977389;829427;1067008;;;;;;
249212,146;156454;10771;159232;819405;819405;910336;975859;830176;1069568;;;;;;
249238,329;155155;10931;155648;819405;820045;910336;974560;830976;1065984;;;;;;
249272,412;155315;10035;159232;820045;820621;910336;975360;830656;1069568;;;;;;
249326,625;153379;9573;159232;820652;821932;910336;974031;831505;1069568;;;;;;
249356,738;152933;9848;159744;821936;822984;910336;974869;832832;1070080;;;;;;
249377,482;153720;8822;159232;822984;824009;910336;976704;832831;1069568;;;;;;
249431,703;152606;8944;160768;824009;825208;910336;976615;834152;1071104;;;;;;
249466,571;154864;8901;160256;825208;825752;910336;980072;834653;1070592;;;;;;
249494,545;154821;8032;161280;825752;826304;910336;980573;834336;1071616;;;;;;
249531,080;155488;8869;161280;826304;826793;910336;981792;835662;1071616;;;;;;
249560,924;156325;6047;161792;826793;827401;910336;983118;833448;1072128;;;;;;
249582,219;154527;6735;161792;827401;827720;910336;981928;834455;1072128;;;;;;
249651,423;155215;7954;162304;827720;828145;910336;982935;836099;1072640;;;;;;
249713,420;156946;10810;161792;828145;828144;910336;985091;838954;1072128;;;;;;
249765,774;159802;13300;158720;828144;828866;910336;987946;842166;1069056;;;;;;
249812,578;158708;8572;160256;828866;830042;910336;987574;838614;1070592;;;;;;
249848,143;153980;8450;161280;830042;830042;910336;984022;838492;1071616;;;;;;
249895,258;155394;8047;160768;830042;830042;910336;985436;838089;1071104;;;;;;
250008,560;154991;10609;160768;830042;830042;910336;985033;840651;1071104;;;;;;
250046,334;158065;11676;159232;830042;830042;910336;988107;841718;1069568;;;;;;
250118,043;159132;9693;161280;830042;830042;910336;989174;839735;1071616;;;;;;
250310,609;156637;9443;160768;830042;830743;910336;986679;840186;1071104;;;;;;
250633,138;156318;8931;161792;830743;831224;910336;987061;840155;1072128;;;;;;
250710,028;156899;9449;161280;831224;831575;910336;988123;841024;1071616;;;;;;
250809,433;157417;9807;162304;831575;832088;910336;988992;841895;1072640;;;;;;
250864,236;159311;8957;162304;832088;832247;910336;991399;841204;1072640;;;;;;
250900,303;158461;11605;161280;832247;832854;910336;990708;844459;1071616;;;;;;
250922,115;160085;8392;161792;832854;833182;910336;992939;841574;1072128;;;;;;
250931,787;156872;7512;162304;833182;833910;910336;990054;841422;1072640;;;;;;
251188,557;157016;8337;162304;833910;835521;910336;990926;843858;1072640;;;;;;
251352,271;157841;10841;161280;835521;835704;910336;993362;846545;1071616;;;;;;
251389,557;159321;8068;161792;835704;835705;910336;995025;843773;1072128;;;;;;
251403,883;156527;7168;162304;835705;836169;910336;992232;843337;1072640;;;;;;
251440,141;156672;8803;162304;836169;836497;910336;992841;845300;1072640;;;;;;
251472,587;158307;7584;162816;836497;836689;910336;994804;844273;1073152;;;;;;
251506,875;157600;9705;162304;836689;836992;910336;994289;846697;1072640;;;;;;
251532,651;159721;9051;162816;836992;837033;910336;996713;846084;1073152;;;;;;
251542,752;159579;7993;162816;837033;837240;910336;996612;845233;1073152;;;;;;
251555,612;158521;10178;162816;837240;837728;910336;995761;847906;1073152;;;;;;
251621,527;160706;12257;162816;837728;838619;910336;998434;850876;1073152;;;;;;
251637,540;162785;8066;160768;838619;839123;910336;1001404;847189;1071104;;;;;;
251652,964;156546;6339;161792;839123;840426;910336;995669;846765;1072128;;;;;;
251671,543;69955;5201;160768;840427;841171;910336;910382;846372;1071104;;;;;;
251671,562;5201;0;160768;841171;819199;910336;846372;819199;1071104;186296;185718;786432;1032668;1004917;1857536
251721,479;147456;4627;161280;819199;819200;910336;966655;823827;1071616;;;;;;
251771,751;152083;3055;160256;819200;819199;910336;971283;822254;1070592;;;;;;
251842,918;149487;5085;160768;819199;819199;910336;968686;824284;1071104;;;;;;
251868,537;151517;3762;161280;819199;819199;910336;970716;822961;1071616;;;;;;
251927,988;151181;7154;161280;819781;819782;910336;970962;826936;1071616;;;;;;
251944,715;154610;7556;162304;819787;819787;910336;974397;827343;1072640;;;;;;
251950,835;156548;5208;161792;819787;819786;910336;976335;824994;1072128;;;;;;
252037,524;154200;10698;161280;819786;819786;910336;973986;830484;1071616;;;;;;
252061,084;159178;7284;161792;819786;819787;910336;978964;827071;1072128;;;;;;
252093,453;155764;7054;162816;819787;820712;910336;975551;827766;1073152;;;;;;
252103,056;157070;5073;162304;820712;821663;910336;977782;826736;1072640;;;;;;
252131,704;155089;4224;162816;821663;822672;910336;976752;826896;1073152;;;;;;
252152,582;154752;3504;162816;822672;824271;910336;977424;827775;1073152;;;;;;
252174,413;154032;5869;163328;824271;825203;910336;978303;831072;1073664;;;;;;
252187,342;156909;5671;162816;825203;825851;910336;982112;831522;1073152;;;;;;
252218,572;156711;2655;162816;825851;827638;910336;982562;830293;1073152;;;;;;
252254,543;154207;3423;163328;827638;828557;910336;981845;831980;1073664;;;;;;
252268,866;154975;1361;162816;828557;829821;910336;983532;831182;1073152;;;;;;
252273,104;152913;944;163328;829821;830518;910336;982734;831462;1073664;;;;;;
252278,942;152496;6109;163328;830518;830808;910336;983014;836917;1073664;;;;;;
252288,698;157661;5025;163328;830808;832088;910336;988469;837113;1073664;;;;;;
252305,313;156577;5042;164864;832088;832560;910336;988665;837602;1075200;;;;;;
252316,208;159154;1248;164352;832560;834399;910336;991714;835647;1074688;;;;;;
252341,652;155360;1520;164352;834399;834719;910336;989759;836239;1074688;;;;;;
252369,094;155120;2003;164352;834719;835248;910336;989839;837251;1074688;;;;;;
252380,667;155603;1088;164864;835248;835479;910336;990851;836567;1075200;;;;;;
252401,356;155712;3652;164864;835479;835944;910336;991191;839596;1075200;;;;;;
252447,365;158276;4685;165888;835944;836536;910336;994220;841221;1076224;;;;;;
252458,593;160845;3540;165376;836536;837450;910336;997381;840990;1075712;;;;;;
252512,680;159700;1664;166400;837450;838419;910336;997150;840083;1076736;;;;;;
252547,132;159360;4004;166400;838419;839322;910336;997779;843326;1076736;;;;;;
252552,370;161700;800;166400;839322;840938;910336;1001022;841738;1076736;;;;;;
252564,546;158496;1072;166400;840938;841090;910336;999434;842162;1076736;;;;;;
252602,710;158768;3860;166912;841090;841435;910336;999858;845295;1077248;;;;;;
252620,568;162580;2795;166912;841435;842962;910336;1004015;845757;1077248;;;;;;
252639,563;161515;7671;164352;842962;843862;910336;1004477;851533;1074688;;;;;;
252668,394;164343;3714;165888;843862;845929;910336;1008205;849643;1076224;;;;;;
252683,279;160386;2513;166400;845929;846449;910336;1006315;848962;1076736;;;;;;
252732,603;160209;964;166400;846449;847009;910336;1006658;847973;1076736;;;;;;
252780,209;158660;4068;166912;847009;847257;910336;1005669;851325;1077248;;;;;;
252816,620;162276;3284;166400;847257;848073;910336;1009533;851357;1076736;;;;;;
252840,502;161492;4263;167424;848073;848073;910336;1009565;852336;1077760;;;;;;
252870,300;164007;5722;165888;848073;848073;910336;1012080;853795;1076224;;;;;;
252897,302;165466;5524;166912;848073;848073;910336;1013539;853597;1077248;;;;;;
252902,705;164244;4384;166912;848073;848073;910336;1012317;852457;1077248;;;;;;
252910,984;163104;4400;166912;848073;849209;910336;1011177;853609;1077248;;;;;;
252932,489;163120;6469;165376;849209;850305;910336;1012329;856774;1075712;;;;;;
252956,984;165189;4612;166912;850305;851001;910336;1015494;855613;1077248;;;;;;
252969,380;162820;3876;166400;851001;852145;910336;1013821;856021;1076736;;;;;;
252979,280;162084;1903;166912;852145;853689;910336;1014229;855592;1077248;;;;;;
253011,139;160623;5266;166912;853689;854377;910336;1014312;859643;1077248;;;;;;
253030,381;163986;5591;166912;854377;855081;910336;1018363;860672;1077248;;;;;;
253041,481;164311;4569;166912;855081;855825;910336;1019392;860394;1077248;;;;;;
253063,854;163289;6135;166912;855825;857108;910336;1019114;863243;1077248;;;;;;
253084,488;164855;3700;166912;857108;858328;910336;1021963;862028;1077248;;;;;;
253092,312;162420;1376;166912;858328;859736;910336;1020748;861112;1077248;;;;;;
253116,720;160096;3636;166912;859736;860433;910336;1019832;864069;1077248;;;;;;
253256,489;162354;5052;166912;860433;861008;910336;1022787;866060;1077248;;;;;;
253299,465;163772;4542;166912;861008;862064;910336;1024780;866606;1077248;;;;;;
253372,462;163262;2960;167424;862064;863775;910336;1025326;866735;1077760;;;;;;
253418,707;162704;1749;167424;863775;864167;910336;1026479;865916;1077760;;;;;;
253427,642;161413;2972;167424;864555;864556;910336;1025968;867528;1077760;;;;;;
253516,526;162716;7655;167424;864559;865031;910336;1027275;872686;1077760;;;;;;
253519,097;167399;7648;162304;865031;868222;910336;1032430;875870;1072640;;;;;;
253580,869;162272;1048;156160;868222;875158;910336;1030494;876206;1066496;;;;;;
253665,892;155672;1366;164352;875158;875767;910336;1030830;877133;1074688;;;;;;
253701,247;154966;6378;164352;875767;876110;910336;1030733;882488;1074688;;;;;;
253730,509;159978;992;164352;876110;878210;910336;1036088;879202;1074688;;;;;;
253746,965;154592;3280;164352;878210;878514;910336;1032802;881794;1074688;;;;;;
253768,040;156880;1523;164864;878514;880978;910336;1035394;882501;1075200;;;;;;
253781,668;156147;4372;164864;880978;881591;910336;1037125;885963;1075200;;;;;;
253790,329;158996;1768;165376;881591;883110;910336;1040587;884878;1075712;;;;;;
253809,654;157416;963;165376;883110;883946;910336;1040526;884909;1075712;;;;;;
253818,042;156611;896;165888;883946;884170;910336;1040557;885066;1076224;;;;;;
253830,625;157568;816;165888;884170;884402;910336;1041738;885218;1076224;;;;;;
253850,062;157488;1421;166400;884402;884706;910336;1041890;886127;1076736;;;;;;
253862,270;158605;1687;165888;884706;884994;910336;1043311;886681;1076224;;;;;;
253979,203;158871;1250;166912;884994;885669;910336;1043865;886919;1077248;;;;;;
254033,964;159970;1536;166912;885669;886013;910336;1045639;887549;1077248;;;;;;
254080,665;160256;1488;167936;886013;886612;910336;1046269;888100;1078272;;;;;;
254126,431;161744;1728;167424;886612;886612;910336;1048356;888340;1077760;;;;;;
254164,144;161984;1972;168448;886612;886612;910336;1048596;888584;1078784;;;;;;
254429,256;163764;6655;168448;886612;887674;910336;1050376;894329;1078784;;;;;;
254468,165;168447;4388;165376;887674;888338;910336;1056121;892726;1075712;;;;;;
254501,744;163108;3167;166912;888338;888338;910336;1051446;891505;1077248;;;;;;
254799,639;161887;5443;166400;888338;888338;910336;1050225;893781;1076736;;;;;;
255025,455;164163;8186;166912;888338;888417;910336;1052501;896603;1077248;;;;;;
255274,686;141180;4687;164864;888417;889465;910336;1029597;894152;1075200;;;;;;
255274,712;4687;0;164864;889465;827767;910336;894152;827767;1075200;185895;185707;786432;1080047;1013474;1861632
255398,331;156672;1328;165888;827767;827767;910336;984439;829095;1076224;;;;;;
255522,058;158000;3571;166400;827767;827768;910336;985767;831339;1076736;;;;;;
255681,136;160755;8688;165888;827768;830143;910336;988523;838831;1076224;;;;;;
255703,470;165872;9197;161792;830143;831746;910336;996015;840943;1072128;;;;;;
255704,124;161773;9762;158208;831746;831746;910336;993519;841508;1068544;;;;;;
255720,596;157730;5857;160768;831746;831914;910336;989476;837771;1071104;;;;;;
256288,526;154337;5708;161792;831914;833025;910336;986251;838733;1072128;;;;;;
256410,148;154188;3782;162816;833025;834504;910336;987213;838286;1073152;;;;;;
256610,305;154310;5960;162816;834504;835152;910336;988814;841112;1073152;;;;;;
256648,827;156488;3264;163840;835152;836720;910336;991640;839984;1074176;;;;;;
256756,446;155328;4483;163328;836720;837281;910336;992048;841764;1073664;;;;;;
256782,587;156547;2057;164352;837281;839016;910336;993828;841073;1074688;;;;;;
256819,445;155657;4452;164352;839016;839675;910336;994673;844127;1074688;;;;;;
257188,510;158052;831;163840;839675;841115;910336;997727;841946;1074176;;;;;;
257746,950;154431;4958;164352;841115;841587;910336;995546;846545;1074688;;;;;;
257977,931;158558;7763;163840;841587;841588;910336;1000145;849351;1074176;;;;;;
258003,037;161363;5057;164352;841588;841588;910336;1002951;846645;1074688;;;;;;
258068,706;158657;7635;163840;841588;841588;910336;1000245;849223;1074176;;;;;;
258192,284;161235;5559;164352;841588;841588;910336;1002823;847147;1074688;;;;;;
258248,346;159159;10732;161280;841588;842522;910336;1000747;853254;1071616;;;;;;
258269,638;161260;4097;162816;842522;844306;910336;1003782;848403;1073152;;;;;;
258282,694;154625;4063;163328;844306;844306;910336;998931;848369;1073664;;;;;;
258305,347;155103;3953;162816;844306;844802;910336;999409;848755;1073152;;;;;;
258307,898;154993;4099;164352;844802;845154;910336;999795;849253;1074688;;;;;;
258317,273;157187;4217;163840;845154;846545;910336;1002341;850762;1074176;;;;;;
258343,983;157305;2607;164352;846545;846729;910336;1003850;849336;1074688;;;;;;
258364,114;156207;2682;164352;846729;846992;910336;1002936;849674;1074688;;;;;;
258402,499;156282;4196;165376;846992;848000;910336;1003274;852196;1075712;;;;;;
258468,560;159332;1968;164864;848000;848705;910336;1007332;850673;1075200;;;;;;
258490,467;157104;864;165376;848705;850002;910336;1005809;850866;1075712;;;;;;
258877,581;136072;2719;165376;850001;850210;910336;986073;852929;1075712;;;;;;
258877,604;2719;0;165376;850210;828304;910336;852929;828304;1075712;186247;185853;786432;1039176;1014157;1862144
259028,777;155648;6744;164352;828304;828304;910336;983952;835048;1074688;;;;;;
259064,383;161368;4782;164864;828304;829119;910336;989672;833901;1075200;;;;;;
259079,343;159406;4369;165888;829119;829942;910336;988525;834311;1076224;;;;;;
259104,332;160529;2226;165376;829942;831551;910336;990471;833777;1075712;;;;;;
259138,353;158386;3910;166400;831551;832167;910336;989937;836077;1076736;;;;;;
259148,923;161094;704;165888;832167;833620;910336;993261;834324;1076224;;;;;;
259210,486;157888;3940;166912;833620;833780;910336;991508;837720;1077248;;;;;;
259242,406;162148;977;166400;833780;835236;910336;995928;836213;1076736;;;;;;
259311,942;159185;3653;166912;835236;835580;910336;994421;839233;1077248;;;;;;
259369,361;162373;2592;166912;835580;835580;910336;997953;838172;1077248;;;;;;
259398,199;161312;4481;167424;835580;835580;910336;996892;840061;1077760;;;;;;
259440,729;164225;3614;167424;835580;835580;910336;999805;839194;1077760;;;;;;
259461,294;163358;3390;167936;835580;835581;910336;998938;838971;1078272;;;;;;
259629,928;164158;5932;166912;835581;835580;910336;999739;841512;1077248;;;;;;
259733,467;166700;7678;165376;835580;835973;910336;1002280;843651;1075712;;;;;;
259872,883;165374;7845;165888;835973;836922;910336;1001347;844767;1076224;;;;;;
260152,545;165541;6310;164864;836922;836922;910336;1002463;843232;1075200;;;;;;
260179,260;161958;6579;162304;836922;836923;910336;998880;843502;1072640;;;;;;
260204,708;162227;5135;165376;836923;836922;910336;999150;842057;1075712;;;;;;
260594,616;160271;7594;164864;836922;836922;910336;997193;844516;1075200;;;;;;
260634,949;162730;9373;162816;836922;836922;910336;999652;846295;1073152;;;;;;
260659,013;161949;9961;162816;836922;836923;910336;998871;846884;1073152;;;;;;
260667,290;162537;7779;162816;836923;836922;910336;999460;844701;1073152;;;;;;
260681,180;158307;7471;162816;836922;837394;910336;995229;844865;1073152;;;;;;
260693,403;157999;9316;161792;837394;838170;910336;995393;847486;1072128;;;;;;
260892,228;158820;6287;162304;838170;839586;910336;996990;845873;1072640;;;;;;
261019,545;155791;10444;160768;839586;840402;910336;995377;850846;1071104;;;;;;
261594,928;158924;7956;161792;840402;841217;910336;999326;849173;1072128;;;;;;
261612,881;156436;5742;162304;841217;841216;910336;997653;846958;1072640;;;;;;
261631,685;155246;5663;162304;841216;841777;910336;996462;847440;1072640;;;;;;
261667,475;155167;7140;163328;841777;842441;910336;996944;849581;1073664;;;;;;
261909,202;96183;11757;162816;842440;842527;910336;938623;854284;1073152;;;;;;
261909,227;11757;0;162816;842527;838023;910336;854284;838023;1073152;186203;185732;786432;1040487;1023755;1859584
261951,852;151040;4322;160768;838023;838023;910336;989063;842345;1071104;;;;;;
261999,335;152730;6558;161792;838024;838024;910336;990754;844582;1072128;;;;;;
262008,724;65847;11109;160256;838023;838024;910336;903870;849133;1070592;;;;;;
262008,750;11109;0;160256;838024;837604;910336;849133;837604;1070592;185906;185738;786432;1035039;1023342;1857024
262020,717;147456;4438;161280;837604;837605;910336;985060;842043;1071616;;;;;;
262046,609;151894;3264;161280;837605;837604;910336;989499;840868;1071616;;;;;;
262115,342;150720;4944;161280;837604;837605;910336;988324;842549;1071616;;;;;;
262207,322;152400;9000;161792;837605;837604;910336;990005;846604;1072128;;;;;;
262253,956;93888;11279;160256;837605;837604;910336;931493;848883;1070592;;;;;;
262253,973;11279;0;160256;837604;837343;910336;848883;837343;1070592;186073;185738;786432;1034956;1023081;1857024
262275,141;148480;2397;159744;837343;837344;910336;985823;839741;1070080;;;;;;
262278,136;147805;4748;160256;837344;837343;910336;985149;842091;1070592;;;;;;
262280,558;54026;9418;160768;837343;837343;910336;891369;846761;1071104;;;;;;
262280,588;9418;0;160768;837343;838197;910336;846761;838197;1071104;185738;185738;786432;1032499;1023935;1857536
262314,347;146432;3488;160768;838197;838197;910336;984629;841685;1071104;;;;;;
262345,453;149920;3888;161280;838197;838197;910336;988117;842085;1071616;;;;;;
262415,563;150832;6933;160768;838197;838197;910336;989029;845130;1071104;;;;;;
262430,696;153877;6401;162304;838197;838197;910336;992074;844598;1072640;;;;;;
262440,991;155393;5857;161792;838197;838197;910336;993590;844054;1072128;;;;;;
262442,330;154849;9437;161792;838197;838197;910336;993046;847634;1072128;;;;;;
262444,771;158941;12796;157696;838197;843781;910336;997138;856577;1068032;;;;;;
262449,404;157692;8752;155136;843781;845154;910336;1001473;853906;1065472;;;;;;
262462,960;151088;8024;158720;845154;846385;910336;996242;854409;1069056;;;;;;
262487,601;150360;5423;159744;846385;847761;910336;996745;853184;1070080;;;;;;
262504,984;149807;2703;159744;847761;850433;910336;997568;853136;1070080;;;;;;
262539,620;147030;928;159744;850433;852304;910336;997463;853232;1070080;;;;;;
262548,992;145312;3184;159744;852304;852889;910336;997616;856073;1070080;;;;;;
262552,227;147568;10704;158720;852889;855573;910336;1000457;866277;1069056;;;;;;
262564,131;53785;6237;159232;855573;858053;910336;909358;864290;1069568;;;;;;
262564,148;6237;0;159232;858053;842236;910336;864290;842236;1069568;186090;185756;786432;1050380;1027992;1856000
262588,142;143360;2205;160256;842236;842236;910336;985596;844441;1070592;;;;;;
262845,516;147101;3557;159744;842236;844035;910336;989337;847592;1070080;;;;;;
262848,747;148453;10128;159232;844035;847244;910336;992488;857372;1069568;;;;;;
263043,921;154512;5045;159744;847244;849773;910336;1001756;854818;1070080;;;;;;
263086,656;149429;3276;160768;849773;850660;910336;999202;853936;1071104;;;;;;
263095,465;149196;1816;160256;850660;852557;910336;999856;854373;1070592;;;;;;
263121,690;105077;5852;161792;852557;853454;910336;957634;859306;1072128;;;;;;
263121,707;5852;0;161792;853454;843031;910336;859306;843031;1072128;185990;185939;786432;1045296;1028970;1858560
263205,599;147456;3970;160768;843031;843031;910336;990487;847001;1071104;;;;;;
263213,565;151426;2774;162304;843031;843649;910336;994457;846423;1072640;;;;;;
263235,538;152278;8989;158720;843649;844814;910336;995927;853803;1069056;;;;;;
263242,291;158493;6407;162304;844814;845934;910336;1003307;852341;1072640;;;;;;
263243,329;132243;12213;161280;845934;849918;910336;978177;862131;1071616;;;;;;
263243,352;12213;0;161280;849918;853157;910336;862131;853157;1071616;185945;185829;786432;1048076;1038986;1858048
263329,367;148992;5872;161280;853157;853158;910336;1002149;859030;1071616;;;;;;
263667,923;153328;4158;161280;853158;858231;910336;1006486;862389;1071616;;;;;;
263671,452;151614;7592;161792;858231;859199;910336;1009845;866791;1072128;;;;;;
263887,440;155231;5657;161280;859199;861803;910336;1014430;867460;1071616;;;;;;
263923,330;153625;5164;162816;861803;862767;910336;1015428;867931;1073152;;;;;;
263982,509;155180;992;162304;862767;864581;910336;1017947;865573;1072640;;;;;;
264115,089;151008;2969;162816;864581;864757;910336;1015589;867726;1073152;;;;;;
264192,112;152985;7299;162304;864757;865816;910336;1017742;873115;1072640;;;;;;
264192,782;157315;8168;161792;865816;865815;910336;1023131;873983;1072128;;;;;;
264235,377;157672;3812;162304;865815;870900;910336;1023487;874712;1072640;;;;;;
264294,461;153316;2791;162816;870900;871212;910336;1024216;874003;1073152;;;;;;
264317,778;153319;4682;162816;871212;871937;910336;1024531;876619;1073152;;;;;;
264404,375;155210;992;163328;871937;873627;910336;1027147;874619;1073664;;;;;;
264461,647;152544;5491;163328;873627;873847;910336;1026171;879338;1073664;;;;;;
264522,004;157043;3041;163840;873847;874713;910336;1030890;877754;1074176;;;;;;
264527,984;155617;2384;163840;874713;876458;910336;1030330;878842;1074176;;;;;;
265335,416;154960;2597;164352;876458;876834;910336;1031418;879431;1074688;;;;;;
265354,481;156197;6876;164352;876834;877842;910336;1033031;884718;1074688;;;;;;
265401,175;160476;1712;164352;877842;879560;910336;1038318;881272;1074688;;;;;;
265414,920;155312;768;164352;879560;879880;910336;1034872;880648;1074688;;;;;;
265459,635;154319;704;164352;879881;880056;910336;1034200;880760;1074688;;;;;;
265939,755;154304;4979;164352;880056;880449;910336;1034360;885428;1074688;;;;;;
265980,809;158579;4606;164864;880449;880449;910336;1039028;885055;1075200;;;;;;
266004,364;159230;4773;164864;880449;880449;910336;1039679;885222;1075200;;;;;;
266020,207;159397;4423;165376;880449;880449;910336;1039846;884872;1075712;;;;;;
266045,988;160071;6886;162816;880449;881129;910336;1040520;888015;1073152;;;;;;
266058,140;162534;4741;165376;881129;881560;910336;1043663;886301;1075712;;;;;;
266064,161;159877;4965;164864;881560;882416;910336;1041437;887381;1075200;;;;;;
266080,006;160101;2128;165888;882416;883527;910336;1042517;885655;1076224;;;;;;
266084,395;158800;865;165888;883527;885280;910336;1042327;886145;1076224;;;;;;
266098,363;157537;4348;165888;885280;885552;910336;1042817;889900;1076224;;;;;;
266134,469;160648;3353;165888;885552;887057;910336;1046200;890410;1076224;;;;;;
266154,148;160025;4332;166912;887057;887130;910336;1047082;891462;1077248;;;;;;
266215,118;162540;4943;166400;887130;887650;910336;1049670;892593;1076736;;;;;;
266237,320;163151;4699;166912;887650;888306;910336;1050801;893005;1077248;;;;;;
266273,692;163419;4701;166912;888306;888981;910336;1051725;893682;1077248;;;;;;
266299,892;163421;2624;166912;888981;890119;910336;1052402;892743;1077248;;;;;;
266314,993;161344;3556;166912;890119;890526;910336;1051463;894082;1077248;;;;;;
266328,448;162276;1256;167424;890526;891718;910336;1052802;892974;1077760;;;;;;
266355,142;160991;5156;167424;891718;892190;910336;1052709;897346;1077760;;;;;;
266374,872;164900;3151;167424;892190;894029;910336;1057090;897180;1077760;;;;;;
266416,850;162895;4172;167424;894029;894893;910336;1056924;899065;1077760;;;;;;
266439,996;163916;2816;167936;894893;895173;910336;1058809;897989;1078272;;;;;;
266465,383;163072;512;167424;895173;896420;910336;1058245;896932;1077760;;;;;;
266479,145;160768;3186;167936;896420;896549;910336;1057188;899735;1078272;;;;;;
266545,047;163442;7148;167424;896549;897420;910336;1059991;904568;1077760;;;;;;
266556,107;167404;736;165376;897420;899669;910336;1064824;900405;1075712;;;;;;
266597,366;158432;3460;166400;899669;900014;910336;1058101;903474;1076736;;;;;;
266655,135;161156;1310;166912;900014;901302;910336;1061170;902612;1077248;;;;;;
266693,847;160030;5876;164864;901302;901820;910336;1061332;907696;1075200;;;;;;
266733,252;164596;4545;166912;901820;902885;910336;1066416;907430;1077248;;;;;;
266745,905;162753;4464;166400;902885;902884;910336;1065638;907348;1076736;;;;;;
266799,096;162672;3956;166912;902884;903476;910336;1065556;907432;1077248;;;;;;
266835,266;162676;3645;166912;903476;903476;910336;1066152;907121;1077248;;;;;;
266845,099;23863;2432;167424;903476;903476;910336;927339;905908;1077760;;;;;;
266845,119;2432;0;167424;903476;843225;910336;905908;843225;1077760;188013;185816;786432;1093921;1029041;1864192
266927,412;159744;5656;167424;843225;843225;910336;1002969;848881;1077760;;;;;;
266952,962;165400;2736;167424;843225;843225;910336;1008625;845961;1077760;;;;;;
266977,196;162480;2768;167424;843225;843225;910336;1005705;845993;1077760;;;;;;
267015,172;162512;4804;167424;843225;843225;910336;1005737;848029;1077760;;;;;;
267063,850;164548;4608;167424;843225;843225;910336;1007773;847833;1077760;;;;;;
267177,006;164352;7658;165376;843225;843594;910336;1007577;851252;1075712;;;;;;
267209,231;165354;5330;166400;843594;844306;910336;1008948;849636;1076736;;;;;;
267233,497;163026;4767;166912;844306;844306;910336;1007332;849073;1077248;;;;;;
267264,535;162975;6608;166400;844306;844306;910336;1007281;850914;1076736;;;;;;
267277,085;164816;5983;165376;844306;844306;910336;1009122;850289;1075712;;;;;;
267316,131;162655;4671;165888;844306;844858;910336;1006961;849529;1076224;;;;;;
267348,038;161343;5375;166400;844858;845354;910336;1006201;850729;1076736;;;;;;
267390,869;163071;8696;166400;845354;846536;910336;1008425;855232;1076736;;;;;;
267420,749;166392;6627;163328;846536;847496;910336;1012928;854123;1073664;;;;;;
267450,321;161136;7328;164864;847497;847496;910336;1008633;854824;1075200;;;;;;
267486,542;161952;6095;164864;847496;847496;910336;1009448;853591;1075200;;;;;;
267535,021;160719;7777;164864;847496;847496;910336;1008215;855273;1075200;;;;;;
267608,200;162401;7343;163840;847496;847496;910336;1009897;854839;1074176;;;;;;
267630,474;160943;8835;162816;847496;847497;910336;1008439;856332;1073152;;;;;;
267648,821;162435;10316;161792;847497;847496;910336;1009932;857812;1072128;;;;;;
267659,583;160844;9983;160768;847496;847665;910336;1008340;857648;1071104;;;;;;
267670,690;160511;10096;161280;847665;848360;910336;1008176;858456;1071616;;;;;;
267693,573;158576;9521;158208;848360;849048;910336;1006936;858569;1068544;;;;;;
267717,035;158001;8131;161792;849048;850496;910336;1007049;858627;1072128;;;;;;
267727,879;156099;7266;161280;850496;851225;910336;1006595;858491;1071616;;;;;;
267792,793;155234;6527;162816;851225;852433;910336;1006459;858960;1073152;;;;;;
267838,657;156514;8782;162304;852433;853522;910336;1008947;862304;1072640;;;;;;
267857,480;158798;6405;162816;853522;854378;910336;1012320;860783;1073152;;;;;;
267885,137;156933;4223;162816;854378;855489;910336;1011311;859712;1073152;;;;;;
267902,572;154751;3488;162816;855489;856501;910336;1010240;859989;1073152;;;;;;
267931,101;154016;4229;162816;856501;857625;910336;1010517;861854;1073152;;;;;;
267988,556;154757;3280;162816;857625;858072;910336;1012382;861352;1073152;;;;;;
268024,233;153808;2976;162816;858072;858072;910336;1011880;861048;1073152;;;;;;
268148,896;153504;6356;163328;858072;858073;910336;1011576;864429;1073664;;;;;;
268159,930;157396;6115;162816;858073;858073;910336;1015469;864188;1073152;;;;;;
268176,542;157155;6723;163840;858073;858777;910336;1015228;865500;1074176;;;;;;
268215,615;159299;6139;163840;858777;859169;910336;1018076;865308;1074176;;;;;;
268231,579;158715;3297;164352;859169;860690;910336;1017884;863987;1074688;;;;;;
268235,523;156897;4420;164352;860690;861877;910336;1017587;866297;1074688;;;;;;
268247,795;158020;1872;163840;861877;864159;910336;1019897;866031;1074176;;;;;;
268260,485;155472;3933;164352;864159;864980;910336;1019631;868913;1074688;;;;;;
268281,462;157533;5317;165376;864980;865824;910336;1022513;871141;1075712;;;;;;
268286,994;160453;1312;164864;865824;867650;910336;1026277;868962;1075200;;;;;;
268294,041;156448;1152;164864;867650;867866;910336;1024098;869018;1075200;;;;;;
268300,492;155776;2176;164864;867866;868210;910336;1023642;870386;1075200;;;;;;
268310,087;156800;3460;165376;868210;868983;910336;1025010;872443;1075712;;;;;;
268322,550;158596;4552;164864;868983;869678;910336;1027579;874230;1075200;;;;;;
268329,786;159688;1873;165888;869678;871247;910336;1029366;873120;1076224;;;;;;
268333,270;158545;3876;165888;871247;871753;910336;1029792;875629;1076224;;;;;;
268371,999;160548;960;166400;871753;873169;910336;1032301;874129;1076736;;;;;;
268467,119;158656;7583;165376;873169;873593;910336;1031825;881176;1075712;;;;;;
268495,192;165279;3476;165888;873593;876916;910336;1038872;880392;1076224;;;;;;
268518,913;159636;3252;165376;876916;877616;910336;1036552;880868;1075712;;;;;;
268555,576;159412;4036;166400;877616;878128;910336;1037028;882164;1076736;;;;;;
268574,052;161732;3987;166400;878128;878824;910336;1039860;882811;1076736;;;;;;
268606,031;161683;4821;166912;878824;879776;910336;1040507;884597;1077248;;;;;;
268619,629;163541;6064;166912;879776;880589;910336;1043317;886653;1077248;;;;;;
268627,847;164784;3775;166912;880589;881509;910336;1045373;885284;1077248;;;;;;
268652,264;162495;1565;166912;881509;882964;910336;1044004;884529;1077248;;;;;;
268680,562;160285;1152;166912;882964;883429;910336;1043249;884581;1077248;;;;;;
268714,664;159872;4516;166912;883429;883845;910336;1043301;888361;1077248;;;;;;
268740,150;163236;3679;167424;883845;884667;910336;1047081;888346;1077760;;;;;;
268759,208;162911;704;166912;884667;886339;910336;1047578;887043;1077248;;;;;;
268842,189;159936;2704;167424;886339;886651;910336;1046275;889355;1077760;;;;;;
268881,612;162448;5302;167424;886651;887301;910336;1049099;892603;1077760;;;;;;
268926,783;165046;2304;167424;887301;887300;910336;1052347;889604;1077760;;;;;;
268986,296;162048;2704;167424;887300;887300;910336;1049348;890004;1077760;;;;;;
269121,220;162448;3372;167936;887300;887301;910336;1049748;890673;1078272;;;;;;
269147,065;164140;6075;166912;887301;887301;910336;1051441;893376;1077248;;;;;;
269159,488;166843;3954;167424;887301;887300;910336;1054144;891254;1077760;;;;;;
269192,479;163698;2655;167424;887300;888389;910336;1050998;891044;1077760;;;;;;
269198,223;162399;2633;167936;888389;888676;910336;1050788;891309;1078272;;;;;;
269378,531;163401;2911;167936;888676;889372;910336;1052077;892283;1078272;;;;;;
269493,509;163679;2479;168448;889372;889532;910336;1053051;892011;1078784;;;;;;
269547,806;164271;896;168448;889532;891251;910336;1053803;892147;1078784;;;;;;
269585,965;162416;1663;168448;891251;891579;910336;1053667;893242;1078784;;;;;;
269613,396;163455;5112;166912;891579;891579;910336;1055034;896691;1077248;;;;;;
269649,988;166904;4701;167936;891579;891579;910336;1058483;896280;1078272;;;;;;
269664,273;165469;4886;165888;891579;891579;910336;1057048;896465;1076224;;;;;;
269675,987;165654;3151;167936;891579;891667;910336;1057233;894818;1078272;;;;;;
269695,190;163407;5971;167424;891667;891924;910336;1055074;897895;1077760;;;;;;
269711,957;166227;2544;167424;891924;893170;910336;1058151;895714;1077760;;;;;;
269777,561;162288;4007;167424;893170;894078;910336;1055458;898085;1077760;;;;;;
269872,157;163751;7160;164864;894078;894629;910336;1057829;901789;1075200;;;;;;
269940,934;164856;3859;166400;894629;896628;910336;1059485;900487;1076736;;;;;;
269984,466;161555;5000;166912;896628;896628;910336;1058183;901628;1077248;;;;;;
270051,924;163720;4689;166912;896628;896628;910336;1060348;901317;1077248;;;;;;
270078,072;163409;6958;165888;896628;896628;910336;1060037;903586;1076224;;;;;;
270115,733;164654;5539;166400;896628;896628;910336;1061282;902167;1076736;;;;;;
270136,187;163235;5104;166400;896628;896628;910336;1059863;901732;1076736;;;;;;
270173,077;162800;7059;164864;896628;896628;910336;1059428;903687;1075200;;;;;;
270198,281;164755;8798;163840;896628;896628;910336;1061383;905426;1074176;;;;;;
270238,792;163422;6511;164864;896628;896628;910336;1060050;903139;1075200;;;;;;
270273,270;161135;8227;163840;896628;896628;910336;1057763;904855;1074176;;;;;;
270309,206;161827;10725;164352;896628;897930;910336;1058455;908655;1074688;;;;;;
270315,097;164325;10737;159744;897930;899344;910336;1062255;910081;1070080;;;;;;
270327,730;159729;9475;158720;899344;900430;910336;1059073;909905;1069056;;;;;;
270367,402;158467;9772;159744;900430;901494;910336;1058897;911266;1070080;;;;;;
270398,346;155180;6047;160256;901494;902911;910336;1056674;908958;1070592;;;;;;
270409,928;151455;6111;161280;902911;903801;910336;1054366;909912;1071616;;;;;;
270426,633;153055;7604;160768;903801;905584;910336;1056856;913188;1071104;;;;;;
270448,458;141740;5071;162304;905584;906889;910336;1047324;911960;1072640;;;;;;
270448,479;5071;0;162304;906889;854141;910336;911960;854141;1072640;190696;185978;786432;1102656;1040119;1859072
270491,512;148992;928;161792;854141;854141;910336;1003133;855069;1072128;;;;;;
270496,296;149920;1344;160768;854141;854141;910336;1004061;855485;1071104;;;;;;
270507,831;148800;1870;161280;854141;854581;910336;1002941;856451;1071616;;;;;;
270512,571;149326;3267;161792;854581;855534;910336;1003907;858801;1072128;;;;;;
270565,898;151235;3796;161280;855534;856153;910336;1006769;859949;1071616;;;;;;
270652,136;151764;4560;163328;856153;856976;910336;1007917;861536;1073664;;;;;;
270752,428;155088;4489;162304;856976;857623;910336;1012064;862112;1072640;;;;;;
270836,484;155017;6152;163840;857623;858267;910336;1012640;864419;1074176;;;;;;
270860,238;158728;416;163840;858267;860411;910336;1016995;860827;1074176;;;;;;
270936,473;152992;5302;163840;860411;860635;910336;1013403;865937;1074176;;;;;;
270958,570;157878;2576;163840;860635;860636;910336;1018513;863212;1074176;;;;;;
270975,338;155152;5475;164352;860636;860636;910336;1015788;866111;1074688;;;;;;
271000,461;159075;7110;164352;860636;861389;910336;1019711;868499;1074688;;;;;;
271039,644;160710;5456;164352;861389;861717;910336;1022099;867173;1074688;;;;;;
271060,192;159056;4048;164352;861717;862551;910336;1020773;866599;1074688;;;;;;
271100,557;157648;3808;165376;862551;863326;910336;1020199;867134;1075712;;;;;;
271127,961;158944;6712;164864;863326;863522;910336;1022270;870234;1075200;;;;;;
271152,881;161848;4301;165376;863522;864324;910336;1025370;868625;1075712;;;;;;
271161,424;159437;7821;164864;864324;865099;910336;1023761;872920;1075200;;;;;;
271164,729;162957;5346;165376;865099;866330;910336;1028056;871676;1075712;;;;;;
271173,144;160482;2944;164864;866330;867436;910336;1026812;870380;1075200;;;;;;
271181,515;158080;1314;164352;867436;868980;910336;1025516;870294;1074688;;;;;;
271197,479;155938;5473;164864;868980;869212;910336;1024918;874685;1075200;;;;;;
271222,553;160097;1329;165376;869212;871573;910336;1029309;872902;1075712;;;;;;
271232,813;156977;3008;165376;871573;871996;910336;1028550;875004;1075712;;;;;;
271235,495;158656;736;165376;871996;873619;910336;1030652;874355;1075712;;;;;;
271242,790;156384;3901;165376;873619;873932;910336;1030003;877833;1075712;;;;;;
271258,447;159549;4232;166400;873932;875381;910336;1033481;879613;1076736;;;;;;
271266,318;161416;2096;165888;875381;877200;910336;1036797;879296;1076224;;;;;;
271276,961;159280;5076;166400;877200;878717;910336;1036480;883793;1076736;;;;;;
271294,503;162772;2384;166400;878717;879768;910336;1041489;882152;1076736;;;;;;
271299,750;159426;3697;166912;879768;880432;910336;1039194;884129;1077248;;;;;;
271323,478;162417;5010;166912;880432;881030;910336;1042849;886040;1077248;;;;;;
271340,406;163730;1397;166912;881030;882478;910336;1044760;883875;1077248;;;;;;
271359,288;160117;3232;166912;882478;882854;910336;1042595;886086;1077248;;;;;;
271369,962;161853;4755;167424;883503;883847;910336;1045356;888602;1077760;;;;;;
271379,311;164499;3687;167424;883849;885341;910336;1048348;889028;1077760;;;;;;
271396,421;163431;5364;166912;885341;886421;910336;1048772;891785;1077248;;;;;;
271417,757;165108;4530;167424;886421;888328;910336;1051529;892858;1077760;;;;;;
271438,188;164274;1153;167424;888328;889655;910336;1052602;890808;1077760;;;;;;
271442,696;160897;3998;167424;889655;890112;910336;1050552;894110;1077760;;;;;;
271476,584;163742;2928;167936;890112;891018;910336;1053854;893946;1078272;;;;;;
271487,282;163184;4849;167424;891018;891624;910336;1054202;896473;1077760;;;;;;
271493,934;165105;1703;167936;891624;893560;910336;1056729;895263;1078272;;;;;;
271505,963;162471;5124;166400;893560;894051;910336;1056031;899175;1076736;;;;;;
271539,141;165891;6588;166400;894050;894842;910336;1059941;901430;1076736;;;;;;
271570,087;165308;1393;166912;894842;896850;910336;1060150;898243;1077248;;;;;;
271589,940;160113;1136;166912;896850;897387;910336;1056963;898523;1077248;;;;;;
271603,836;159856;1264;166912;897387;897739;910336;1057243;899003;1077248;;;;;;
271648,697;159984;6101;165888;897739;898011;910336;1057723;904112;1076224;;;;;;
271696,149;163797;896;166400;898011;899916;910336;1061808;900812;1076736;;;;;;
271710,464;158592;1608;166400;899916;900312;910336;1058508;901920;1076736;;;;;;
271721,345;159304;2992;166400;900312;900720;910336;1059616;903712;1076736;;;;;;
271752,834;160688;5429;166912;900720;901247;910336;1061408;906676;1077248;;;;;;
271798,960;164149;2041;166912;901247;903143;910336;1065396;905184;1077248;;;;;;
271851,127;160761;3972;166912;903143;903709;910336;1063904;907681;1077248;;;;;;
271978,295;162692;4808;166912;903709;903709;910336;1066401;908517;1077248;;;;;;
272004,954;163528;7827;164864;903709;903709;910336;1067237;911536;1075200;;;;;;
272009,364;164499;4063;165888;903709;903709;910336;1068208;907772;1076224;;;;;;
272043,207;160735;3696;166912;903709;905034;910336;1064444;908730;1077248;;;;;;
272057,103;161904;5185;166400;905034;906034;910336;1066938;911219;1076736;;;;;;
272065,532;163393;2689;166912;906034;907749;910336;1069427;910438;1077248;;;;;;
272065,559;2689;0;166912;907749;867024;954880;910438;867024;1121792;189520;186003;786432;1099958;1053027;1908224
272097,578;158208;1558;166400;867024;867024;954880;1025232;868582;1121280;;;;;;
272116,623;159766;960;166912;867024;867916;954880;1026790;868876;1121792;;;;;;
272135,822;159680;4932;166912;867916;868380;954880;1027596;873312;1121792;;;;;;
272148,825;163652;5859;165888;868380;869034;954880;1032032;874893;1120768;;;;;;
272165,262;163555;4132;166400;869034;870317;954880;1032589;874449;1121280;;;;;;
272178,785;161828;4824;166912;870317;870745;954880;1032145;875569;1121792;;;;;;
272187,730;163544;5764;164864;870745;871811;954880;1034289;877575;1119744;;;;;;
272193,030;164484;3409;166912;871811;873044;954880;1036295;876453;1121792;;;;;;
272200,018;161617;5236;166400;873044;873836;954880;1034661;879072;1121280;;;;;;
272218,405;163444;4479;166912;873836;874806;954880;1037280;879285;1121792;;;;;;
272238,597;163199;3551;166912;874806;875911;954880;1038005;879462;1121792;;;;;;
272248,962;162271;3340;167424;875911;876582;954880;1038182;879922;1122304;;;;;;
272266,039;163084;6464;166400;876582;877121;954880;1039666;883585;1121280;;;;;;
272276,444;166208;4807;166912;877121;878386;954880;1043329;883193;1121792;;;;;;
272295,436;163527;4927;166912;878386;879589;954880;1041913;884516;1121792;;;;;;
272305,700;163647;4292;167424;879589;881121;954880;1043236;885413;1122304;;;;;;
272327,645;164036;3248;167424;881121;882296;954880;1045157;885544;1122304;;;;;;
272335,474;162992;832;167424;882296;884169;954880;1045288;885001;1122304;;;;;;
272343,488;160576;2304;167424;884169;884521;954880;1044745;886825;1122304;;;;;;
272368,792;162048;2576;167424;884521;885402;954880;1046569;887978;1122304;;;;;;
272394,935;162320;4676;167424;885402;886412;954880;1047722;891088;1122304;;;;;;
272405,286;164420;3999;167936;886412;887423;954880;1050832;891422;1122816;;;;;;
272418,281;164255;1056;167424;887423;889240;954880;1051678;890296;1122304;;;;;;
272440,447;161312;3389;167936;889240;889575;954880;1050552;892964;1122816;;;;;;
272454,387;164157;1008;167936;889575;891142;954880;1053732;892150;1122816;;;;;;
272477,945;161776;5485;166912;891142;891807;954880;1052918;897292;1121792;;;;;;
272488,516;165229;608;167424;891807;893547;954880;1057036;894155;1122304;;;;;;
272531,113;160352;3987;167424;893547;893924;954880;1053899;897911;1122304;;;;;;
272555,884;163731;2768;167424;893924;894891;954880;1057655;897659;1122304;;;;;;
272570,347;162512;1136;167936;894891;896608;954880;1057403;897744;1122816;;;;;;
272585,244;161904;3024;167936;896608;896920;954880;1058512;899944;1122816;;;;;;
272596,265;163792;1163;168448;896920;898629;954880;1060712;899792;1123328;;;;;;
272604,084;162955;4464;166400;898629;898781;954880;1061584;903245;1121280;;;;;;
272618,959;166256;5300;166912;898781;899864;954880;1065037;905164;1121792;;;;;;
272624,023;165044;4615;167424;899864;900595;954880;1064908;905210;1122304;;;;;;
272642,945;164192;1369;167424;900595;902387;954880;1064787;903756;1122304;;;;;;
272659,778;161113;4128;167424;902387;902547;954880;1063500;906675;1122304;;;;;;
272670,861;163872;3828;167936;902547;903586;954880;1066419;907414;1122816;;;;;;
272677,569;164084;736;167424;903586;905401;954880;1067670;906137;1122304;;;;;;
272683,672;160992;4096;167936;905401;905665;954880;1066393;909761;1122816;;;;;;
272697,161;164864;3088;167936;905665;906612;954880;1070529;909700;1122816;;;;;;
272726,169;163856;4692;167936;906612;907260;954880;1070468;911952;1122816;;;;;;
272754,764;165460;992;167936;907260;908828;954880;1072720;909820;1122816;;;;;;
272773,710;161760;4392;167936;908828;909356;954880;1070588;913748;1122816;;;;;;
272784,250;165160;4911;165888;909356;910235;954880;1074516;915146;1120768;;;;;;
272800,710;165679;3934;167936;910235;910845;954880;1075914;914779;1122816;;;;;;
272825,709;164190;1537;167424;910845;912974;954880;1075035;914511;1122304;;;;;;
272839,503;161793;4599;166912;912974;913334;954880;1074767;917933;1121792;;;;;;
272844,821;164343;6144;166400;913334;914238;954880;1077677;920382;1121280;;;;;;
272848,976;165887;1901;166912;914238;918554;954880;1080125;920455;1121792;;;;;;
272865,859;160621;1027;166912;918554;919210;954880;1079175;920237;1121792;;;;;;
272883,774;159747;5136;166912;919210;919451;954880;1078957;924587;1121792;;;;;;
272914,866;163856;1108;166912;919451;921453;954880;1083307;922561;1121792;;;;;;
272917,648;159828;3200;167424;921453;921848;954880;1081281;925048;1122304;;;;;;
272934,412;162432;991;166912;921848;923716;954880;1084280;924707;1121792;;;;;;
272970,160;160223;6357;165376;923716;924308;954880;1083939;930665;1120256;;;;;;
272979,583;164053;2148;166400;924308;926387;954880;1088361;928535;1121280;;;;;;
272986,335;159844;4261;166912;926387;927094;954880;1086231;931355;1121792;;;;;;
273008,671;162981;2928;166912;927094;927878;954880;1090075;930806;1121792;;;;;;
273021,614;161648;1288;167424;927878;929411;954880;1089526;930699;1122304;;;;;;
273049,874;161032;5140;165376;929411;930140;954880;1090443;935280;1120256;;;;;;
273074,169;164884;1152;167424;930140;932033;954880;1095024;933185;1122304;;;;;;
273096,165;160384;1056;166912;932033;932593;954880;1092417;933649;1121792;;;;;;
273109,572;160288;4580;167424;932593;933033;954880;1092881;937613;1122304;;;;;;
273127,925;164324;3104;167424;933033;934008;954880;1097357;937112;1122304;;;;;;
273147,201;162848;4564;167424;934008;934553;954880;1096856;939117;1122304;;;;;;
273180,778;164308;2136;167424;934553;936097;954880;1098861;938233;1122304;;;;;;
273194,224;161880;5356;166912;936097;936684;954880;1097977;942040;1121792;;;;;;
273210,680;165100;3648;167424;936684;937354;954880;1101784;941002;1122304;;;;;;
273226,757;163392;3076;167936;937354;938264;954880;1100746;941340;1122816;;;;;;
273250,452;163332;2304;167424;938264;938815;954880;1101596;941119;1122304;;;;;;
273293,841;162560;3024;168448;938815;939335;954880;1101375;942359;1123328;;;;;;
273311,498;164304;3104;167936;939335;940025;954880;1103639;943129;1122816;;;;;;
273333,834;164384;4718;167936;940025;940662;954880;1104409;945380;1122816;;;;;;
273352,474;166510;576;168448;940662;942366;954880;1107172;942942;1123328;;;;;;
273361,899;162368;4561;167424;942366;942495;954880;1104734;947056;1122304;;;;;;
273368,841;165329;1137;167936;942495;944423;954880;1107824;945560;1122816;;;;;;
273375,715;161905;3904;167936;944423;944990;954880;1106328;948894;1122816;;;;;;
273392,048;164672;2079;167936;944990;946837;954880;1109662;948916;1122816;;;;;;
273406,966;162847;3988;168448;946837;948265;954880;1109684;952253;1123328;;;;;;
273421,844;165780;544;168448;948265;950056;954880;1114045;950600;1123328;;;;;;
273447,880;162336;3280;168448;950056;950201;954880;1112392;953481;1123328;;;;;;
273472,629;165072;2784;168448;950201;951110;954880;1115273;953894;1123328;;;;;;
273484,667;164576;2380;168960;951110;951684;954880;1115686;954064;1123840;;;;;;
273497,495;165196;3395;168960;951684;951996;954880;1116880;955391;1123840;;;;;;
273531,165;166211;992;168960;951996;953460;954880;1118207;954452;1123840;;;;;;
273531,182;992;0;168960;953460;878777;965632;954452;878777;1134592;192541;186172;786432;1146993;1064949;1921024
273568,221;162816;3507;168960;878777;878778;965632;1041593;882285;1134592;;;;;;
273577,450;166323;3444;168960;878778;878777;965632;1045101;882221;1134592;;;;;;
273599,290;166260;3216;168960;878777;879884;965632;1045037;883100;1134592;;;;;;
273630,679;166032;4356;168448;879884;880116;965632;1045916;884472;1134080;;;;;;
273657,186;167172;3328;168960;880116;880116;965632;1047288;883444;1134592;;;;;;
273667,104;166144;3187;169472;880116;880116;965632;1046260;883303;1135104;;;;;;
273688,651;166515;3888;168960;880116;880465;965632;1046631;884353;1134592;;;;;;
273715,507;167216;2720;169472;880465;880849;965632;1047681;883569;1135104;;;;;;
273760,619;166560;3479;169472;880849;880849;965632;1047409;884328;1135104;;;;;;
273787,442;167319;3520;169472;880849;880849;965632;1048168;884369;1135104;;;;;;
273810,596;167360;4448;169472;880849;880849;965632;1048209;885297;1135104;;;;;;
273831,097;168288;4496;168448;880849;880850;965632;1049137;885346;1134080;;;;;;
273855,729;167312;6130;168960;880850;881654;965632;1048162;887784;1134592;;;;;;
273894,222;168946;4062;167936;881654;882126;965632;1050600;886188;1133568;;;;;;
273999,292;165854;4357;168448;882126;882126;965632;1047980;886483;1134080;;;;;;
274024,193;166149;6627;165376;882126;883305;965632;1048275;889932;1131008;;;;;;
274049,780;165347;8043;166912;883305;883473;965632;1048652;891516;1132544;;;;;;
274068,283;166763;7717;163840;883473;883474;965632;1050236;891191;1129472;;;;;;
274096,999;163365;8115;163840;883474;883473;965632;1046839;891588;1129472;;;;;;
274109,468;163763;8286;162816;883473;883474;965632;1047236;891760;1128448;;;;;;
274131,077;160862;9059;161792;883474;883929;965632;1044336;892988;1127424;;;;;;
274205,926;161635;7471;163328;883929;884705;965632;1045564;892176;1128960;;;;;;
274235,926;159023;10531;162304;884705;885367;965632;1043728;895898;1127936;;;;;;
274252,470;162083;6975;162816;885367;885366;965632;1047450;892341;1128448;;;;;;
274283,946;156991;7375;162304;885366;885382;965632;1042357;892757;1127936;;;;;;
274296,027;157391;8719;162816;885382;885382;965632;1042773;894101;1128448;;;;;;
274318,444;159247;9924;160768;885382;885486;965632;1044629;895410;1126400;;;;;;
274351,984;160452;9354;161792;885486;886421;965632;1045938;895775;1127424;;;;;;
274422,881;157834;9141;161792;886421;886925;965632;1044255;896066;1127424;;;;;;
274443,475;157621;10255;160768;886925;886924;965632;1044546;897179;1126400;;;;;;
274461,220;157711;11976;159744;886924;886925;965632;1044635;898901;1125376;;;;;;
274500,114;159432;8369;160768;886925;887301;965632;1046357;895670;1126400;;;;;;
274516,167;154289;8368;160256;887301;887301;965632;1041590;895669;1125888;;;;;;
274524,350;154288;8496;161792;887301;887709;965632;1041589;896205;1127424;;;;;;
274548,161;156464;13309;156672;887709;894818;965632;1044173;908127;1122304;;;;;;
274561,851;156669;9408;156160;894818;895760;965632;1051487;905168;1121792;;;;;;
274568,833;151744;9954;158720;895760;896313;965632;1047504;906267;1124352;;;;;;
274584,635;152172;10056;159744;896312;897144;965632;1048484;907200;1125376;;;;;;
274590,336;153928;8746;159232;897144;898154;965632;1051072;906900;1124864;;;;;;
274607,336;152618;6548;159744;898154;899098;965632;1050772;905646;1125376;;;;;;
274650,784;150932;5567;159744;899098;899513;965632;1050030;905080;1125376;;;;;;
274661,982;149951;4319;159744;899513;901045;965632;1049464;905364;1125376;;;;;;
274679,184;148703;7708;159744;901045;901830;965632;1049748;909538;1125376;;;;;;
274688,544;152092;6727;160768;901830;903069;965632;1053922;909796;1126400;;;;;;
274726,797;152647;4159;160256;903069;903365;965632;1055716;907524;1125888;;;;;;
274745,049;150079;3183;159744;903365;904578;965632;1053444;907761;1125376;;;;;;
274793,941;148591;3248;160256;904578;905632;965632;1053169;908880;1125888;;;;;;
274828,828;148656;4787;160768;905632;905721;965632;1054288;910508;1126400;;;;;;
274840,216;150707;6114;160256;905721;905721;965632;1056428;911835;1125888;;;;;;
274885,474;152034;7171;161792;905721;906960;965632;1057755;914131;1127424;;;;;;
274936,609;155139;2771;161280;906960;907568;965632;1062099;910339;1126912;;;;;;
274947,629;150739;1169;161792;907568;909409;965632;1058307;910578;1127424;;;;;;
274972,285;149649;9130;157696;909409;909761;965632;1059058;918891;1123328;;;;;;
275012,029;157610;928;161280;909761;911806;965632;1067371;912734;1126912;;;;;;
275058,555;148384;4590;161280;911806;912166;965632;1060190;916756;1126912;;;;;;
275068,492;152046;2336;161792;912166;912166;965632;1064212;914502;1127424;;;;;;
275103,411;150816;6659;161792;912166;912494;965632;1062982;919153;1127424;;;;;;
275181,702;155139;2832;162304;912494;912494;965632;1067633;915326;1127936;;;;;;
275191,741;152336;3219;162304;912494;912494;965632;1064830;915713;1127936;;;;;;
275255,490;152723;7087;162816;912494;912654;965632;1065217;919741;1128448;;;;;;
275316,438;157615;5124;162816;912654;912654;965632;1070269;917778;1128448;;;;;;
275354,872;155652;4881;163840;912654;912655;965632;1068306;917536;1129472;;;;;;
275382,523;156945;6246;163328;912655;912655;965632;1069600;918901;1128960;;;;;;
275394,285;158310;7587;163328;912655;912654;965632;1070965;920241;1128960;;;;;;
275423,440;160163;8490;161280;912654;912654;965632;1072817;921144;1126912;;;;;;
275458,410;161066;8265;162304;912654;912654;965632;1073720;920919;1127936;;;;;;
275497,645;158793;6479;162816;912654;912654;965632;1071447;919133;1128448;;;;;;
275534,003;157007;6623;163840;912654;912654;965632;1069661;919277;1129472;;;;;;
275547,388;158687;7359;163328;912654;912654;965632;1071341;920013;1128960;;;;;;
275575,651;159423;9556;161792;912654;913423;965632;1072077;922979;1127424;;;;;;
275597,619;160084;6060;162816;913423;914439;965632;1073507;920499;1128448;;;;;;
275621,242;156588;5582;163840;914439;914751;965632;1071027;920333;1129472;;;;;;
275636,053;157646;5710;163328;914751;914775;965632;1072397;920485;1128960;;;;;;
275646,251;157774;6128;164352;914775;915937;965632;1072549;922065;1129984;;;;;;
275673,117;159728;6964;164352;915937;916696;965632;1075665;923660;1129984;;;;;;
275708,992;160564;4771;164864;916696;917225;965632;1077260;921996;1130496;;;;;;
275723,248;159395;3996;164864;917225;917785;965632;1076620;921781;1130496;;;;;;
275738,487;158620;3862;164864;917785;918021;965632;1076405;921883;1130496;;;;;;
275748,260;158486;5652;164864;918021;918596;965632;1076507;924248;1130496;;;;;;
275781,206;160276;3952;165376;918596;919333;965632;1078872;923285;1131008;;;;;;
275888,361;159600;4660;165376;919333;919549;965632;1078933;924209;1131008;;;;;;
276075,865;160308;6531;165376;919549;919549;965632;1079857;926080;1131008;;;;;;
276149,643;162179;8141;163840;919549;919549;965632;1081728;927690;1129472;;;;;;
276205,184;163789;4506;165376;919549;919550;965632;1083338;924056;1131008;;;;;;
276282,806;159642;8686;163840;919550;919550;965632;1079192;928236;1129472;;;;;;
276309,470;163822;6192;164864;919550;919549;965632;1083372;925741;1130496;;;;;;
276322,326;160304;6102;164352;919549;919550;965632;1079853;925652;1129984;;;;;;
276333,647;160214;9700;161280;919550;922268;965632;1079764;931968;1126912;;;;;;
276362,785;161252;7898;163328;922268;922524;965632;1083520;930422;1128960;;;;;;
276376,626;159450;7524;163328;922524;922612;965632;1081974;930136;1128960;;;;;;
276393,891;159059;7718;163328;922611;923718;965632;1081670;931436;1128960;;;;;;
276589,403;159270;9406;162816;923718;924094;965632;1082988;933500;1128448;;;;;;
276649,025;160958;7854;163328;924094;924566;965632;1085052;932420;1128960;;;;;;
276801,646;159406;6785;163840;924566;924653;965632;1083972;931438;1129472;;;;;;
276835,081;158849;8837;163328;924653;924654;965632;1083502;933491;1128960;;;;;;
276911,396;160901;7776;163840;924654;924654;965632;1085555;932430;1129472;;;;;;
276949,849;159840;7923;163328;924654;924654;965632;1084494;932577;1128960;;;;;;
277013,690;159987;9011;163840;924654;924653;965632;1084641;933664;1129472;;;;;;
277069,945;161587;10421;163328;924653;924654;965632;1086240;935075;1128960;;;;;;
277096,485;162997;7713;163328;924654;925909;965632;1087651;933622;1128960;;;;;;
277128,551;159265;11746;163328;925909;926344;965632;1085174;938090;1128960;;;;;;
277133,240;31957;6959;161280;926344;927521;965632;958301;934480;1126912;;;;;;
277133,268;6959;0;161280;927521;871884;965632;934480;871884;1126912;191205;185822;786432;1125685;1057706;1913344
277155,398;149504;3070;152576;871884;871884;965632;1021388;874954;1118208;;;;;;
277251,191;152574;3995;161792;871884;871884;965632;1024458;875879;1127424;;;;;;
277283,363;152475;4628;161792;871884;871885;965632;1024359;876513;1127424;;;;;;
277314,704;153108;6527;162304;871885;871884;965632;1024993;878411;1127936;;;;;;
277336,933;155519;5827;161792;871884;871885;965632;1027403;877712;1127424;;;;;;
277342,718;154819;7407;163328;871885;871885;965632;1026704;879292;1128960;;;;;;
277381,679;158447;10310;161792;871885;871884;965632;1030332;882194;1127424;;;;;;
277391,199;161350;7184;162816;871884;871884;965632;1033234;879068;1128448;;;;;;
277401,237;157200;6431;162304;871884;871884;965632;1029084;878315;1127936;;;;;;
277409,867;156447;6399;163328;871884;871884;965632;1028331;878283;1128960;;;;;;
277418,291;157902;8586;163328;871884;871884;965632;1029786;880470;1128960;;;;;;
277477,650;160138;10500;162304;871884;872852;965632;1032022;883352;1127936;;;;;;
277686,998;161028;9575;160256;872852;873732;965632;1033880;883307;1125888;;;;;;
278114,525;160103;9578;162304;873732;874819;965632;1033835;884397;1127936;;;;;;
278205,501;159082;10842;160768;874819;874818;965632;1033901;885660;1126400;;;;;;
278239,941;160346;9619;161280;874818;874819;965632;1035164;884438;1126912;;;;;;
278271,873;157075;8623;161280;874819;874819;965632;1031894;883442;1126912;;;;;;
278299,463;156079;8207;162304;874819;874819;965632;1030898;883026;1127936;;;;;;
278419,418;157199;11731;160768;874819;874818;965632;1032018;886549;1126400;;;;;;
278569,286;160723;13471;159232;874818;874819;965632;1035541;888290;1124864;;;;;;
278588,145;158879;10161;160256;874819;874819;965632;1033698;884980;1125888;;;;;;
278604,629;155569;9390;160768;874819;875499;965632;1030388;884889;1126400;;;;;;
278610,054;155310;11604;160256;875499;875810;965632;1030809;887414;1125888;;;;;;
278775,401;157472;11546;160256;875811;876595;965632;1033283;888141;1125888;;;;;;
278920,366;156954;11749;157184;877178;878186;965632;1034132;889935;1122816;;;;;;
278972,416;157157;13601;158720;878190;879118;965632;1035347;892719;1124352;;;;;;
278987,842;156961;8901;159232;879118;879990;965632;1036079;888891;1124864;;;;;;
279025,317;152261;8686;159744;879990;880854;965632;1032251;889540;1125376;;;;;;
279250,071;152558;9550;159232;880854;881277;965632;1033412;890827;1124864;;;;;;
279263,995;153422;9286;160256;881277;881277;965632;1034699;890563;1125888;;;;;;
279280,422;154694;8270;160256;881277;881277;965632;1035971;889547;1125888;;;;;;
279437,638;153678;7822;160768;881277;881573;965632;1034955;889395;1126400;;;;;;
279707,870;154254;12208;158720;881573;881901;965632;1035827;894109;1124352;;;;;;
279735,341;158640;10707;160256;881901;882582;965632;1040541;893289;1125888;;;;;;
279751,468;156115;9347;160256;882582;883271;965632;1038697;892618;1125888;;;;;;
279767,521;154755;8558;160768;883271;883407;965632;1038026;891965;1126400;;;;;;
279783,238;154990;8846;160768;883407;883639;965632;1038397;892485;1126400;;;;;;
279887,929;155278;12603;160256;883639;884006;965632;1038917;896609;1125888;;;;;;
280464,104;159035;8761;160768;884006;884526;965632;1043041;893287;1126400;;;;;;
280595,059;155129;10286;160768;884526;884862;965632;1039655;895148;1126400;;;;;;
280620,388;156718;8293;160768;884862;885294;965632;1041580;893587;1126400;;;;;;
280651,930;154725;7266;161280;885294;885334;965632;1040019;892600;1126912;;;;;;
280736,119;60782;9357;161280;885334;885470;965632;946116;894827;1126912;;;;;;
280736,149;9357;0;161280;885470;872206;965632;894827;872206;1126912;186852;185937;786432;1081679;1058143;1913344
280895,348;147456;5470;160768;872206;872207;965632;1019662;877677;1126400;;;;;;
280934,714;152926;2642;150528;872207;872206;965632;1025133;874848;1116160;;;;;;
281098,971;150098;6062;160768;872206;872206;965632;1022304;878268;1126400;;;;;;
281112,477;152494;10097;160768;872206;872207;965632;1024700;882304;1126400;;;;;;
281136,708;156529;6596;160768;872207;872207;965632;1028736;878803;1126400;;;;;;
281175,421;153028;5247;160768;872207;872207;965632;1025235;877454;1126400;;;;;;
281236,739;151679;7167;161280;872207;872207;965632;1023886;879374;1126912;;;;;;
281251,315;154623;9699;161280;872207;872207;965632;1026830;881906;1126912;;;;;;
281307,379;157155;7873;161792;872207;872206;965632;1029362;880079;1127424;;;;;;
281356,160;155841;7393;161280;872206;872207;965632;1028047;879600;1126912;;;;;;
281475,312;155361;7960;162816;872207;872207;965632;1027568;880167;1128448;;;;;;
281555,482;157976;10843;162304;872207;872207;965632;1030183;883050;1127936;;;;;;
281572,500;160859;8161;162304;872207;872207;965632;1033066;880368;1127936;;;;;;
281656,588;157665;8978;162304;872207;872207;965632;1029872;881185;1127936;;;;;;
281764,854;158482;10988;160768;872207;872206;965632;1030689;883194;1126400;;;;;;
281777,372;159468;8399;161792;872206;872750;965632;1031674;881149;1127424;;;;;;
281952,880;156879;9264;162304;872750;872959;965632;1029629;882223;1127936;;;;;;
282012,877;158768;10619;162304;872959;873607;965632;1031727;884226;1127936;;;;;;
282052,166;160123;9493;162304;873607;874494;965632;1033730;883987;1127936;;;;;;
282062,408;158988;7822;162304;874494;874967;965632;1033482;882789;1127936;;;;;;
282228,244;157326;11972;161280;874967;875127;965632;1032293;887099;1126912;;;;;;
282268,043;160452;8527;161792;875127;875415;965632;1035579;883942;1127424;;;;;;
282514,243;157007;8606;162304;875415;876164;965632;1032422;884770;1127936;;;;;;
282553,598;157598;12780;161792;876164;876924;965632;1033762;889704;1127424;;;;;;
282585,326;161772;8144;160768;876924;877492;965632;1038696;885636;1126400;;;;;;
282602,417;155600;8174;161280;877492;877492;965632;1033092;885666;1126912;;;;;;
282643,911;155630;10369;161280;877492;877988;965632;1033122;888357;1126912;;;;;;
282697,834;157825;12009;159744;877988;878219;965632;1035813;890228;1125376;;;;;;
282752,123;159465;12048;159744;878219;878500;965632;1037684;890548;1125376;;;;;;
282798,875;157456;8239;160256;878500;879155;965632;1035956;887394;1125888;;;;;;
282842,910;153647;9354;160768;879155;879316;965632;1032802;888670;1126400;;;;;;
282868,323;155786;10755;160768;879316;879905;965632;1035102;890660;1126400;;;;;;
282893,133;156961;11991;160768;879906;880418;965632;1036867;892409;1126400;;;;;;
282913,965;158423;13645;160256;880418;880673;965632;1038841;894318;1125888;;;;;;
282919,711;160077;9442;159232;880673;881218;965632;1040750;890660;1124864;;;;;;
282929,302;153826;9029;159744;881218;881970;965632;1035044;890999;1125376;;;;;;
282948,282;153413;10467;160768;881970;883443;965632;1035383;893910;1126400;;;;;;
282957,843;156387;13540;159744;883443;883803;965632;1039830;897343;1125376;;;;;;
282975,892;159460;7870;159744;883803;885120;965632;1043263;892990;1125376;;;;;;
282988,750;152254;7183;159744;885120;885864;965632;1037374;893047;1125376;;;;;;
282993,612;151567;6111;159744;885864;886935;965632;1037431;893046;1125376;;;;;;
282997,827;150495;5631;150016;886935;888280;965632;1037430;893911;1115648;;;;;;
283010,329;150015;7791;159744;888280;888936;965632;1038295;896727;1125376;;;;;;
283070,885;151663;5635;159232;888936;890135;965632;1040599;895770;1124864;;;;;;
283122,958;149507;4160;159744;890135;890790;965632;1039642;894950;1125376;;;;;;
283132,863;148544;3984;159744;890790;891806;965632;1039334;895790;1125376;;;;;;
283184,408;148368;6014;160256;891806;893218;965632;1040174;899232;1125888;;;;;;
283353,430;150910;2274;159744;893218;894044;965632;1044128;896318;1125376;;;;;;
283393,757;147170;4803;160256;894044;894540;965632;1041214;899343;1125888;;;;;;
283404,040;149699;9106;159744;894540;894539;965632;1044239;903645;1125376;;;;;;
283412,321;154002;3856;160256;894539;895587;965632;1048541;899443;1125888;;;;;;
283418,710;149264;2545;160256;895587;897179;965632;1044851;899724;1125888;;;;;;
283429,827;147953;1024;160256;897179;897691;965632;1045132;898715;1125888;;;;;;
283445,253;146432;3169;160256;897691;897979;965632;1044123;901148;1125888;;;;;;
283459,039;148577;4323;161280;897979;898505;965632;1046556;902828;1126912;;;;;;
283489,644;151267;2949;160768;898505;899512;965632;1049772;902461;1126400;;;;;;
283516,251;149893;1408;161792;899512;901023;965632;1049405;902431;1127424;;;;;;
283592,810;149888;4710;161792;901023;901335;965632;1050911;906045;1127424;;;;;;
283616,061;153190;3960;163328;901335;902627;965632;1054525;906587;1128960;;;;;;
283639,437;155000;976;162816;902627;904203;965632;1057627;905179;1128448;;;;;;
283718,286;152000;3118;163840;904203;904203;965632;1056203;907321;1129472;;;;;;
283775,500;155182;6068;163328;904203;904204;965632;1059385;910272;1128960;;;;;;
283793,333;158132;6123;163840;904204;904203;965632;1062336;910326;1129472;;;;;;
283816,509;158699;7494;160256;904203;904363;965632;1062902;911857;1125888;;;;;;
283836,810;160070;6353;163328;904363;905019;965632;1064433;911372;1128960;;;;;;
283874,636;157905;6005;163328;905019;905859;965632;1062924;911864;1128960;;;;;;
283911,289;157557;5552;164352;905859;906371;965632;1063416;911923;1129984;;;;;;
283931,152;158640;4880;163840;906371;907180;965632;1065011;912060;1129472;;;;;;
283961,091;157968;4768;165376;907180;908147;965632;1065148;912915;1131008;;;;;;
284036,577;159904;1588;164864;908147;910740;965632;1068051;912328;1130496;;;;;;
284051,901;156724;866;164864;910740;911881;965632;1067464;912747;1130496;;;;;;
284091,213;155490;1970;164864;911881;912104;965632;1067371;914074;1130496;;;;;;
284114,948;156594;963;164864;912104;912472;965632;1068698;913435;1130496;;;;;;
284157,990;155587;1326;164864;912472;912641;965632;1068059;913967;1130496;;;;;;
284197,901;155950;1714;165376;912641;912640;965632;1068591;914354;1131008;;;;;;
284270,535;157362;4691;165376;912640;912641;965632;1070002;917332;1131008;;;;;;
284306,711;160339;4559;165888;912641;912641;965632;1072980;917200;1131520;;;;;;
284335,206;161231;6224;163328;912641;912641;965632;1073872;918865;1128960;;;;;;
284338,502;63761;4459;165888;912641;912641;965632;976402;917100;1131520;;;;;;
284338,534;4459;0;165888;912641;885873;965632;917100;885873;1131520;190312;185839;786432;1107412;1071712;1917952
284365,832;156160;2894;165376;885873;885873;965632;1042033;888767;1131008;;;;;;
284411,068;159054;6725;164864;885873;885873;965632;1044927;892598;1130496;;;;;;
284430,871;162373;4095;165376;885873;885874;965632;1048246;889969;1131008;;;;;;
284451,541;159743;4304;166400;885874;885873;965632;1045617;890177;1132032;;;;;;
284529,878;161488;7910;165376;885873;885873;965632;1047361;893783;1131008;;;;;;
284587,103;165094;5413;165376;885873;885873;965632;1050967;891286;1131008;;;;;;
284616,092;161061;8089;163840;885873;885874;965632;1046934;893963;1129472;;;;;;
284627,199;163737;6582;164864;885874;885873;965632;1049611;892455;1130496;;;;;;
284642,843;161206;7252;162304;885873;885874;965632;1047079;893126;1127936;;;;;;
284739,334;161876;10724;160768;885874;887448;965632;1047750;898172;1126400;;;;;;
284774,769;160740;7710;158208;887448;887448;965632;1048188;895158;1123840;;;;;;
284794,750;157726;11391;160256;887448;887448;965632;1045174;898839;1125888;;;;;;
284800,495;158847;9862;157696;887448;888992;965632;1046295;898854;1123328;;;;;;
284808,645;157318;9507;159744;888992;889648;965632;1046310;899155;1125376;;;;;;
284817,309;154915;8299;160256;889648;890836;965632;1044563;899135;1125888;;;;;;
284826,281;153707;7708;161280;890836;892043;965632;1044543;899751;1126912;;;;;;
284830,373;154652;10513;160768;892043;893314;965632;1046695;903827;1126400;;;;;;
284843,413;157457;7700;161280;893314;893938;965632;1050771;901638;1126912;;;;;;
284863,456;154644;6182;160768;893938;895169;965632;1048582;901351;1126400;;;;;;
284874,815;153126;4256;161792;895169;896432;965632;1048295;900688;1127424;;;;;;
284881,337;152736;4592;161792;896432;897140;965632;1049168;901732;1127424;;;;;;
284893,382;153072;3712;161792;897140;898393;965632;1050212;902105;1127424;;;;;;
284913,473;152192;4692;161792;898393;899688;965632;1050585;904380;1127424;;;;;;
284916,720;153172;944;161280;899688;901280;965632;1052860;902224;1126912;;;;;;
284946,279;149424;4692;161792;901280;901752;965632;1050704;906444;1127424;;;;;;
284985,990;153172;3040;162816;901752;902432;965632;1054924;905472;1128448;;;;;;
285089,273;153042;3766;162304;902432;902776;965632;1055474;906542;1127936;;;;;;
285244,119;153537;7570;162816;902776;903842;965632;1056313;911412;1128448;;;;;;
285284,270;158098;5345;162816;903842;905057;965632;1061940;910402;1128448;;;;;;
285292,574;155873;4725;163840;905057;905058;965632;1060930;909783;1129472;;;;;;
285309,733;156789;704;163328;905058;907704;965632;1061847;908408;1128960;;;;;;
285340,270;152768;2912;163840;907704;907888;965632;1060472;910800;1129472;;;;;;
285355,922;155488;2912;163840;907888;908417;965632;1063376;911329;1129472;;;;;;
285497,200;155488;5107;164352;908417;909059;965632;1063905;914166;1129984;;;;;;
285535,017;158707;8175;161792;909059;909059;965632;1067766;917234;1127424;;;;;;
285553,016;161775;6660;163840;909059;909059;965632;1070834;915719;1129472;;;;;;
285567,596;159236;4846;163840;909059;909059;965632;1068295;913905;1129472;;;;;;
285575,422;157422;5150;164864;909059;909059;965632;1066481;914209;1130496;;;;;;
285594,029;159262;4287;164352;909059;911018;965632;1068321;915305;1129984;;;;;;
285618,502;158399;2867;165376;911018;912106;965632;1069417;914973;1131008;;;;;;
285715,654;158515;4016;165376;912106;912273;965632;1070621;916289;1131008;;;;;;
285756,635;159664;6968;164864;912273;912274;965632;1071937;919242;1130496;;;;;;
285768,543;162616;8835;164864;912274;912273;965632;1074890;921108;1130496;;;;;;
285781,974;164483;5472;164864;912273;912799;965632;1076756;918271;1130496;;;;;;
285798,850;160096;5071;164864;912799;913031;965632;1072895;918102;1130496;;;;;;
285813,220;159695;5525;165376;913031;913855;965632;1072726;919380;1131008;;;;;;
285831,339;161173;6416;165376;913855;914645;965632;1075028;921061;1131008;;;;;;
285846,065;162064;6918;165376;914645;915349;965632;1076709;922267;1131008;;;;;;
285851,421;162566;5141;165376;915349;915876;965632;1077915;921017;1131008;;;;;;
285860,369;160789;4647;165888;915876;917349;965632;1076665;921996;1131520;;;;;;
285876,777;161319;7273;164352;917349;918062;965632;1078668;925335;1129984;;;;;;
285887,116;163945;4515;165888;918062;919368;965632;1082007;923883;1131520;;;;;;
285900,734;160675;1520;165376;919368;921271;965632;1080043;922791;1131008;;;;;;
285907,591;157680;3855;165888;921271;921711;965632;1078951;925566;1131520;;;;;;
285914,794;160015;4780;165376;921711;922643;965632;1081726;927423;1131008;;;;;;
285920,711;160940;1024;165888;922643;924364;965632;1083583;925388;1131520;;;;;;
285937,202;157696;8419;165376;924364;924771;965632;1082060;933190;1131008;;;;;;
285951,580;165091;3584;164352;924771;925955;965632;1089862;929539;1129984;;;;;;
285978,635;158208;4102;164864;925955;926794;965632;1084163;930896;1130496;;;;;;
286047,453;158726;5269;165888;926794;927409;965632;1085520;932678;1131520;;;;;;
286075,105;161429;640;165376;927409;929532;965632;1088838;930172;1131008;;;;;;
286105,246;156800;864;165376;929532;929700;965632;1086332;930564;1131008;;;;;;
286188,923;156512;6995;162816;929700;929964;965632;1086212;936959;1128448;;;;;;
286242,478;162643;6434;163840;929964;929964;965632;1092607;936398;1129472;;;;;;
286253,645;160034;4461;164352;929964;929964;965632;1089998;934425;1129984;;;;;;
286264,209;158061;5423;165376;929964;931323;965632;1088025;936746;1131008;;;;;;
286270,417;161071;4452;165376;931323;932130;965632;1092394;936582;1131008;;;;;;
286277,379;160100;5004;165888;932130;933390;965632;1092230;938394;1131520;;;;;;
286301,024;161672;1535;165888;933390;934878;965632;1095062;936413;1131520;;;;;;
286309,334;158207;4067;166400;934878;935389;965632;1093085;939456;1132032;;;;;;
286425,984;161251;5623;165888;935389;935998;965632;1096640;941621;1131520;;;;;;
286450,045;162807;4227;166912;935998;937176;965632;1098805;941403;1132544;;;;;;
286464,073;162435;576;166400;937176;938903;965632;1099611;939479;1132032;;;;;;
286477,933;158784;3564;166912;938903;939136;965632;1097687;942700;1132544;;;;;;
286501,372;161772;1264;166400;939136;940929;965632;1100908;942193;1132032;;;;;;
286514,622;159472;5285;165888;940929;941281;965632;1100401;946566;1131520;;;;;;
286650,200;162981;3651;166400;941281;942033;965632;1104262;945684;1132032;;;;;;
286684,029;161347;5859;165888;942033;942633;965632;1103380;948492;1131520;;;;;;
286694,475;163555;5185;166400;942633;942633;965632;1106188;947818;1132032;;;;;;
286701,843;162881;3440;166912;942633;943400;965632;1105514;946840;1132544;;;;;;
286719,748;161648;896;166400;943400;945248;965632;1105048;946144;1132032;;;;;;
286729,960;159104;3392;166912;945248;945544;965632;1104352;948936;1132544;;;;;;
286840,976;162112;4856;166912;945544;946577;965632;1107656;951433;1132544;;;;;;
286867,432;163576;7202;165888;946577;947709;965632;1110153;954911;1131520;;;;;;
286905,458;164898;2035;166400;947709;949801;965632;1112607;951836;1132032;;;;;;
286920,593;159731;4646;166400;949801;949801;965632;1109532;954447;1132032;;;;;;
286926,837;162342;4772;166400;949801;950265;965632;1112143;955037;1132032;;;;;;
286931,140;162468;2668;166912;950265;951721;965632;1112733;954389;1132544;;;;;;
286955,830;161388;6281;165376;951721;952385;965632;1113109;958666;1131008;;;;;;
286967,430;165001;2333;166400;952385;955061;965632;1117386;957394;1132032;;;;;;
286980,352;160029;5911;166400;955061;955518;965632;1115090;961429;1132032;;;;;;
286984,031;163607;5606;166400;955518;956516;965632;1119125;962122;1132032;;;;;;
286990,976;163302;4548;166400;956516;957632;965632;1119818;962180;1132032;;;;;;
286997,696;162244;5569;166400;957632;958399;965632;1119876;963968;1132032;;;;;;
287002,991;163265;4158;166400;958399;959207;965632;1121664;963365;1132032;;;;;;
287008,628;161854;3680;166912;959207;960063;965632;1121061;963743;1132544;;;;;;
287016,837;162400;1488;166912;960063;961844;965632;1122463;963332;1132544;;;;;;
287020,495;160208;4272;167424;961844;962716;965632;1122052;966988;1133056;;;;;;
287024,211;163504;5096;166912;962716;963896;965632;1126220;968992;1132544;;;;;;
287024,228;5096;0;166912;963896;908842;994304;968992;908842;1161216;191871;185894;786432;1160863;1094736;1947648
287045,575;159232;4000;167424;908842;908842;994304;1068074;912842;1161728;;;;;;
287053,721;163744;1506;167424;908842;910261;994304;1072586;911767;1161728;;;;;;
287059,262;161250;4188;167424;910261;910605;994304;1071511;914793;1161728;;;;;;
287070,793;163932;5629;167424;910605;911328;994304;1074537;916957;1161728;;;;;;
287083,971;165373;4036;167424;911328;912321;994304;1076701;916357;1161728;;;;;;
287105,095;163780;928;167424;912321;913824;994304;1076101;914752;1161728;;;;;;
287124,115;160672;832;167424;913824;914192;994304;1074496;915024;1161728;;;;;;
287131,364;160576;963;167424;914192;914652;994304;1074768;915615;1161728;;;;;;
287149,641;160707;3232;167936;914652;914885;994304;1075359;918117;1162240;;;;;;
287198,636;163488;7164;167424;914885;915975;994304;1078373;923139;1161728;;;;;;
287240,170;167420;7666;162816;915975;917836;994304;1083395;925502;1157120;;;;;;
287252,923;162802;1472;156672;917836;920390;994304;1080638;921862;1150976;;;;;;
287262,735;156608;2224;164864;920390;921326;994304;1076998;923550;1159168;;;;;;
287273,758;156848;947;164864;921326;922389;994304;1078174;923336;1159168;;;;;;
287295,004;155571;5536;164864;922389;922806;994304;1077960;928342;1159168;;;;;;
287302,120;160160;2962;164864;922806;923981;994304;1082966;926943;1159168;;;;;;
287311,330;157586;3924;165888;923981;924526;994304;1081567;928450;1160192;;;;;;
287328,140;160084;4067;165376;924526;925110;994304;1084610;929177;1159680;;;;;;
287363,195;160178;8702;160256;925109;929575;994304;1085287;938277;1154560;;;;;;
287488,568;160254;4388;163328;929575;931134;994304;1089829;935522;1157632;;;;;;
287619,803;155940;4452;164352;931134;932028;994304;1087074;936480;1158656;;;;;;
287692,457;157540;3871;163840;932028;932027;994304;1089568;935898;1158144;;;;;;
287716,211;156959;4755;165376;932027;932028;994304;1088986;936783;1159680;;;;;;
287756,445;159891;5151;164864;932028;932027;994304;1091919;937178;1159168;;;;;;
287778,011;108612;9208;162816;932027;932683;994304;1040639;941891;1157120;;;;;;
287778,041;9208;0;162816;932683;909370;994304;941891;909370;1157120;188913;186066;786432;1130804;1095436;1943552
287896,154;153600;4047;164352;909370;909371;994304;1062970;913418;1158656;;;;;;
287941,141;157647;4339;164864;909371;909371;994304;1067018;913710;1159168;;;;;;
287955,624;158451;3151;164352;909371;909371;994304;1067822;912522;1158656;;;;;;
288017,113;157263;6691;164352;909371;909371;994304;1066634;916062;1158656;;;;;;
288066,337;161315;6388;164864;909371;909371;994304;1070686;915759;1159168;;;;;;
288084,313;161012;5956;164864;909371;909371;994304;1070383;915327;1159168;;;;;;
288093,257;160580;5819;164864;909371;909371;994304;1069951;915190;1159168;;;;;;
288126,006;160443;9644;163328;909371;909371;994304;1069814;919015;1157632;;;;;;
288172,931;163244;7699;161792;909371;909371;994304;1072615;917070;1156096;;;;;;
288193,268;161299;7135;163840;909371;909371;994304;1070670;916506;1158144;;;;;;
288220,981;159711;6606;163840;909371;909771;994304;1069082;916377;1158144;;;;;;
288233,740;159182;8375;163328;909771;909770;994304;1068953;918145;1157632;;;;;;
288262,717;160951;9310;162304;909770;910411;994304;1070721;919721;1156608;;;;;;
288281,036;161886;9119;162304;910411;910570;994304;1072297;919689;1156608;;;;;;
288347,089;159647;10482;161280;910570;911226;994304;1070217;921708;1155584;;;;;;
288368,344;161010;8767;161792;911226;911227;994304;1072236;919994;1156096;;;;;;
288390,983;157247;8719;161792;911227;911882;994304;1068474;920601;1156096;;;;;;
288400,918;157199;8838;161792;911882;912026;994304;1069081;920864;1156096;;;;;;
288417,777;157318;11511;160256;912026;912998;994304;1069344;924509;1154560;;;;;;
288435,331;159991;9136;161280;912998;914077;994304;1072989;923213;1155584;;;;;;
288451,610;156592;6943;161280;914077;914622;994304;1070669;921565;1155584;;;;;;
288471,211;154399;6975;161792;914622;915835;994304;1069021;922810;1156096;;;;;;
288498,945;155455;6628;161792;915835;917259;994304;1071290;923887;1156096;;;;;;
288512,609;155108;4368;162304;917259;918345;994304;1072367;922713;1156608;;;;;;
288620,616;153872;4834;162304;918345;919433;994304;1072217;924267;1156608;;;;;;
288632,961;154338;4810;162304;919433;919529;994304;1073771;924339;1156608;;;;;;
288639,244;154314;7629;162304;919529;920315;994304;1073843;927944;1156608;;;;;;
288650,072;157133;5617;162816;920315;921003;994304;1077448;926620;1157120;;;;;;
288660,971;156145;7693;162816;921003;921762;994304;1077148;929455;1157120;;;;;;
288671,394;158221;7031;163840;921762;922690;994304;1079983;929721;1158144;;;;;;
288680,212;159095;1952;163328;922690;925453;994304;1081785;927405;1157632;;;;;;
288686,311;154016;3014;163328;925453;925685;994304;1079469;928699;1157632;;;;;;
288694,401;154566;1138;153088;925685;926982;994304;1080251;928120;1147392;;;;;;
288698,786;152690;997;162816;926982;927525;994304;1079672;928522;1157120;;;;;;
288706,454;151525;3502;162816;927525;927789;994304;1079050;931291;1157120;;;;;;
288719,239;154030;928;163328;927789;929487;994304;1081819;930415;1157632;;;;;;
288726,937;152480;832;163328;929487;929775;994304;1081967;930607;1157632;;;;;;
288735,894;152384;2896;163840;929775;930063;994304;1082159;932959;1158144;;;;;;
288756,777;154960;2933;163328;930394;932138;994304;1085354;935071;1157632;;;;;;
288806,133;154997;3759;164864;932144;933181;994304;1087141;936940;1159168;;;;;;
288828,979;157871;3443;164352;933181;933780;994304;1091052;937223;1158656;;;;;;
288855,724;157555;5235;165376;933780;934292;994304;1091335;939527;1159680;;;;;;
288874,426;160883;592;165376;934292;936451;994304;1095175;937043;1159680;;;;;;
288881,084;156240;4465;165888;936451;936723;994304;1092691;941188;1160192;;;;;;
288899,877;160625;7908;164352;936723;937155;994304;1097348;945063;1158656;;;;;;
288949,886;164068;672;164864;937155;939394;994304;1101223;940066;1159168;;;;;;
288961,121;155296;833;164864;939394;939755;994304;1094690;940588;1159168;;;;;;
288987,201;155457;720;164864;939755;939946;994304;1095212;940666;1159168;;;;;;
289016,017;155344;1046;164864;939946;940282;994304;1095290;941328;1159168;;;;;;
289080,398;155670;3328;165888;940282;940490;994304;1095952;943818;1160192;;;;;;
289108,885;159488;2752;165376;940490;940491;994304;1099978;943243;1159680;;;;;;
289142,946;158912;3071;166912;940491;940491;994304;1099403;943562;1161216;;;;;;
289166,274;161279;6820;165376;940491;940491;994304;1101770;947311;1159680;;;;;;
289188,505;165028;4755;165888;940491;940491;994304;1105519;945246;1160192;;;;;;
289234,155;161427;5379;165888;940491;940491;994304;1101918;945870;1160192;;;;;;
289249,676;162051;8243;163840;940491;940491;994304;1102542;948734;1158144;;;;;;
289277,780;162867;5487;164864;940491;940491;994304;1103358;945978;1159168;;;;;;
289304,412;160111;7363;163840;940491;940491;994304;1100602;947854;1158144;;;;;;
289313,280;160963;6578;164352;940491;940491;994304;1101454;947069;1158656;;;;;;
289332,145;160178;5679;164352;940491;941402;994304;1100669;947081;1158656;;;;;;
289336,738;159279;9744;163840;941402;942209;994304;1100681;951953;1158144;;;;;;
289355,965;163344;5130;163840;942209;942993;994304;1105553;948123;1158144;;;;;;
289398,479;157706;8574;161280;942993;943969;994304;1100699;952543;1155584;;;;;;
289424,891;161150;4853;163840;943969;944650;994304;1105119;949503;1158144;;;;;;
289445,223;156917;4838;163328;944650;945791;994304;1101567;950629;1157632;;;;;;
289533,336;156902;7812;163840;945791;946727;994304;1102693;954539;1158144;;;;;;
289567,422;160388;3441;163840;946727;946919;994304;1107115;950360;1158144;;;;;;
289587,188;155813;5164;164352;946918;947223;994304;1102731;952387;1158656;;;;;;
289635,192;158252;4195;163840;947223;947223;994304;1105475;951418;1158144;;;;;;
289643,651;157283;6905;163840;947223;947223;994304;1104506;954128;1158144;;;;;;
289672,467;160505;4387;164352;947223;948510;994304;1107728;952897;1158656;;;;;;
289682,851;157987;5507;165376;948510;948830;994304;1106497;954337;1159680;;;;;;
289694,301;160643;3167;164864;948830;949398;994304;1109473;952565;1159168;;;;;;
289707,870;158303;1088;164352;949398;951665;994304;1107701;952753;1158656;;;;;;
289713,328;155712;946;164864;951665;952321;994304;1107377;953267;1159168;;;;;;
289737,348;155570;4837;165376;952321;952489;994304;1107891;957326;1159680;;;;;;
289745,484;159968;6314;164864;952489;953494;994304;1112457;959808;1159168;;;;;;
289753,679;161450;4432;165376;953494;954577;994304;1114944;959009;1159680;;;;;;
289760,972;159568;3522;164864;954577;955491;994304;1114145;959013;1159168;;;;;;
289775,250;158658;1665;165888;955491;957203;994304;1114149;958868;1160192;;;;;;
289777,008;158337;2946;165888;957203;957627;994304;1115540;960573;1160192;;;;;;
289785,216;159618;7283;164864;957627;958452;994304;1117245;965735;1159168;;;;;;
289791,417;162931;4149;165376;958452;960954;994304;1121383;965103;1159680;;;;;;
289801,456;159797;7369;164864;960954;961421;994304;1120751;968790;1159168;;;;;;
289807,991;163017;3520;165376;961421;962557;994304;1124438;966077;1159680;;;;;;
289819,601;159168;1728;165376;962557;964670;994304;1121725;966398;1159680;;;;;;
289824,736;157376;5292;165376;964670;965310;994304;1122046;970602;1159680;;;;;;
289828,013;160940;800;165376;965310;967869;994304;1126250;968669;1159680;;;;;;
289841,355;156448;1888;165376;967869;968173;994304;1124317;970061;1159680;;;;;;
289857,057;157536;5375;164864;968173;969509;994304;1125709;974884;1159168;;;;;;
289881,072;161023;5375;165376;969509;970147;994304;1130532;975522;1159680;;;;;;
289889,121;161023;6972;163840;970147;970994;994304;1131170;977966;1158144;;;;;;
289932,053;161596;5712;164864;970994;972974;994304;1132590;978686;1159168;;;;;;
289950,958;160336;1464;165376;972974;974819;994304;1133310;976283;1159680;;;;;;
289956,354;157112;992;165376;974819;975291;994304;1131931;976283;1159680;;;;;;
289977,803;156640;7584;163328;975291;975660;994304;1131931;983244;1157632;;;;;;
289990,237;161184;6666;160768;975660;977227;994304;1136844;983893;1155072;;;;;;
289996,075;160266;3136;164352;977227;979067;994304;1137493;982203;1158656;;;;;;
290033,928;156224;5173;163840;979067;981679;994304;1135291;986852;1158144;;;;;;
290062,229;158261;5575;164864;981679;982739;994304;1139940;988314;1159168;;;;;;
290076,272;160199;1341;164864;982739;984480;994304;1142938;985821;1159168;;;;;;
290085,113;155965;1088;164864;984480;984952;994304;1140445;986040;1159168;;;;;;
290103,095;155712;1120;164864;984952;985184;994304;1140664;986304;1159168;;;;;;
290107,210;155744;2516;165376;985184;985576;994304;1140928;988092;1159680;;;;;;
290115,951;157652;3356;164864;985576;986024;994304;1143228;989380;1159168;;;;;;
290145,627;158492;2736;166400;986024;986728;994304;1144516;989464;1160704;;;;;;
290177,755;159920;4689;165888;986728;987809;994304;1146648;992498;1160192;;;;;;
290215,359;161873;5143;166400;987809;988537;994304;1149682;993680;1160704;;;;;;
290224,223;162839;4313;166400;988537;989745;994304;1151376;994058;1160704;;;;;;
290260,687;162009;2002;166912;989745;991424;994304;1151754;993426;1161216;;;;;;
290280,816;160210;897;166400;991424;991824;994304;1151634;992721;1160704;;;;;;
290280,831;897;0;166400;991824;918147;1003008;992721;918147;1169408;190091;186240;786432;1182812;1104387;1955840
290322,934;158208;1864;166912;918147;918148;1003008;1076355;920012;1169920;;;;;;
290339,274;160584;928;166912;918148;919660;1003008;1078732;920588;1169920;;;;;;
290355,346;159622;6369;165888;919660;920229;1003008;1079282;926598;1168896;;;;;;
290383,831;164065;6276;164352;920229;921126;1003008;1084294;927402;1167360;;;;;;
290391,411;163972;6147;164864;921126;921126;1003008;1085098;927273;1167872;;;;;;
290395,711;161795;4019;165376;921126;922934;1003008;1082921;926953;1168384;;;;;;
290407,062;159667;5932;164864;922934;923701;1003008;1082601;929633;1167872;;;;;;
290429,259;161580;5029;165376;923701;924544;1003008;1085281;929573;1168384;;;;;;
290445,107;160677;3775;166400;924544;925120;1003008;1085221;928895;1169408;;;;;;
290462,189;160959;3123;165888;925120;925836;1003008;1086079;928959;1168896;;;;;;
290479,797;160307;3992;166912;925836;926283;1003008;1086143;930275;1169920;;;;;;
290490,358;162200;5075;166400;926283;926715;1003008;1088483;931790;1169408;;;;;;
290494,763;163283;4340;167424;926715;927916;1003008;1089998;932256;1170432;;;;;;
290511,840;163572;3152;166912;927916;928147;1003008;1091488;931299;1169920;;;;;;
290531,969;162384;1056;167424;928147;929933;1003008;1090531;930989;1170432;;;;;;
290540,574;160800;4879;167424;929933;930093;1003008;1090733;934972;1170432;;;;;;
290619,099;164623;6947;165376;930093;930831;1003008;1094716;937778;1168384;;;;;;
290662,203;164643;1180;166400;930831;932918;1003008;1095474;934098;1169408;;;;;;
290666,241;158876;5464;166400;932918;933198;1003008;1091794;938662;1169408;;;;;;
290681,977;163160;6145;164352;933198;935802;1003008;1096358;941947;1167360;;;;;;
290728,108;163841;1397;165888;935802;937971;1003008;1099643;939368;1168896;;;;;;
290745,281;158069;4740;165888;937971;938259;1003008;1096040;942999;1168896;;;;;;
290769,458;161320;2193;166400;938421;940426;1003008;1099741;942619;1169408;;;;;;
290786,388;159377;3554;165888;940431;941065;1003008;1099808;944619;1168896;;;;;;
290801,469;160738;800;165888;941065;942971;1003008;1101803;943771;1168896;;;;;;
290809,211;158496;3876;166400;942971;943179;1003008;1101467;947055;1169408;;;;;;
290821,972;161572;6316;165888;943179;943724;1003008;1104751;950040;1168896;;;;;;
290836,867;164012;3990;166400;943724;944588;1003008;1107736;948578;1169408;;;;;;
290964,755;161686;3107;166912;944588;945244;1003008;1106274;948351;1169920;;;;;;
290988,002;161827;2432;166912;945244;945923;1003008;1107071;948355;1169920;;;;;;
291013,598;161152;3620;167424;945923;946403;1003008;1107075;950023;1170432;;;;;;
291032,175;163364;3060;167424;946403;947067;1003008;1109767;950127;1170432;;;;;;
291072,057;162804;2256;167936;947067;947457;1003008;1109871;949713;1170944;;;;;;
291102,905;163024;4720;167936;947457;947458;1003008;1110481;952178;1170944;;;;;;
291114,131;165488;4143;167936;947458;947458;1003008;1112946;951601;1170944;;;;;;
291124,596;164911;3313;167936;947458;948034;1003008;1112369;951347;1170944;;;;;;
291130,191;164081;1536;168448;948034;949801;1003008;1112115;951337;1171456;;;;;;
291140,867;163328;3120;168448;949801;950481;1003008;1113129;953601;1171456;;;;;;
291152,375;164912;6651;165376;950481;952149;1003008;1115393;958800;1168384;;;;;;
291170,495;165371;6748;165888;952149;953087;1003008;1117520;959835;1168896;;;;;;
291182,598;165468;7740;164352;953087;954250;1003008;1118555;961990;1167360;;;;;;
291203,044;163388;3611;165376;954250;955085;1003008;1117638;958696;1168384;;;;;;
291216,475;159259;2838;165888;955085;955747;1003008;1114344;958585;1168896;;;;;;
291221,174;159510;6435;163328;955747;956164;1003008;1115257;962599;1166336;;;;;;
291224,442;163107;4353;165888;956164;957347;1003008;1119271;961700;1168896;;;;;;
291233,754;160513;3520;165376;957347;958388;1003008;1117860;961908;1168384;;;;;;
291244,820;159680;5231;166400;958388;958901;1003008;1118068;964132;1169408;;;;;;
291275,251;162927;5576;166400;958901;960198;1003008;1121828;965774;1169408;;;;;;
291284,746;163272;864;166400;960198;962237;1003008;1123470;963101;1169408;;;;;;
291293,551;158560;1332;159232;962237;962405;1003008;1120797;963737;1162240;;;;;;
291306,333;159028;4179;166400;962405;962646;1003008;1121433;966825;1169408;;;;;;
291316,747;161363;1565;165888;962646;964633;1003008;1124009;966198;1168896;;;;;;
291324,671;158749;1312;166400;964633;964953;1003008;1123382;966265;1169408;;;;;;
291333,361;159008;1248;166400;964953;965569;1003008;1123961;966817;1169408;;;;;;
291344,532;158944;736;166912;965569;966233;1003008;1124513;966969;1169920;;;;;;
291353,374;159456;4031;166912;966233;966361;1003008;1125689;970392;1169920;;;;;;
291375,260;162751;6008;165888;966361;967050;1003008;1129112;973058;1168896;;;;;;
291388,336;163704;3216;166400;967050;967985;1003008;1130754;971201;1169408;;;;;;
291405,490;160912;7510;164864;967985;968755;1003008;1128897;976265;1167872;;;;;;
291407,483;164182;1633;165888;968755;971366;1003008;1132937;972999;1168896;;;;;;
291419,204;158305;2288;166400;971366;972366;1003008;1129671;974654;1169408;;;;;;
291432,633;159472;1024;165888;972366;972758;1003008;1131838;973782;1168896;;;;;;
291437,082;158208;1280;166400;972758;973118;1003008;1130966;974398;1169408;;;;;;
291442,471;158976;1709;166400;973118;973574;1003008;1132094;975283;1169408;;;;;;
291449,362;159405;5364;165888;973574;974406;1003008;1132979;979770;1168896;;;;;;
291455,647;163060;4205;166400;974406;975347;1003008;1137466;979552;1169408;;;;;;
291464,979;161901;4861;166400;975347;977325;1003008;1137248;982186;1169408;;;;;;
291479,322;162519;6031;163840;977325;978602;1003008;1139844;984633;1166848;;;;;;
291494,520;163484;1067;165888;978603;980747;1003008;1142087;981814;1168896;;;;;;
291505,105;157739;3988;165888;980747;981114;1003008;1138486;985102;1168896;;;;;;
291516,689;160660;1024;166400;981114;982946;1003008;1141774;983970;1169408;;;;;;
291527,060;158720;4240;166400;982946;983210;1003008;1141666;987450;1169408;;;;;;
291539,840;161936;3920;166912;983210;984473;1003008;1145146;988393;1169920;;;;;;
291565,868;162128;4176;166400;984473;985367;1003008;1146601;989543;1169408;;;;;;
291579,563;162384;3652;167424;985367;987398;1003008;1147751;991050;1170432;;;;;;
291587,567;162884;4416;166912;987398;990070;1003008;1150282;994486;1169920;;;;;;
291599,857;163648;3936;167936;990070;992134;1003008;1153718;996070;1170944;;;;;;
291628,667;164192;5273;167424;992134;992765;1003008;1156326;998038;1170432;;;;;;
291651,792;165529;1748;167424;992765;994516;1003008;1158294;996264;1170432;;;;;;
291665,656;161492;5041;167424;994516;995500;1003008;1156008;1000541;1170432;;;;;;
291678,162;164785;2352;167424;995500;998135;1003008;1160285;1000487;1170432;;;;;;
291694,680;162096;1169;167424;998135;999816;1003008;1160231;1000985;1170432;;;;;;
291694,701;1169;0;167424;999816;928429;1012736;1000985;928429;1180160;190094;186074;786432;1191079;1114503;1966592
291718,875;159744;1216;167424;928429;928429;1012736;1088173;929645;1180160;;;;;;
291830,896;160960;3489;167424;928429;929061;1012736;1089389;932550;1180160;;;;;;
291863,507;163233;6741;165888;929061;929061;1012736;1092294;935802;1178624;;;;;;
291874,142;165461;7044;165888;929061;929061;1012736;1094522;936105;1178624;;;;;;
291886,916;165764;3553;166400;929061;929621;1012736;1094825;933174;1179136;;;;;;
291894,283;160737;2891;165888;929621;930397;1012736;1090358;933288;1178624;;;;;;
291898,568;160075;5646;165888;930397;931293;1012736;1090472;936939;1178624;;;;;;
291923,439;163342;2557;166400;931293;934295;1012736;1094635;936852;1179136;;;;;;
291951,657;160253;5599;165888;934295;935235;1012736;1094548;940834;1178624;;;;;;
291970,838;163295;6083;163840;935235;936174;1012736;1098530;942257;1176576;;;;;;
291990,259;163779;4515;166400;936174;937086;1012736;1099953;941601;1179136;;;;;;
292000,714;161699;5076;165888;937086;938125;1012736;1098785;943201;1178624;;;;;;
292014,194;162260;1384;166400;938125;939589;1012736;1100385;940973;1179136;;;;;;
292024,172;159080;3599;166400;939589;940004;1012736;1098669;943603;1179136;;;;;;
292034,390;161295;6177;165888;940004;941398;1012736;1101299;947575;1178624;;;;;;
292056,683;163873;784;166400;941398;943710;1012736;1105271;944494;1179136;;;;;;
292062,118;158480;8675;161280;943710;946172;1012736;1102190;954847;1174016;;;;;;
292093,480;161251;960;163840;946172;949440;1012736;1107423;950400;1176576;;;;;;
292119,183;153536;5304;164352;949440;949733;1012736;1102976;955037;1177088;;;;;;
292134,405;158392;5539;163840;949733;950571;1012736;1108125;956110;1176576;;;;;;
292156,832;158627;4795;164864;950571;951507;1012736;1109198;956302;1177600;;;;;;
292188,670;158907;6122;164352;951507;952991;1012736;1110414;959113;1177088;;;;;;
292194,737;160234;4332;165376;954351;955832;1012736;1114585;960164;1178112;;;;;;
292207,180;159468;3924;164864;955835;956718;1012736;1115303;960642;1177600;;;;;;
292231,550;159060;2808;165888;956718;958593;1012736;1115778;961401;1178624;;;;;;
292264,863;159480;3955;165888;958593;959249;1012736;1118073;963204;1178624;;;;;;
292275,659;160627;1388;166400;959249;960937;1012736;1119876;962325;1179136;;;;;;
292291,443;159084;5165;166400;960937;961265;1012736;1120021;966430;1179136;;;;;;
292313,100;162861;1920;166400;961265;962009;1012736;1124126;963929;1179136;;;;;;
292505,288;159616;7611;165376;962009;962329;1012736;1121625;969940;1178112;;;;;;
292545,833;165307;8253;163328;962329;962329;1012736;1127636;970582;1176064;;;;;;
292561,117;161853;6372;164352;962329;962329;1012736;1124182;968701;1177088;;;;;;
292575,118;159972;5139;164864;962329;963256;1012736;1122301;968395;1177600;;;;;;
292584,884;159251;3232;164352;963256;963831;1012736;1122507;967063;1177088;;;;;;
292589,620;157344;5468;165376;963831;964875;1012736;1121175;970343;1178112;;;;;;
292623,203;160604;1440;164864;964875;967838;1012736;1125479;969278;1177600;;;;;;
292675,602;156576;4511;165888;967838;968667;1012736;1124414;973178;1178624;;;;;;
292695,182;160671;7832;164352;968667;969417;1012736;1129338;977249;1177088;;;;;;
292722,154;163992;4767;165376;969417;970009;1012736;1133409;974776;1178112;;;;;;
292756,546;159903;2286;164864;970009;972152;1012736;1129912;974438;1177600;;;;;;
292804,361;157422;6507;165376;972152;972152;1012736;1129574;978659;1178112;;;;;;
292817,047;162155;5893;165376;972152;972152;1012736;1134307;978045;1178112;;;;;;
292834,352;161541;4453;165888;972152;972152;1012736;1133693;976605;1178624;;;;;;
292844,833;160613;5407;165376;972152;972152;1012736;1132765;977559;1178112;;;;;;
292857,836;161567;5951;165888;972152;972735;1012736;1133719;978686;1178624;;;;;;
292866,841;162611;5161;165888;972735;973701;1012736;1135346;978862;1178624;;;;;;
292874,935;161833;3164;166400;973701;974125;1012736;1135534;977289;1179136;;;;;;
292878,120;160860;3296;166400;974125;974956;1012736;1134985;978252;1179136;;;;;;
292886,603;160992;3520;166400;974956;976182;1012736;1135948;979702;1179136;;;;;;
292898,801;161216;3764;166400;976182;977186;1012736;1137398;980950;1179136;;;;;;
292912,582;161460;1024;165888;977186;979010;1012736;1138646;980034;1178624;;;;;;
292929,944;158720;3121;166400;979010;979194;1012736;1137730;982315;1179136;;;;;;
292943,278;160817;1328;166912;979194;979482;1012736;1140011;980810;1179648;;;;;;
292953,417;160048;1041;166912;979482;980274;1012736;1139530;981315;1179648;;;;;;
292974,050;159761;5007;165888;980274;980467;1012736;1140035;985474;1178624;;;;;;
293003,987;162703;2833;166400;980467;982091;1012736;1143170;984924;1179136;;;;;;
293022,313;160529;1121;166912;982091;982387;1012736;1142620;983508;1179648;;;;;;
293033,859;159841;4227;166912;982387;982676;1012736;1142228;986903;1179648;;;;;;
293091,557;162947;1184;166912;982676;984466;1012736;1145623;985650;1179648;;;;;;
293114,898;159904;1537;166912;984466;984851;1012736;1144370;986388;1179648;;;;;;
293148,047;160257;1168;167424;984851;985066;1012736;1145108;986234;1180160;;;;;;
293165,143;160896;1484;167424;985067;985067;1012736;1145963;986551;1180160;;;;;;
293191,178;161228;5487;165888;985067;985066;1012736;1146295;990553;1178624;;;;;;
293216,932;164207;7357;166400;985066;985067;1012736;1149273;992424;1179136;;;;;;
293223,869;166077;8703;162304;985067;986727;1012736;1151144;995430;1175040;;;;;;
293241,886;162303;8942;162816;986727;987447;1012736;1149030;996389;1175552;;;;;;
293268,334;162542;4084;163328;987447;989456;1012736;1149989;993540;1176064;;;;;;
293277,266;155121;5442;162816;989456;991006;1012736;1144577;996448;1175552;;;;;;
293285,253;156482;2944;164352;991006;993061;1012736;1147488;996005;1177088;;;;;;
293307,112;156032;4795;163840;993061;994217;1012736;1149093;999012;1176576;;;;;;
293344,741;157883;1138;164864;994217;996001;1012736;1152100;997139;1177600;;;;;;
293362,299;155762;5628;164864;996001;996474;1012736;1151763;1002102;1177600;;;;;;
293390,032;160252;1145;164864;996474;998391;1012736;1156726;999536;1177600;;;;;;
293439,189;155769;4716;164864;998391;998776;1012736;1154160;1003492;1177600;;;;;;
293497,913;159340;6258;164864;998776;998776;1012736;1158116;1005034;1177600;;;;;;
293542,122;160882;4436;164864;998776;998775;1012736;1159658;1003211;1177600;;;;;;
293600,954;159060;5832;165376;998775;998775;1012736;1157835;1004607;1178112;;;;;;
293642,939;161480;7806;163840;998775;998775;1012736;1160255;1006581;1176576;;;;;;
293674,096;163454;5082;164864;998775;998776;1012736;1162229;1003858;1177600;;;;;;
293699,237;159194;10225;164352;998776;1000056;1012736;1157970;1010281;1177088;;;;;;
293722,249;164337;8878;160256;1000056;1000864;1012736;1164393;1009742;1172992;;;;;;
293740,293;158382;6819;162304;1000864;1000864;1012736;1159246;1007683;1175040;;;;;;
293746,812;156323;6337;163328;1000864;1000863;1012736;1157187;1007200;1176064;;;;;;
293808,432;157377;5535;162816;1000863;1001911;1012736;1158240;1007446;1175552;;;;;;
293841,953;156575;5537;164352;1001911;1002863;1012736;1158486;1008400;1177088;;;;;;
293888,108;158625;5541;163840;1002863;1004168;1012736;1161488;1009709;1176576;;;;;;
293918,943;158629;3487;164864;1004168;1004463;1012736;1162797;1007950;1177600;;;;;;
294017,404;157599;7775;164352;1004463;1004463;1012736;1162062;1012238;1177088;;;;;;
294062,816;161887;4479;164352;1004463;1004463;1012736;1166350;1008942;1177088;;;;;;
294101,172;158079;4639;164352;1004463;1004463;1012736;1162542;1009102;1177088;;;;;;
294111,946;158239;9467;162816;1004463;1004463;1012736;1162702;1013930;1175552;;;;;;
294176,138;162043;9228;162304;1004463;1004824;1012736;1166506;1014052;1175040;;;;;;
294187,119;161804;6588;163328;1004824;1004823;1012736;1166628;1011411;1176064;;;;;;
294215,002;158140;6163;163328;1004823;1004959;1012736;1162963;1011122;1176064;;;;;;
294281,446;157715;5393;164352;1004959;1005585;1012736;1162674;1010978;1177088;;;;;;
294291,259;158481;5712;163840;1005585;1005585;1012736;1164066;1011297;1176576;;;;;;
294342,709;158800;6065;164864;1005585;1006113;1012736;1164385;1012178;1177600;;;;;;
294353,379;160689;8214;164864;1006113;1006113;1012736;1166802;1014327;1177600;;;;;;
294378,908;162838;7241;164864;1006113;1006767;1012736;1168951;1014008;1177600;;;;;;
294392,178;161865;7072;164864;1006767;1006991;1012736;1168632;1014063;1177600;;;;;;
294405,659;161696;4931;164864;1006991;1008065;1012736;1168687;1012996;1177600;;;;;;
294440,024;159555;4479;164864;1008065;1008597;1012736;1167620;1013076;1177600;;;;;;
294572,285;159103;10211;161792;1008597;1009952;1012736;1167700;1020163;1174528;;;;;;
294603,790;161763;5588;163328;1009952;1010376;1012736;1171715;1015964;1176064;;;;;;
294614,573;157140;6619;163840;1010376;1010376;1012736;1167516;1016995;1176576;;;;;;
294627,600;159195;8413;163840;1010376;1010392;1012736;1169571;1018805;1176576;;;;;;
294708,850;160989;5766;163840;1010392;1011351;1012736;1171381;1017117;1176576;;;;;;
294708,884;5766;0;163840;1011351;931164;1012736;1017117;931164;1176576;191936;187125;786432;1209053;1118289;1963008
294741,939;152576;3607;163840;931164;931164;1012736;1083740;934771;1176576;;;;;;
294796,408;156183;4600;164352;931164;931164;1012736;1087347;935764;1177088;;;;;;
294813,946;157688;6287;163840;931164;931164;1012736;1088852;937451;1176576;;;;;;
294858,545;159375;4525;164864;931164;931164;1012736;1090539;935689;1177600;;;;;;
294872,452;158637;4270;164352;931164;931164;1012736;1089801;935434;1177088;;;;;;
294913,269;158382;10226;161792;931164;931778;1012736;1089546;942004;1174528;;;;;;
295018,450;161778;7373;163328;931778;931777;1012736;1093556;939150;1176064;;;;;;
295034,202;158925;8010;163328;931777;931777;1012736;1090702;939787;1176064;;;;;;
295052,619;159562;8702;163328;931777;931777;1012736;1091339;940479;1176064;;;;;;
295070,890;160254;9551;162304;931777;931778;1012736;1092031;941329;1175040;;;;;;
295081,337;160079;7945;162816;931778;931777;1012736;1091857;939722;1175552;;;;;;
295085,033;158473;6367;163328;931777;932545;1012736;1090250;938912;1176064;;;;;;
295087,529;157407;5680;162816;932545;933288;1012736;1089952;938968;1175552;;;;;;
295091,897;156720;8144;163328;933288;933776;1012736;1090008;941920;1176064;;;;;;
295105,862;159696;7221;163328;933776;935004;1012736;1093472;942225;1176064;;;;;;
295131,665;158773;7792;163840;935004;935692;1012736;1093777;943484;1176576;;;;;;
295146,888;160368;5878;163840;935692;936188;1012736;1096060;942066;1176576;;;;;;
295158,033;158454;8406;163840;936188;936603;1012736;1094642;945009;1176576;;;;;;
295180,155;160982;4195;163840;936603;938019;1012736;1097585;942214;1176576;;;;;;
295206,956;156771;4943;163840;938019;939019;1012736;1094790;943962;1176576;;;;;;
295209,562;157519;2616;163840;939019;940378;1012736;1096538;942994;1176576;;;;;;
295213,404;155192;930;162816;940378;942258;1012736;1095570;943188;1175552;;;;;;
295264,041;152482;4179;163328;942258;942555;1012736;1094740;946734;1176064;;;;;;
295277,908;155731;1024;163328;942555;944482;1012736;1098286;945506;1176064;;;;;;
295287,902;152576;961;163328;944482;944729;1012736;1097058;945690;1176064;;;;;;
295323,296;152513;800;163328;944729;944889;1012736;1097242;945689;1176064;;;;;;
295335,869;152352;2356;163328;944889;945105;1012736;1097241;947461;1176064;;;;;;
295346,448;153908;4626;164352;945105;945402;1012736;1099013;950028;1177088;;;;;;
295350,570;157714;2561;163840;945402;947066;1012736;1103116;949627;1176576;;;;;;
295362,588;155649;736;164864;947066;948238;1012736;1102715;948974;1177600;;;;;;
295367,938;154848;768;164352;948238;948430;1012736;1103086;949198;1177088;;;;;;
295400,670;154880;914;164864;948430;948630;1012736;1103310;949544;1177600;;;;;;
295446,685;155538;3587;164864;948630;948910;1012736;1104168;952497;1177600;;;;;;
295457,619;158211;3280;165888;948910;949588;1012736;1107121;952868;1178624;;;;;;
295477,121;159440;832;165376;949588;951365;1012736;1109028;952197;1178112;;;;;;
295510,218;156992;6243;164352;951365;951637;1012736;1108357;957880;1177088;;;;;;
295528,235;161891;1088;165376;951637;953760;1012736;1113528;954848;1178112;;;;;;
295578,600;156736;4371;165888;953760;954232;1012736;1110496;958603;1178624;;;;;;
295595,162;161043;3716;165888;954232;955015;1012736;1115275;958731;1178624;;;;;;
295619,761;160388;899;166400;955015;956856;1012736;1115403;957755;1179136;;;;;;
295646,235;158595;3362;166400;956856;956951;1012736;1115451;960313;1179136;;;;;;
295656,061;161058;3724;166912;956951;956951;1012736;1118009;960675;1179648;;;;;;
295697,489;162444;1434;166912;956951;958793;1012736;1119395;960227;1179648;;;;;;
295723,535;160154;4447;167424;958793;959017;1012736;1118947;963464;1180160;;;;;;
295742,685;164191;4884;164864;959017;959017;1012736;1123208;963901;1177600;;;;;;
295757,918;164628;3120;167424;959017;959016;1012736;1123645;962136;1180160;;;;;;
295782,836;162352;7651;166912;959016;960378;1012736;1121368;968029;1179648;;;;;;
295797,113;166883;3897;165888;960378;961234;1012736;1127261;965131;1178624;;;;;;
295807,799;161593;3667;166400;961234;961778;1012736;1122827;965445;1179136;;;;;;
295836,578;161363;7508;164864;961778;962799;1012736;1123141;970307;1177600;;;;;;
295881,364;164180;2672;165888;962799;965208;1012736;1126979;967880;1178624;;;;;;
295895,397;159344;896;165888;965208;965488;1012736;1124552;966384;1178624;;;;;;
295904,373;157568;3651;165888;965488;965993;1012736;1123056;969644;1178624;;;;;;
295931,939;160323;3999;166912;965993;966472;1012736;1126316;970471;1179648;;;;;;
295943,463;162207;2592;166400;966472;967272;1012736;1128679;969864;1179136;;;;;;
295958,202;160800;4844;166912;967272;967712;1012736;1128072;972556;1179648;;;;;;
296014,225;163564;5663;166912;967712;968345;1012736;1131276;974008;1179648;;;;;;
296036,336;164383;4212;166912;968345;969313;1012736;1132728;973525;1179648;;;;;;
296048,990;162932;2671;166912;969313;970049;1012736;1132245;972720;1179648;;;;;;
296077,280;161391;3424;167424;970049;970376;1012736;1131440;973800;1180160;;;;;;
296098,982;163168;5731;165888;970376;971377;1012736;1133544;977108;1178624;;;;;;
296109,725;165475;4321;167424;971377;972000;1012736;1136852;976321;1180160;;;;;;
296127,106;163553;1056;166912;972000;973793;1012736;1135553;974849;1179648;;;;;;
296142,293;160179;5585;166400;973793;974225;1012736;1133972;979810;1179136;;;;;;
296162,742;164305;4081;166912;974225;975334;1012736;1138530;979415;1179648;;;;;;
296181,269;162801;5793;166400;975334;976089;1012736;1138135;981882;1179136;;;;;;
296195,058;164513;3493;166912;976089;976835;1012736;1140602;980328;1179648;;;;;;
296228,644;162213;5189;166400;976835;977399;1012736;1139048;982588;1179136;;;;;;
296249,711;163909;4276;166912;977399;978300;1012736;1141308;982576;1179648;;;;;;
296261,211;162996;1216;167424;978300;980044;1012736;1141296;981260;1180160;;;;;;
296265,948;160960;4291;167424;980044;980324;1012736;1141004;984615;1180160;;;;;;
296276,688;164035;3795;167936;980324;981068;1012736;1144359;984863;1180672;;;;;;
296301,245;164051;5156;167424;981068;981659;1012736;1145119;986815;1180160;;;;;;
296313,184;165412;1059;167424;981659;983836;1012736;1147071;984895;1180160;;;;;;
296332,410;160803;4323;167424;983836;983996;1012736;1144639;988319;1180160;;;;;;
296343,606;164067;904;167424;983996;985987;1012736;1148063;986891;1180160;;;;;;
296356,204;160648;4780;167424;985987;986123;1012736;1146635;990903;1180160;;;;;;
296376,428;164524;6857;165376;986123;986843;1012736;1150647;993700;1178112;;;;;;
296394,323;164553;1184;166400;986843;988483;1012736;1151396;989667;1179136;;;;;;
296397,319;158880;1492;166400;988483;988827;1012736;1147363;990319;1179136;;;;;;
296411,761;159188;4271;166400;988827;989155;1012736;1148015;993426;1179136;;;;;;
296437,569;161967;2094;166912;989155;990963;1012736;1151122;993057;1179648;;;;;;
296465,721;160814;3956;166912;990963;991553;1012736;1151777;995509;1179648;;;;;;
296477,557;162676;3888;167424;991553;992104;1012736;1154229;995992;1180160;;;;;;
296493,602;163632;832;167424;992104;993880;1012736;1155736;994712;1180160;;;;;;
296506,213;160576;736;167424;993880;994056;1012736;1154456;994792;1180160;;;;;;
296517,694;160480;1172;167424;994056;994393;1012736;1154536;995565;1180160;;;;;;
296524,148;160916;4496;167424;994393;994792;1012736;1155309;999288;1180160;;;;;;
296543,921;164240;1111;167424;994792;996692;1012736;1159032;997803;1180160;;;;;;
296552,390;160855;1251;167936;996692;996908;1012736;1157547;998159;1180672;;;;;;
296571,775;161507;4161;167424;996908;997259;1012736;1158415;1001420;1180160;;;;;;
296577,003;164417;640;167424;997259;999147;1012736;1161676;999787;1180160;;;;;;
296603,273;160384;800;167424;999147;999267;1012736;1159531;1000067;1180160;;;;;;
296615,381;160544;4373;166912;999267;999699;1012736;1159811;1004072;1179648;;;;;;
296662,730;164117;1091;167424;999699;1001267;1012736;1163816;1002358;1180160;;;;;;
296682,713;160835;736;167936;1001267;1001699;1012736;1162102;1002435;1180672;;;;;;
296708,427;161504;3935;167936;1001699;1002051;1012736;1163203;1005986;1180672;;;;;;
296734,630;164703;4256;166912;1002051;1002677;1012736;1166754;1006933;1179648;;;;;;
296750,431;164000;1760;167424;1002677;1004740;1012736;1166677;1006500;1180160;;;;;;
296761,436;161504;6772;165888;1004740;1006141;1012736;1166244;1012913;1178624;;;;;;
296773,460;165492;1264;166912;1006141;1008894;1012736;1171633;1010158;1179648;;;;;;
296781,676;159984;1056;167424;1008894;1009383;1012736;1168878;1010439;1180160;;;;;;
296786,063;160288;3812;166912;1009383;1009543;1012736;1169671;1013355;1179648;;;;;;
296789,194;163044;2612;167936;1009543;1010151;1012736;1172587;1012763;1180672;;;;;;
296789,212;2612;0;167936;1010151;933335;1015296;1012763;933335;1183232;188804;186073;786432;1201567;1119408;1969664
296809,937;160256;3756;167424;933335;933336;1015296;1093591;937092;1182720;;;;;;
296815,123;164012;2141;167936;933336;935528;1015296;1097348;937669;1183232;;;;;;
296831,032;162909;6828;167936;935528;936144;1015296;1098437;942972;1183232;;;;;;
296863,690;167596;816;165888;936144;940083;1015296;1103740;940899;1181184;;;;;;
296880,568;159536;1723;166912;940083;940491;1015296;1099619;942214;1182208;;;;;;
296921,852;160443;912;167424;940491;940992;1015296;1100934;941904;1182720;;;;;;
296932,338;160656;1152;167424;940992;941208;1015296;1101648;942360;1182720;;;;;;
296945,880;160896;3276;167936;941208;941416;1015296;1102104;944692;1183232;;;;;;
296966,070;164044;769;167936;941416;943353;1015296;1105460;944122;1183232;;;;;;
296975,022;161537;1553;168448;943353;943562;1015296;1104890;945115;1183744;;;;;;
297019,865;162833;6412;167936;943562;943721;1015296;1106395;950133;1183232;;;;;;
297034,772;167692;1136;166912;943721;945853;1015296;1111413;946989;1182208;;;;;;
297080,017;160880;4117;167424;945853;946165;1015296;1106733;950282;1182720;;;;;;
297093,665;163861;1074;167424;946165;947973;1015296;1110026;949047;1182720;;;;;;
297163,086;160818;6969;166912;947973;948158;1015296;1108791;955127;1182208;;;;;;
297182,192;166713;3311;166912;948158;948158;1015296;1114871;951469;1182208;;;;;;
297215,012;162031;3791;166912;948158;948157;1015296;1110189;951948;1182208;;;;;;
297312,073;162511;8164;162816;948157;949846;1015296;1110668;958010;1178112;;;;;;
297336,260;162788;4494;164864;949846;951197;1015296;1112634;955691;1180160;;;;;;
297351,017;159118;7329;164352;951197;951198;1015296;1110315;958527;1179648;;;;;;
297367,881;161953;9992;164864;951198;951197;1015296;1113151;961189;1180160;;;;;;
297377,106;164616;5134;162816;951197;951839;1015296;1115813;956973;1178112;;;;;;
297386,739;157710;4691;163840;951839;953702;1015296;1109549;958393;1179136;;;;;;
297438,212;157267;6353;164352;953702;954790;1015296;1110969;961143;1179648;;;;;;
297466,737;159953;2991;164352;954790;955558;1015296;1114743;958549;1179648;;;;;;
297502,025;156591;987;164352;955558;957817;1015296;1112149;958804;1179648;;;;;;
297524,246;154587;3926;164352;957817;958097;1015296;1112404;962023;1179648;;;;;;
297532,180;157526;1152;164864;958097;959993;1015296;1115623;961145;1180160;;;;;;
297556,007;155776;3428;164864;959993;960521;1015296;1115769;963949;1180160;;;;;;
297574,933;158052;2499;165888;960521;961138;1015296;1118573;963637;1181184;;;;;;
297589,761;158659;1856;165376;961138;961593;1015296;1119797;963449;1180672;;;;;;
297611,878;158016;5604;165888;961593;962002;1015296;1119609;967606;1181184;;;;;;
297626,911;162276;1691;165888;962002;963990;1015296;1124278;965681;1181184;;;;;;
297655,360;158363;1572;165888;963990;964690;1015296;1122353;966262;1181184;;;;;;
297659,562;158244;928;165888;964690;964993;1015296;1122934;965921;1181184;;;;;;
297669,288;157600;4012;166400;964993;965154;1015296;1122593;969166;1181696;;;;;;
297694,278;161708;3392;166400;965154;965825;1015296;1126862;969217;1181696;;;;;;
297708,908;161088;5430;165888;965825;966498;1015296;1126913;971928;1181184;;;;;;
297742,765;163103;1056;166400;966499;968302;1015296;1129602;969358;1181696;;;;;;
297789,100;158694;3715;166912;968302;968534;1015296;1126996;972249;1182208;;;;;;
297833,828;161796;4552;166400;968534;969411;1015296;1130330;973963;1181696;;;;;;
297859,243;162760;4240;166912;969411;970333;1015296;1132171;974573;1182208;;;;;;
297877,669;162960;4468;166912;970333;970334;1015296;1133293;974802;1182208;;;;;;
297891,873;163188;3472;167424;970334;970333;1015296;1133522;973805;1182720;;;;;;
297897,451;162704;3538;166912;970333;970742;1015296;1133037;974280;1182208;;;;;;
297942,881;162770;5365;166912;970742;971597;1015296;1133512;976962;1182208;;;;;;
297954,388;165109;960;167424;971597;973678;1015296;1136706;974638;1182720;;;;;;
297966,694;160704;1088;167424;973678;973838;1015296;1134382;974926;1182720;;;;;;
298020,056;160832;3491;167424;973838;974246;1015296;1134670;977737;1182720;;;;;;
298098,288;163235;2608;167936;974246;974677;1015296;1137481;977285;1183232;;;;;;
298109,484;163376;5377;166400;974677;974677;1015296;1138053;980054;1181696;;;;;;
298124,246;166145;1423;167424;974677;977349;1015296;1140822;978772;1182720;;;;;;
298150,906;161167;5775;165888;977349;978181;1015296;1138516;983956;1181184;;;;;;
298200,758;165519;4551;166912;978181;980292;1015296;1143700;984843;1182208;;;;;;
298220,005;163271;2912;166912;980292;980292;1015296;1143563;983204;1182208;;;;;;
298244,586;161632;2848;167936;980292;980292;1015296;1141924;983140;1183232;;;;;;
298282,210;163104;6917;167424;980292;980292;1015296;1143396;987209;1182720;;;;;;
298339,506;167173;3968;166400;980292;980292;1015296;1147465;984260;1181696;;;;;;
298384,550;162688;5940;166912;980292;980293;1015296;1142980;986233;1182208;;;;;;
298409,642;164660;4672;166912;980293;980292;1015296;1144953;984964;1182208;;;;;;
298429,279;163392;7479;166400;980292;980292;1015296;1143684;987771;1181696;;;;;;
298438,704;166199;7838;164352;980292;980293;1015296;1146491;988131;1179648;;;;;;
298448,325;163486;8064;163840;980293;980973;1015296;1143779;989037;1179136;;;;;;
298463,723;163712;6947;164352;980973;981989;1015296;1144685;988936;1179648;;;;;;
298470,492;160547;5370;164352;981989;982644;1015296;1142536;988014;1179648;;;;;;
298495,132;158970;5828;164864;982644;983684;1015296;1141614;989512;1180160;;;;;;
298505,236;160452;3601;164864;983684;984924;1015296;1144136;988525;1180160;;;;;;
298540,014;158225;3300;165376;984924;985580;1015296;1143149;988880;1180672;;;;;;
298561,738;158948;5008;165376;985580;986404;1015296;1144528;991412;1180672;;;;;;
298572,182;160656;928;164864;986404;988300;1015296;1147060;989228;1180160;;;;;;
298579,412;156548;2047;165376;988300;988612;1015296;1144848;990659;1180672;;;;;;
298590,870;157695;5301;165888;988612;988956;1015296;1146307;994257;1181184;;;;;;
298613,208;161461;4335;165376;988956;989983;1015296;1150417;994318;1180672;;;;;;
298626,733;160495;2448;166400;989983;991822;1015296;1150478;994270;1181696;;;;;;
298654,565;160144;4149;166400;991822;992302;1015296;1151966;996451;1181696;;;;;;
298666,049;161845;1136;165888;992302;994007;1015296;1154147;995143;1181184;;;;;;
298689,231;158832;5414;166400;994007;994238;1015296;1152839;999652;1181696;;;;;;
298713,608;163110;2206;166400;994238;996000;1015296;1157348;998206;1181696;;;;;;
298731,581;159855;1495;166400;996000;996279;1015296;1155855;997774;1181696;;;;;;
298761,891;159191;4699;166912;996279;996656;1015296;1155470;1001355;1182208;;;;;;
298777,622;162907;4722;166400;996656;997370;1015296;1159563;1002092;1181696;;;;;;
298812,411;162930;2064;166912;997370;999628;1015296;1160300;1001692;1182208;;;;;;
298848,439;160784;1026;166912;999628;1000545;1015296;1160412;1001571;1182208;;;;;;
298855,031;159746;6501;165888;1000545;1000545;1015296;1160291;1007046;1181184;;;;;;
298885,015;164197;2018;166400;1000544;1002952;1015296;1164741;1004970;1181696;;;;;;
298896,803;159714;1252;166400;1002952;1003753;1015296;1162666;1005005;1181696;;;;;;
298916,116;158948;2983;166400;1003753;1004146;1015296;1162701;1007129;1181696;;;;;;
298937,688;160679;4063;166912;1004146;1004770;1015296;1164825;1008833;1182208;;;;;;
298948,750;162783;3940;166912;1004770;1005650;1015296;1167553;1009590;1182208;;;;;;
298973,112;162660;3883;167424;1005650;1007218;1015296;1168310;1011101;1182720;;;;;;
298984,330;163627;1184;167424;1007218;1007658;1015296;1170845;1008842;1182720;;;;;;
299000,515;160928;2496;167936;1007658;1007914;1015296;1168586;1010410;1183232;;;;;;
299018,958;162752;3390;167424;1007914;1009779;1015296;1170666;1013169;1182720;;;;;;
299061,034;163646;3152;168448;1009779;1010839;1015296;1173425;1013991;1183744;;;;;;
299085,794;164432;903;167936;1010839;1012633;1015296;1175271;1013536;1183232;;;;;;
299136,522;162183;3280;168448;1012633;1012864;1015296;1174816;1016144;1183744;;;;;;
299136,542;3280;0;168448;1012864;942526;1023488;1016144;942526;1191936;187748;186189;786432;1203892;1128715;1978368
299149,870;161792;4369;168448;942526;942527;1023488;1104318;946896;1191936;;;;;;
299170,851;166161;6651;165376;942527;943437;1023488;1108688;950088;1188864;;;;;;
299197,824;165371;4080;166912;943437;946471;1023488;1108808;950551;1190400;;;;;;
299216,997;162800;5606;166400;946471;946976;1023488;1109271;952582;1189888;;;;;;
299236,828;164326;1265;166912;946976;949085;1023488;1111302;950350;1190400;;;;;;
299274,492;159985;5519;166912;949085;949638;1023488;1109070;955157;1190400;;;;;;
299295,933;164239;5167;164352;949638;949637;1023488;1113877;954804;1187840;;;;;;
299323,708;163887;4463;166912;949637;949638;1023488;1113524;954101;1190400;;;;;;
299357,120;162671;7351;165888;949638;949638;1023488;1112309;956989;1189376;;;;;;
299374,031;165559;4928;166400;949638;949637;1023488;1115197;954565;1189888;;;;;;
299418,100;162112;7199;164864;949637;949637;1023488;1111749;956836;1188352;;;;;;
299492,666;164383;8111;164352;949637;949637;1023488;1114020;957748;1187840;;;;;;
299511,749;162735;7071;161792;949637;949638;1023488;1112372;956709;1185280;;;;;;
299558,794;161695;8691;163328;949638;949637;1023488;1111333;958328;1186816;;;;;;
299578,634;161267;7088;163840;949637;949637;1023488;1110904;956725;1187328;;;;;;
299605,539;159664;7488;163840;949637;949637;1023488;1109301;957125;1187328;;;;;;
299642,703;160064;7551;160256;949637;949637;1023488;1109701;957188;1183744;;;;;;
299689,295;160127;8975;162304;949637;949637;1023488;1109764;958612;1185792;;;;;;
299708,350;159503;8431;162816;949637;949638;1023488;1109140;958069;1186304;;;;;;
299726,766;158959;10494;160768;949638;949637;1023488;1108597;960131;1184256;;;;;;
299744,859;158974;8500;161792;949637;950894;1023488;1108611;959394;1185280;;;;;;
299762,436;156980;9139;161792;950894;951789;1023488;1107874;960928;1185280;;;;;;
299766,879;157619;6767;161792;951789;952789;1023488;1109408;959556;1185280;;;;;;
299859,806;155247;8604;162304;952789;954053;1023488;1108036;962657;1185792;;;;;;
299870,695;158108;7638;162304;954053;954805;1023488;1112161;962443;1185792;;;;;;
299877,265;156954;8154;162816;954805;955253;1023488;1111759;963407;1186304;;;;;;
299902,703;158682;7478;162816;955253;955884;1023488;1113935;963362;1186304;;;;;;
299908,787;158006;8227;163328;955884;956333;1023488;1113890;964560;1186816;;;;;;
299918,651;159779;6369;163328;956333;956985;1023488;1116112;963354;1186816;;;;;;
299941,061;157921;7198;163840;956985;957481;1023488;1114906;964679;1187328;;;;;;
299953,388;159774;6926;163840;957481;957977;1023488;1117255;964903;1187328;;;;;;
300016,025;159502;3632;163328;957977;959368;1023488;1117479;963000;1186816;;;;;;
300057,191;156208;2544;155136;959368;960356;1023488;1115576;962900;1178624;;;;;;
300082,089;155120;608;162304;960356;962267;1023488;1115476;962875;1185792;;;;;;
300089,387;151136;704;162816;962267;962619;1023488;1113403;963323;1186304;;;;;;
300103,238;151232;3267;162816;962619;962900;1023488;1113851;966167;1186304;;;;;;
300118,389;153795;2688;162816;962900;963330;1023488;1116695;966018;1186304;;;;;;
300155,700;153210;2448;163328;963331;963891;1023488;1116541;966339;1186816;;;;;;
300200,812;154000;4860;163328;963891;965725;1023488;1117891;970585;1186816;;;;;;
300230,271;156412;1299;164352;965725;966921;1023488;1122137;968220;1187840;;;;;;
300251,733;154387;3840;163840;966921;967352;1023488;1121308;971192;1187328;;;;;;
300263,883;156928;8515;162816;967352;967352;1023488;1124280;975867;1186304;;;;;;
300299,911;161091;4888;163840;967352;968611;1023488;1128443;973499;1187328;;;;;;
300307,035;157464;896;164352;968611;970562;1023488;1126075;971458;1187840;;;;;;
300315,603;154496;1696;164352;970562;971282;1023488;1125058;972978;1187840;;;;;;
300325,527;155296;6608;163328;971282;972498;1023488;1126578;979106;1186816;;;;;;
300352,285;159184;5060;163840;972498;973599;1023488;1131682;978659;1187328;;;;;;
300364,188;157636;4587;164864;973599;974340;1023488;1131235;978927;1188352;;;;;;
300386,691;158699;2960;164352;974340;975110;1023488;1133039;978070;1187840;;;;;;
300424,202;157072;928;165376;975110;977017;1023488;1132182;977945;1188864;;;;;;
300438,832;156576;2400;165376;977017;977345;1023488;1133593;979745;1188864;;;;;;
300498,698;158048;5551;165376;977345;977859;1023488;1135393;983410;1188864;;;;;;
300522,281;161199;3827;165376;977859;978978;1023488;1139058;982805;1188864;;;;;;
300549,237;159475;4243;166400;978978;979434;1023488;1138453;983677;1189888;;;;;;
300560,833;161427;5060;165888;979434;979434;1023488;1140861;984494;1189376;;;;;;
300572,528;162244;2815;166400;979434;979906;1023488;1141678;982721;1189888;;;;;;
300595,517;160511;1120;166400;979906;981689;1023488;1140417;982809;1189888;;;;;;
300609,479;158816;1264;166400;981689;981993;1023488;1140505;983257;1189888;;;;;;
300615,034;158960;2005;166400;981993;982282;1023488;1140953;984287;1189888;;;;;;
300627,119;159701;864;166912;982282;982601;1023488;1141983;983465;1190400;;;;;;
300664,146;159584;3072;166912;982601;982865;1023488;1142185;985937;1190400;;;;;;
300688,567;161792;816;167424;982865;984460;1023488;1144657;985276;1190912;;;;;;
300713,568;160560;640;167424;984460;984892;1023488;1145020;985532;1190912;;;;;;
300730,400;160384;1055;167936;984892;985133;1023488;1145276;986188;1191424;;;;;;
300762,138;161311;977;167424;985133;985292;1023488;1146444;986269;1190912;;;;;;
300852,994;161233;3547;167936;985292;985292;1023488;1146525;988839;1191424;;;;;;
300929,107;164315;4579;165376;985292;985293;1023488;1149607;989872;1188864;;;;;;
301207,324;165347;4163;167424;985293;985293;1023488;1150640;989456;1190912;;;;;;
301224,112;163907;5279;165376;985293;985293;1023488;1149200;990572;1188864;;;;;;
301262,638;165023;4351;166912;985293;985292;1023488;1150316;989643;1190400;;;;;;
301288,534;163071;4447;166912;985292;985292;1023488;1148363;989739;1190400;;;;;;
301329,633;163167;5056;166912;985292;985292;1023488;1148459;990348;1190400;;;;;;
301391,022;163776;4895;166912;985292;985292;1023488;1149068;990187;1190400;;;;;;
301418,245;163615;4767;166912;985292;985292;1023488;1148907;990059;1190400;;;;;;
301426,814;163487;6002;164864;985292;985293;1023488;1148779;991295;1188352;;;;;;
301458,855;164722;6819;165376;985293;985517;1023488;1150015;992336;1188864;;;;;;
301496,661;163491;6111;162816;985517;985748;1023488;1149008;991859;1186304;;;;;;
301519,181;162783;6463;165376;985748;985748;1023488;1148531;992211;1188864;;;;;;
301553,001;162111;6183;165376;985748;986340;1023488;1147859;992523;1188864;;;;;;
301587,569;161831;8579;163328;986340;986341;1023488;1148171;994920;1186816;;;;;;
301632,967;162179;6866;164352;986341;986340;1023488;1148520;993206;1187840;;;;;;
301646,914;160466;7903;163328;986340;986340;1023488;1146806;994243;1186816;;;;;;
301665,293;160479;8771;161792;986340;986461;1023488;1146819;995232;1185280;;;;;;
301718,263;161340;6525;163328;986461;986980;1023488;1147801;993505;1186816;;;;;;
301859,891;158077;7601;163328;986980;987284;1023488;1145057;994885;1186816;;;;;;
301904,878;159153;9166;162304;987284;987676;1023488;1146437;996842;1185792;;;;;;
301956,221;159694;8774;159744;987676;987836;1023488;1147370;996610;1183232;;;;;;
301974,520;159302;6911;162816;987836;987924;1023488;1147138;994835;1186304;;;;;;
301997,780;156927;8750;162304;987924;988012;1023488;1144851;996762;1185792;;;;;;
302022,407;158766;9871;161792;988012;988341;1023488;1146778;998212;1185280;;;;;;
302031,707;159375;9281;159232;988341;988839;1023488;1147716;998120;1182720;;;;;;
302065,233;158785;8462;162304;988839;989431;1023488;1147624;997893;1185792;;;;;;
302077,948;157454;9121;161792;989431;989903;1023488;1146885;999024;1185280;;;;;;
302114,825;158113;6977;162304;989903;990337;1023488;1148016;997314;1185792;;;;;;
302127,166;156481;6497;162304;990337;991149;1023488;1146818;997646;1185792;;;;;;
302139,836;156001;4640;162816;991149;992385;1023488;1147150;997025;1186304;;;;;;
302152,262;155168;7116;162816;992385;992802;1023488;1147553;999918;1186304;;;;;;
302176,796;157644;7504;163328;992802;993465;1023488;1150446;1000969;1186816;;;;;;
302203,852;159056;4994;163328;993465;993985;1023488;1152521;998979;1186816;;;;;;
302218,040;156546;3987;163328;993985;994394;1023488;1150531;998381;1186816;;;;;;
302240,201;155539;6460;163328;994394;994698;1023488;1149933;1001158;1186816;;;;;;
302270,238;158012;3185;163840;994698;995800;1023488;1152710;998985;1187328;;;;;;
302301,799;155761;2834;163840;995800;996200;1023488;1151561;999034;1187328;;;;;;
302307,018;155410;3487;163840;996200;996361;1023488;1151610;999848;1187328;;;;;;
302327,130;156063;2259;163840;996361;998114;1023488;1152424;1000373;1187328;;;;;;
302333,106;154835;5075;164352;998114;998450;1023488;1152949;1003525;1187840;;;;;;
302339,857;158163;3016;163840;998450;999978;1023488;1156613;1002994;1187328;;;;;;
302357,538;156104;4148;164864;999978;1000504;1023488;1156082;1004652;1188352;;;;;;
302371,078;158260;3828;164352;1000504;1001276;1023488;1158764;1005104;1187840;;;;;;
302385,653;157940;2176;164864;1001276;1002900;1023488;1159216;1005076;1188352;;;;;;
302404,344;156800;3508;164864;1002900;1003356;1023488;1159700;1006864;1188352;;;;;;
302421,184;158132;3516;165888;1003356;1003988;1023488;1161488;1007504;1189376;;;;;;
302471,322;159676;1905;165376;1003988;1005701;1023488;1163664;1007606;1188864;;;;;;
302501,481;158065;3838;166400;1005701;1005918;1023488;1163766;1009756;1189888;;;;;;
302539,955;161022;2304;165888;1005918;1006700;1023488;1166940;1009004;1189376;;;;;;
302544,449;159488;4832;166400;1006700;1006701;1023488;1166188;1011533;1189888;;;;;;
302563,155;162528;3716;166400;1006701;1007733;1023488;1169229;1011449;1189888;;;;;;
302593,660;161412;1120;166912;1007733;1009509;1023488;1169145;1010629;1190400;;;;;;
302618,261;159795;7399;166400;1009509;1009837;1023488;1169304;1017236;1189888;;;;;;
302628,100;166119;5540;165376;1009837;1010632;1023488;1175956;1016172;1188864;;;;;;
302637,141;162212;2003;165888;1010632;1013062;1023488;1172844;1015065;1189376;;;;;;
302648,988;158675;2422;165888;1013062;1013678;1023488;1171737;1016100;1189376;;;;;;
302657,604;159094;3824;165888;1013678;1014342;1023488;1172772;1018166;1189376;;;;;;
302675,449;160496;979;166400;1014342;1016351;1023488;1174838;1017330;1189888;;;;;;
302710,799;158675;3827;166400;1016351;1016639;1023488;1175026;1020466;1189888;;;;;;
302732,806;161523;1282;166912;1016639;1018565;1023488;1178162;1019847;1190400;;;;;;
302738,853;22311;224;166912;1018566;1018709;1023488;1040877;1018933;1190400;;;;;;
302738,872;224;0;166912;1018709;947074;1023488;1018933;947074;1190400;191715;185957;786432;1210648;1133031;1976832
302755,976;158720;1137;166912;947074;947074;1023488;1105794;948211;1190400;;;;;;
302791,494;159857;4164;166912;947074;947426;1023488;1106931;951590;1190400;;;;;;
302820,167;162884;4177;166912;947426;948122;1023488;1110310;952299;1190400;;;;;;
302881,364;162897;4916;166912;948122;948706;1023488;1111019;953622;1190400;;;;;;
302941,950;163636;3489;167424;948706;948706;1023488;1112342;952195;1190912;;;;;;
302999,527;162721;3056;166912;948706;948706;1023488;1111427;951762;1190400;;;;;;
303105,617;162288;3008;167936;948706;948705;1023488;1110994;951713;1191424;;;;;;
303166,377;163264;6069;167424;948705;948706;1023488;1111969;954775;1190912;;;;;;
303193,764;166325;4689;167424;948706;948706;1023488;1115031;953395;1190912;;;;;;
303254,119;164433;4799;167424;948706;948706;1023488;1113139;953505;1190912;;;;;;
303262,880;164543;4383;167424;948706;948706;1023488;1113249;953089;1190912;;;;;;
303299,401;164127;7656;167424;948706;949777;1023488;1112833;957433;1190912;;;;;;
303315,373;167400;6545;163328;949777;950713;1023488;1117177;957258;1186816;;;;;;
303387,769;162193;6412;165376;950713;951017;1023488;1112906;957429;1188864;;;;;;
303408,266;162060;5396;165376;951017;951017;1023488;1113077;956413;1188864;;;;;;
303480,892;161044;5153;165376;951017;951106;1023488;1112061;956259;1188864;;;;;;
303491,687;160801;8348;163840;951106;951105;1023488;1111907;959453;1187328;;;;;;
303539,648;162972;6964;164864;951105;951561;1023488;1114077;958525;1188352;;;;;;
303609,192;161588;8003;163840;951561;951561;1023488;1113149;959564;1187328;;;;;;
303632,573;161603;6590;164352;951561;951562;1023488;1113164;958152;1187840;;;;;;
303640,906;160190;7118;164352;951562;951562;1023488;1111752;958680;1187840;;;;;;
303690,137;160718;9019;162816;951562;951970;1023488;1112280;960989;1186304;;;;;;
303730,255;162548;8334;162816;952942;953134;1023488;1115490;961468;1186304;;;;;;
303745,678;159886;9152;160768;953138;953139;1023488;1113024;962291;1184256;;;;;;
303750,947;160704;7249;163328;953139;953746;1023488;1113843;960995;1186816;;;;;;
303765,280;158289;7907;162816;953746;954698;1023488;1112035;962605;1186304;;;;;;
303794,972;158947;6782;163840;954698;955139;1023488;1113645;961921;1187328;;;;;;
303818,099;158846;5664;163328;955139;956522;1023488;1113985;962186;1186816;;;;;;
303859,717;157728;5104;163840;956522;957186;1023488;1114250;962290;1187328;;;;;;
303890,746;157680;4968;163840;957186;957970;1023488;1114866;962938;1187328;;;;;;
303940,092;157544;5024;164352;957970;958217;1023488;1115514;963241;1187840;;;;;;
303960,980;158624;4672;164352;958217;958505;1023488;1116841;963177;1187840;;;;;;
303967,693;158272;6128;164864;958505;959001;1023488;1116777;965129;1188352;;;;;;
303979,875;160240;2288;164352;959001;960938;1023488;1119241;963226;1187840;;;;;;
303988,139;156400;2301;163840;960938;961297;1023488;1117338;963598;1187328;;;;;;
303995,490;155901;4212;164352;961297;961682;1023488;1117198;965894;1187840;;;;;;
304030,685;157812;4242;165376;961682;962097;1023488;1119494;966339;1188864;;;;;;
304034,312;159378;3008;164864;962097;962554;1023488;1121475;965562;1188352;;;;;;
304053,941;158144;2720;165376;962554;964273;1023488;1120698;966993;1188864;;;;;;
304072,989;158368;736;165376;964273;965002;1023488;1122641;965738;1188864;;;;;;
304079,337;156384;1472;165376;965002;965177;1023488;1121386;966649;1188864;;;;;;
304102,106;157120;960;165376;965177;965505;1023488;1122297;966465;1188864;;;;;;
304111,053;156608;896;165376;965505;965866;1023488;1122113;966762;1188864;;;;;;
304117,354;156544;896;165376;965866;966098;1023488;1122410;966994;1188864;;;;;;
304171,489;156544;2000;165888;966098;966361;1023488;1122642;968361;1189376;;;;;;
304196,292;158160;2153;165376;966361;966682;1023488;1124521;968835;1188864;;;;;;
304231,985;158313;960;166400;966682;966785;1023488;1124995;967745;1189888;;;;;;
304269,462;158656;1232;166400;966785;967313;1023488;1125441;968545;1189888;;;;;;
304283,699;158928;1296;166912;967313;967497;1023488;1126241;968793;1190400;;;;;;
304301,858;160016;1638;166912;967497;967850;1023488;1127513;969488;1190400;;;;;;
304310,165;160358;3812;167424;967850;968138;1023488;1128208;971950;1190912;;;;;;
304343,634;163556;960;167424;968138;969882;1023488;1131694;970842;1190912;;;;;;
304358,420;160704;1136;167936;969882;970354;1023488;1130586;971490;1191424;;;;;;
304392,800;161904;1024;167936;970354;970690;1023488;1132258;971714;1191424;;;;;;
304401,090;161792;1346;168448;970690;970690;1023488;1132482;972036;1191936;;;;;;
304408,542;163138;1025;168448;970690;971282;1023488;1133828;972307;1191936;;;;;;
304431,566;162817;3907;167936;971282;971650;1023488;1134099;975557;1191424;;;;;;
304447,020;165699;1778;168448;971650;973569;1023488;1137349;975347;1191936;;;;;;
304462,119;163570;1168;168960;973569;973793;1023488;1137139;974961;1192448;;;;;;
304466,508;163984;992;168960;973793;974250;1023488;1137777;975242;1192448;;;;;;
304490,833;163808;736;169472;974250;974585;1023488;1138058;975321;1192960;;;;;;
304500,983;164576;3251;169472;974585;974938;1023488;1139161;978189;1192960;;;;;;
304536,388;167091;3864;168448;974938;975425;1023488;1142029;979289;1191936;;;;;;
304556,635;166680;1124;168960;975425;977105;1023488;1142105;978229;1192448;;;;;;
304574,734;163940;3264;168960;977105;977481;1023488;1141045;980745;1192448;;;;;;
304602,880;166080;3942;168960;977481;978177;1023488;1143561;982119;1192448;;;;;;
304638,244;166758;1730;168960;978177;979673;1023488;1144935;981403;1192448;;;;;;
304644,333;164546;1504;168960;979673;979673;1023488;1144219;981177;1192448;;;;;;
304688,152;164320;1105;169472;979673;980473;1023488;1143993;981578;1192960;;;;;;
304716,814;164945;480;169472;980473;980921;1023488;1145418;981401;1192960;;;;;;
304729,313;164320;906;169472;980921;981161;1023488;1145241;982067;1192960;;;;;;
304758,159;164746;832;169472;981161;981433;1023488;1145907;982265;1192960;;;;;;
304819,450;164672;816;169984;981433;981809;1023488;1146105;982625;1193472;;;;;;
304858,397;165680;1201;169984;981809;981809;1023488;1147489;983010;1193472;;;;;;
305126,463;166065;1615;170496;981809;981809;1023488;1147874;983424;1193984;;;;;;
305148,596;166991;1744;169984;981809;981809;1023488;1148800;983553;1193472;;;;;;
305176,691;167120;2679;170496;981809;981809;1023488;1148929;984488;1193984;;;;;;
305198,037;168567;4605;170496;981809;982483;1023488;1150376;987088;1193984;;;;;;
305210,649;170493;4588;166400;982483;983794;1023488;1152976;988382;1189888;;;;;;
305235,070;166380;3807;168448;983794;984227;1023488;1150174;988034;1191936;;;;;;
305250,155;165599;6119;166400;984227;984226;1023488;1149826;990345;1189888;;;;;;
305282,140;165863;7679;167424;984226;984764;1023488;1150089;992443;1190912;;;;;;
305312,355;167423;5915;163328;984764;985924;1023488;1152187;991839;1186816;;;;;;
305360,355;161563;5132;165376;985924;985925;1023488;1147487;991057;1188864;;;;;;
305387,411;160780;5030;165888;985925;985924;1023488;1146705;990954;1189376;;;;;;
305416,063;161190;9188;165376;985924;986243;1023488;1147114;995431;1188864;;;;;;
305436,541;165348;8006;161280;986243;986945;1023488;1151591;994951;1184768;;;;;;
305472,431;159558;6065;163328;986945;987695;1023488;1146503;993760;1186816;;;;;;
305484,566;157360;5617;163840;987694;987694;1023488;1145054;993311;1187328;;;;;;
305513,989;158193;7837;163840;987694;988398;1023488;1145887;996235;1187328;;;;;;
305520,139;160413;7606;162816;988398;988926;1023488;1148811;996532;1186304;;;;;;
305531,638;159158;5132;163328;988926;989950;1023488;1148084;995082;1186816;;;;;;
305540,717;156684;9512;161792;989950;990646;1023488;1146634;1000158;1185280;;;;;;
305549,105;160040;4684;162816;990646;991430;1023488;1150686;996114;1186304;;;;;;
305552,820;155212;5188;163840;991430;992374;1023488;1146642;997562;1187328;;;;;;
305557,987;157252;2944;163328;992374;993445;1023488;1149626;996389;1186816;;;;;;
305579,354;155008;2423;163840;993445;995373;1023488;1148453;997796;1187328;;;;;;
305584,229;154999;6003;163840;995373;996094;1023488;1150372;1002097;1187328;;;;;;
305596,148;158579;3876;164352;996094;997278;1023488;1154673;1001154;1187840;;;;;;
305633,904;157242;3756;164352;997277;998069;1023488;1154519;1001825;1187840;;;;;;
305647,356;157356;1312;164864;998069;999864;1023488;1155425;1001176;1188352;;;;;;
305659,187;155936;1856;164864;999864;1001088;1023488;1155800;1002944;1188352;;;;;;
305678,605;156480;897;164864;1001088;1001972;1023488;1157568;1002869;1188352;;;;;;
305690,781;155521;945;164864;1001972;1002132;1023488;1157493;1003077;1188352;;;;;;
305698,813;155569;2992;165376;1002132;1002308;1023488;1157701;1005300;1188864;;;;;;
305731,229;158128;848;164864;1002308;1004266;1023488;1160436;1005114;1188352;;;;;;
305745,353;155984;4305;165888;1004266;1004578;1023488;1160250;1008883;1189376;;;;;;
305756,188;160465;832;165376;1004578;1006218;1023488;1165043;1007050;1188864;;;;;;
305762,946;156992;832;165888;1006218;1006394;1023488;1163210;1007226;1189376;;;;;;
305773,719;157504;1165;165888;1006394;1006674;1023488;1163898;1007839;1189376;;;;;;
305787,139;157837;4072;166400;1006674;1006898;1023488;1164511;1010970;1189888;;;;;;
305798,799;161768;1598;166400;1006898;1008632;1023488;1168666;1010230;1189888;;;;;;
305816,416;159294;864;166912;1008632;1008951;1023488;1167926;1009815;1190400;;;;;;
305832,069;159584;704;166912;1008951;1009159;1023488;1168535;1009863;1190400;;;;;;
305848,929;159424;929;167424;1009159;1009359;1023488;1168583;1010288;1190912;;;;;;
305859,148;160673;1232;167424;1009359;1009535;1023488;1170032;1010767;1190912;;;;;;
305864,770;160976;2336;168448;1009535;1010007;1023488;1170511;1012343;1191936;;;;;;
305874,683;163616;1477;167936;1010007;1011793;1023488;1173623;1013270;1191424;;;;;;
305917,473;162757;640;168960;1011793;1012581;1023488;1174550;1013221;1192448;;;;;;
305961,323;162944;784;168448;1012581;1012781;1023488;1175525;1013565;1191936;;;;;;
305982,139;163088;2494;168960;1012781;1013165;1023488;1175869;1015659;1192448;;;;;;
306017,902;165310;1111;168960;1013165;1013285;1023488;1178475;1014396;1192448;;;;;;
306039,164;163927;2386;169472;1013285;1013286;1023488;1177212;1015672;1192960;;;;;;
306089,968;166226;1264;169472;1013286;1013517;1023488;1179512;1014781;1192960;;;;;;
306129,506;165104;1600;169984;1013517;1013517;1023488;1178621;1015117;1193472;;;;;;
306137,414;166464;1874;169984;1013517;1013517;1023488;1179981;1015391;1193472;;;;;;
306152,675;166738;1568;170496;1013517;1013917;1023488;1180255;1015485;1193984;;;;;;
306176,363;167456;4603;170496;1013917;1014547;1023488;1181373;1019150;1193984;;;;;;
306189,795;170491;3491;168448;1014547;1014851;1023488;1185038;1018342;1191936;;;;;;
306202,853;167331;1184;169472;1014851;1017002;1023488;1182182;1018186;1192960;;;;;;
306207,255;165024;5619;166400;1017002;1018715;1023488;1182026;1024334;1189888;;;;;;
306217,513;166387;1024;167936;1018715;1021307;1023488;1185102;1022331;1191424;;;;;;
306217,529;1024;0;167936;1021307;949250;1029120;1022331;949250;1197056;186963;185958;786432;1209294;1135208;1983488
306226,337;160768;1584;168448;949250;949251;1029120;1110018;950835;1197568;;;;;;
306250,675;162864;1056;167936;949251;950221;1029120;1112115;951277;1197056;;;;;;
306260,653;162336;2081;168960;950221;950942;1029120;1112557;953023;1198080;;;;;;
306273,735;164385;4056;168448;950942;951045;1029120;1115327;955101;1197568;;;;;;
306297,882;166360;960;168960;951045;952725;1029120;1117405;953685;1198080;;;;;;
306322,249;163264;960;168448;952725;953181;1029120;1115989;954141;1197568;;;;;;
306329,885;162972;996;168960;953182;953334;1029120;1116154;954330;1198080;;;;;;
306338,957;163812;6141;168960;953334;953851;1029120;1117146;959992;1198080;;;;;;
306354,738;168957;1216;166912;953851;955746;1029120;1122808;956962;1196032;;;;;;
306365,399;161984;1024;167936;955746;956242;1029120;1117730;957266;1197056;;;;;;
306380,025;161792;4644;167936;956242;956627;1029120;1118034;961271;1197056;;;;;;
306394,296;165412;4404;165376;956627;957499;1029120;1122039;961903;1194496;;;;;;
306414,258;165172;2725;167936;957499;958923;1029120;1122671;961648;1197056;;;;;;
306430,072;162981;3424;167424;958923;959931;1029120;1121904;963355;1196544;;;;;;
306450,928;163680;896;167936;959931;961698;1029120;1123611;962594;1197056;;;;;;
306463,017;161664;1144;167936;961698;961987;1029120;1123362;963131;1197056;;;;;;
306494,289;161912;896;168448;961987;962179;1029120;1123899;963075;1197568;;;;;;
306522,615;162688;3779;168448;962179;962531;1029120;1124867;966310;1197568;;;;;;
306554,202;165571;6631;165376;962531;963835;1029120;1128102;970466;1194496;;;;;;
306559,813;165351;1424;166912;963835;965996;1029120;1129186;967420;1196032;;;;;;
306566,111;160144;992;166912;965996;966403;1029120;1126140;967395;1196032;;;;;;
306578,849;159712;3988;166912;966403;966675;1029120;1126115;970663;1196032;;;;;;
306595,509;162708;1856;167424;966675;968371;1029120;1129383;970227;1196544;;;;;;
306608,988;161065;1310;166912;968371;968892;1029120;1129436;970202;1196032;;;;;;
306627,042;160542;1090;167936;968892;969563;1029120;1129434;970653;1197056;;;;;;
306640,565;161858;4239;167936;969563;969875;1029120;1131421;974114;1197056;;;;;;
306670,407;165007;1413;167936;969875;971931;1029120;1134882;973344;1197056;;;;;;
306738,269;162181;1056;167936;971931;972236;1029120;1134112;973292;1197056;;;;;;
306790,688;161824;1409;168448;972236;972235;1029120;1134060;973644;1197568;;;;;;
306804,390;162689;1952;167936;972235;972235;1029120;1134924;974187;1197056;;;;;;
306833,536;163232;1522;168960;972235;972235;1029120;1135467;973757;1198080;;;;;;
306852,870;164338;2112;168960;972235;972235;1029120;1136573;974347;1198080;;;;;;
306866,226;164928;2080;169984;972235;972235;1029120;1137163;974315;1199104;;;;;;
306882,052;166432;5093;169472;972235;973251;1029120;1138667;978344;1198592;;;;;;
306902,609;169445;3600;167424;973251;973603;1029120;1142696;977203;1196544;;;;;;
306924,625;165392;3488;168448;973603;973835;1029120;1138995;977323;1197568;;;;;;
306942,676;165280;3729;168448;973835;973931;1029120;1139115;977660;1197568;;;;;;
306969,585;165521;3632;168448;973931;974171;1029120;1139452;977803;1197568;;;;;;
306987,036;165424;3923;168448;974171;974172;1029120;1139595;978095;1197568;;;;;;
307005,250;165715;3584;168448;974172;974635;1029120;1139887;978219;1197568;;;;;;
307030,407;165376;5715;167424;974635;975012;1029120;1140011;980727;1196544;;;;;;
307042,314;166483;5747;166912;975012;975252;1029120;1141495;980999;1196032;;;;;;
307054,660;166515;4597;167424;975252;975787;1029120;1141767;980384;1196544;;;;;;
307067,095;164341;3743;167424;975787;976124;1029120;1140128;979867;1196544;;;;;;
307099,808;163487;5926;166912;976124;976939;1029120;1139611;982865;1196032;;;;;;
307132,880;165670;2975;167424;976939;977675;1029120;1142609;980650;1196544;;;;;;
307244,286;162719;3217;167936;977675;977843;1029120;1140394;981060;1197056;;;;;;
307267,788;163473;4997;167424;977843;977843;1029120;1141316;982840;1196544;;;;;;
307289,644;165253;4177;167936;977843;977843;1029120;1143096;982020;1197056;;;;;;
307373,477;164433;3759;167424;977843;977843;1029120;1142276;981602;1196544;;;;;;
307394,920;164015;4176;168448;977843;977843;1029120;1141858;982019;1197568;;;;;;
307555,720;165456;4231;167936;977843;977843;1029120;1143299;982074;1197056;;;;;;
307610,566;165511;4575;168448;977843;977843;1029120;1143354;982418;1197568;;;;;;
307632,876;166367;5987;167936;977843;977844;1029120;1144210;983831;1197056;;;;;;
307661,203;167779;6641;166912;977844;977843;1029120;1145623;984484;1196032;;;;;;
307667,137;166385;5481;167424;977843;977843;1029120;1144228;983324;1196544;;;;;;
307681,454;165225;5683;166400;977843;978827;1029120;1143068;984510;1195520;;;;;;
307711,366;164403;7501;166400;978827;979132;1029120;1143230;986633;1195520;;;;;;
307730,028;166221;5055;166912;979132;979363;1029120;1145353;984418;1196032;;;;;;
308018,283;163208;4702;166400;979363;979755;1029120;1142571;984457;1195520;;;;;;
308074,180;162902;7519;165888;979755;980035;1029120;1142657;987554;1195008;;;;;;
308130,949;165215;8388;166400;980035;980035;1029120;1145250;988423;1195520;;;;;;
308159,021;166084;6883;164352;980035;980035;1029120;1146119;986918;1193472;;;;;;
308183,491;162531;7543;163328;980035;980035;1029120;1142566;987578;1192448;;;;;;
308247,844;163191;9347;163840;980035;980036;1029120;1143226;989383;1192960;;;;;;
308258,038;162947;7507;164352;980036;980035;1029120;1142983;987542;1193472;;;;;;
308317,426;161107;6847;164352;980035;980764;1029120;1141142;987611;1193472;;;;;;
308365,747;160447;6943;164352;980764;981099;1029120;1141211;988042;1193472;;;;;;
308425,967;160543;6943;164864;981099;981099;1029120;1141642;988042;1193984;;;;;;
308458,741;161055;10208;164352;981099;981099;1029120;1142154;991307;1193472;;;;;;
308526,602;164320;9790;162304;981099;981387;1029120;1145419;991177;1191424;;;;;;
308568,665;161342;10454;162304;981387;981387;1029120;1142729;991841;1191424;;;;;;
308583,960;162006;9095;162304;981387;982039;1029120;1143393;991134;1191424;;;;;;
308603,349;158599;8127;162304;982039;982351;1029120;1140638;990478;1191424;;;;;;
308646,432;157631;8031;162816;982351;982447;1029120;1139982;990478;1191936;;;;;;
308662,401;158047;11971;162304;982447;982998;1029120;1140494;994969;1191424;;;;;;
308695,379;161987;7935;162304;982998;983879;1029120;1144985;991814;1191424;;;;;;
308704,814;157274;9913;159744;983879;984999;1029120;1141153;994912;1188864;;;;;;
308726,215;159417;9875;161792;984999;985471;1029120;1144416;995346;1190912;;;;;;
308748,470;158355;7167;161792;985471;986055;1029120;1143826;993222;1190912;;;;;;
308768,743;155647;8068;162304;986055;987478;1029120;1141702;995546;1191424;;;;;;
308778,391;157572;8003;162304;987478;988158;1029120;1145050;996161;1191424;;;;;;
308801,474;157507;6333;162816;988158;988742;1029120;1145665;995075;1191936;;;;;;
308878,039;156861;8520;162816;988742;989749;1029120;1145603;998269;1191936;;;;;;
308885,343;159048;7190;163328;989749;991069;1029120;1148797;998259;1192448;;;;;;
308906,048;158742;4962;163328;991069;991709;1029120;1149811;996671;1192448;;;;;;
308920,518;156514;4190;162304;991709;992478;1029120;1148223;996668;1191424;;;;;;
308929,371;154684;4798;162816;992477;994901;1029120;1147161;999699;1191936;;;;;;
308952,137;155326;5174;163328;994901;996172;1029120;1150227;1001346;1192448;;;;;;
309033,131;156214;3619;162816;996172;997221;1029120;1152386;1000840;1191936;;;;;;
309050,389;42423;5941;163328;997220;998979;1029120;1039643;1004920;1192448;;;;;;
309050,411;5941;0;163328;998979;960718;1029120;1004920;960718;1192448;186132;185850;786432;1191052;1146568;1978880
309172,454;151040;4088;162816;960718;960718;1029120;1111758;964806;1191936;;;;;;
309192,662;155128;960;163328;960718;962650;1029120;1115846;963610;1192448;;;;;;
309295,383;152512;1200;153088;962650;962794;1029120;1115162;963994;1182208;;;;;;
309334,993;152585;6603;163328;962794;963619;1029120;1115379;970222;1192448;;;;;;
309453,353;157643;3455;162816;963619;963618;1029120;1121262;967073;1191936;;;;;;
309608,045;154495;3151;163840;963618;963618;1029120;1118113;966769;1192960;;;;;;
309690,955;155215;5496;163328;963618;963618;1029120;1118833;969114;1192448;;;;;;
309733,458;157560;5795;164352;963618;963619;1029120;1121178;969414;1193472;;;;;;
309775,609;159395;5581;164352;963619;963619;1029120;1123014;969200;1193472;;;;;;
309816,429;159181;9331;162816;963619;963618;1029120;1122800;972949;1191936;;;;;;
309852,612;161907;7039;163840;963618;963619;1029120;1125525;970658;1192960;;;;;;
309928,785;159615;9383;161792;963619;963618;1029120;1123234;973001;1190912;;;;;;
309963,429;159911;7538;162816;963618;963618;1029120;1123529;971156;1191936;;;;;;
309983,427;158066;9027;161792;963618;963618;1029120;1121684;972645;1190912;;;;;;
309997,124;158531;9006;162304;963618;963619;1029120;1122149;972625;1191424;;;;;;
310016,095;158510;6974;162816;963619;964811;1029120;1122129;971785;1191936;;;;;;
310035,061;156990;6078;162304;964811;965747;1029120;1121801;971825;1191424;;;;;;
310050,459;156094;5438;163328;965747;966555;1029120;1121841;971993;1192448;;;;;;
310061,495;156990;4669;163328;966555;968097;1029120;1123545;972766;1192448;;;;;;
310064,267;156221;3104;163328;968097;968960;1029120;1124318;972064;1192448;;;;;;
310070,388;154656;1921;163328;968960;970640;1029120;1123616;972561;1192448;;;;;;
310072,674;153473;4036;163840;970640;971017;1029120;1124113;975053;1192960;;;;;;
310083,374;156100;2848;163328;971017;971312;1029120;1127117;974160;1192448;;;;;;
310100,640;154912;2480;163840;971312;971544;1029120;1126224;974024;1192960;;;;;;
310114,203;155056;1088;163840;971544;973176;1029120;1126600;974264;1192960;;;;;;
310137,095;153664;528;163840;973176;973768;1029120;1126840;974296;1192960;;;;;;
310153,053;153104;480;163840;973768;974024;1029120;1126872;974504;1192960;;;;;;
310166,499;153056;848;163840;974024;974152;1029120;1127080;975000;1192960;;;;;;
310184,286;153424;2952;163840;974152;974345;1029120;1127576;977297;1192960;;;;;;
310195,001;155528;1377;164864;974345;974530;1029120;1129873;975907;1193984;;;;;;
310211,346;156001;4643;164864;974530;974705;1029120;1130531;979348;1193984;;;;;;
310221,233;159267;1376;165376;974705;976424;1029120;1133972;977800;1194496;;;;;;
310227,143;157024;864;165376;976424;977056;1029120;1133448;977920;1194496;;;;;;
310241,217;156512;2370;166400;977056;977201;1029120;1133568;979571;1195520;;;;;;
310246,887;159554;768;165888;977201;977656;1029120;1136755;978424;1195008;;;;;;
310257,433;157952;844;166912;977656;978105;1029120;1135608;978949;1196032;;;;;;
310268,687;159052;850;166400;978105;978320;1029120;1137157;979170;1195520;;;;;;
310295,811;159058;1248;167424;978320;978425;1029120;1137378;979673;1196544;;;;;;
310324,075;160480;1199;166912;978425;979025;1029120;1138905;980224;1196032;;;;;;
310345,030;160431;4306;166912;979025;979337;1029120;1139456;983643;1196032;;;;;;
310356,680;164050;3436;167424;979337;979953;1029120;1143387;983389;1196544;;;;;;
310369,046;163180;864;167936;979953;981513;1029120;1143133;982377;1197056;;;;;;
310380,613;161120;1005;167424;981513;981753;1029120;1142633;982758;1196544;;;;;;
310397,708;161261;800;168448;981753;981985;1029120;1143014;982785;1197568;;;;;;
310423,238;162080;1937;167936;981985;982161;1029120;1144065;984098;1197056;;;;;;
310428,867;163217;1746;168960;982161;982305;1029120;1145378;984051;1198080;;;;;;
310444,813;164050;992;168448;982305;982465;1029120;1146355;983457;1197568;;;;;;
310462,433;163296;897;169472;982465;982666;1029120;1145761;983563;1198592;;;;;;
310484,357;164737;2936;169472;982666;982761;1029120;1147403;985697;1198592;;;;;;
310504,962;166776;4292;168448;982761;982969;1029120;1149537;987261;1197568;;;;;;
310518,173;167108;5399;168448;982969;984457;1029120;1150077;989856;1197568;;;;;;
310533,112;168215;929;168448;984457;986150;1029120;1152672;987079;1197568;;;;;;
310547,868;162721;4923;166912;986150;986429;1029120;1148871;991352;1196032;;;;;;
310560,130;166715;5430;166400;986429;987029;1029120;1153144;992459;1195520;;;;;;
310572,396;164150;5133;166912;987029;987884;1029120;1151179;993017;1196032;;;;;;
310579,836;163853;4772;165888;987884;989129;1029120;1151737;993901;1195008;;;;;;
310598,413;162468;1280;166400;989129;991585;1029120;1151597;992865;1195520;;;;;;
310613,483;158976;2274;166912;991585;991985;1029120;1150561;994259;1196032;;;;;;
310632,843;160993;1260;166912;991985;992201;1029120;1152978;993461;1196032;;;;;;
310657,030;159980;992;167424;992201;992705;1029120;1152181;993697;1196544;;;;;;
310675,823;160736;512;167424;992705;993001;1029120;1153441;993513;1196544;;;;;;
310689,268;160256;640;167936;993001;993193;1029120;1153257;993833;1197056;;;;;;
310734,937;160896;783;167424;993193;993329;1029120;1154089;994112;1196544;;;;;;
310774,928;161039;1792;168448;993329;993816;1029120;1154368;995608;1197568;;;;;;
310830,295;163072;5768;167424;993816;993816;1029120;1156888;999584;1196544;;;;;;
310854,868;167048;3377;167424;993816;993817;1029120;1160864;997194;1196544;;;;;;
310964,088;163121;6216;166400;993817;993816;1029120;1156938;1000032;1195520;;;;;;
311108,709;165960;4383;166912;993816;993817;1029120;1159776;998200;1196032;;;;;;
311184,598;163103;4463;166912;993817;993817;1029120;1156920;998280;1196032;;;;;;
311259,061;163183;6115;164864;993817;993817;1029120;1157000;999932;1193984;;;;;;
311298,026;162787;8020;164864;993817;993817;1029120;1156604;1001837;1193984;;;;;;
311310,849;164660;7498;163840;993817;993817;1029120;1158477;1001315;1192960;;;;;;
311362,217;161098;8115;161792;993817;993817;1029120;1154915;1001932;1190912;;;;;;
311401,055;161715;11198;160256;993817;993817;1029120;1155532;1005015;1189376;;;;;;
311464,812;159678;9504;158208;993817;993817;1029120;1153495;1003321;1187328;;;;;;
311483,127;157984;9378;159744;993817;993817;1029120;1151801;1003195;1188864;;;;;;
311521,433;154786;10978;156672;993817;993817;1029120;1148603;1004795;1185792;;;;;;
311564,888;156386;11363;158208;993817;993816;1029120;1150203;1005179;1187328;;;;;;
311587,583;153699;10510;153088;993816;993921;1029120;1147515;1004431;1182208;;;;;;
311723,013;152846;11054;157184;993921;994673;1029120;1146767;1005727;1186304;;;;;;
311739,588;151342;11830;152576;994673;994817;1029120;1146015;1006647;1181696;;;;;;
311766,407;152083;9981;157696;994816;996097;1029120;1146899;1006078;1186816;;;;;;
311788,545;149757;9342;157184;996097;996713;1029120;1145854;1006055;1186304;;;;;;
311801,741;149118;8031;158720;996713;997721;1029120;1145831;1005752;1187840;;;;;;
311842,604;149855;6526;158208;997721;999033;1029120;1147576;1005559;1187328;;;;;;
311859,528;148350;5855;159744;999033;1000072;1029120;1147383;1005927;1188864;;;;;;
311890,101;149727;5876;159232;1000072;1001496;1029120;1149799;1007372;1188352;;;;;;
311923,725;149748;3776;159744;1001496;1002463;1029120;1151244;1006239;1188864;;;;;;
312000,672;148160;4002;159744;1002463;1002887;1029120;1150623;1006889;1188864;;;;;;
312035,135;148386;3808;160256;1002887;1002887;1029120;1151273;1006695;1189376;;;;;;
312088,699;149216;4482;160256;1002887;1002888;1029120;1152103;1007370;1189376;;;;;;
312094,477;149890;6414;161280;1002888;1002887;1029120;1152778;1009301;1190400;;;;;;
312115,799;153358;4639;160768;1002887;1003735;1029120;1156245;1008374;1189888;;;;;;
312131,685;151583;6340;162304;1003735;1004103;1029120;1155318;1010443;1191424;;;;;;
312150,452;155332;8142;161792;1004103;1004336;1029120;1159435;1012478;1190912;;;;;;
312158,152;157134;5311;162816;1004336;1004767;1029120;1161470;1010078;1191936;;;;;;
312166,152;155327;5023;162304;1004767;1005208;1029120;1160094;1010231;1191424;;;;;;
312175,390;155039;5731;163840;1005208;1006343;1029120;1160247;1012074;1192960;;;;;;
312184,200;157795;5251;163328;1006343;1007360;1029120;1164138;1012611;1192448;;;;;;
312210,558;157315;3503;163840;1007360;1007887;1029120;1164675;1011390;1192960;;;;;;
312230,393;156079;4678;163840;1007887;1008990;1029120;1163966;1013668;1192960;;;;;;
312250,861;157254;5268;164864;1008990;1009943;1029120;1166244;1015211;1193984;;;;;;
312277,527;159380;1517;164352;1009943;1011958;1029120;1169323;1013475;1193472;;;;;;
312330,263;155629;1104;164352;1011958;1012310;1029120;1167587;1013414;1193472;;;;;;
312422,103;154704;5271;164352;1012310;1012686;1029120;1167014;1017957;1193472;;;;;;
312477,852;158871;6792;163840;1012686;1013593;1029120;1171557;1020385;1192960;;;;;;
312497,311;160392;2976;164352;1013593;1013592;1029120;1173985;1016568;1193472;;;;;;
312527,824;156576;5182;164864;1013592;1013593;1029120;1170168;1018775;1193984;;;;;;
312581,940;159806;5075;164864;1013593;1013592;1029120;1173399;1018667;1193984;;;;;;
312618,681;159699;9227;163328;1013592;1013593;1029120;1173291;1022820;1192448;;;;;;
312645,237;162827;7399;164352;1013593;1013593;1029120;1176420;1020992;1193472;;;;;;
312654,703;76903;5839;164352;1013593;1013593;1029120;1090496;1019432;1193472;;;;;;
312654,726;5839;0;164352;1013593;968697;1029120;1019432;968697;1193472;185858;185839;786432;1205290;1154536;1979904
312686,547;153600;4340;164352;968697;968697;1029120;1122297;973037;1193472;;;;;;
312706,729;157940;5407;165376;968697;968697;1029120;1126637;974104;1194496;;;;;;
312722,236;160543;4176;164864;968697;968697;1029120;1129240;972873;1193984;;;;;;
312734,643;159310;4688;165888;968698;968697;1029120;1128008;973385;1195008;;;;;;
312759,659;160848;9171;165376;968697;968697;1029120;1129545;977868;1194496;;;;;;
312776,053;165331;5474;164352;968697;968697;1029120;1134028;974171;1193472;;;;;;
312856,980;160045;8958;163840;968697;968697;1029120;1128742;977655;1192960;;;;;;
312912,439;163582;5092;164352;968697;969806;1029120;1132279;974898;1193472;;;;;;
313006,151;158692;6250;164352;969806;969805;1029120;1128498;976055;1193472;;;;;;
313078,048;159850;8595;163840;969805;969806;1029120;1129655;978401;1192960;;;;;;
313098,065;162014;10737;164352;969806;969884;1029120;1131820;980621;1193472;;;;;;
313105,056;164337;7344;162304;969884;970708;1029120;1134221;978052;1191424;;;;;;
313195,451;158896;5167;163328;970708;971772;1029120;1129604;976939;1192448;;;;;;
313363,900;156719;6819;163840;971772;972676;1029120;1128491;979495;1192960;;;;;;
313439,975;158883;5342;163328;972676;972676;1029120;1131559;978018;1192448;;;;;;
313502,009;157406;7075;164352;972676;972676;1029120;1130082;979751;1193472;;;;;;
313531,593;160675;7843;164352;972676;972676;1029120;1133351;980519;1193472;;;;;;
313617,298;161443;7267;164352;972676;972676;1029120;1134119;979943;1193472;;;;;;
313656,253;160867;7358;164352;972676;972676;1029120;1133543;980034;1193472;;;;;;
313821,714;160958;9779;163328;972676;972676;1029120;1133634;982455;1192448;;;;;;
313860,914;162355;7358;163840;972676;972676;1029120;1135031;980034;1192960;;;;;;
313942,645;159934;7662;164352;972676;972676;1029120;1132610;980338;1193472;;;;;;
313970,159;160750;7369;163840;972676;972988;1029120;1133426;980357;1192960;;;;;;
314017,361;160457;7441;164864;972988;973036;1029120;1133445;980477;1193984;;;;;;
314055,392;161553;8464;164352;973036;973684;1029120;1134589;982148;1193472;;;;;;
314105,219;162576;10351;163328;973684;974180;1029120;1136260;984531;1192448;;;;;;
314155,448;162927;10446;163328;974180;974453;1029120;1137107;984899;1192448;;;;;;
314248,810;162976;11749;160256;974452;975616;1029120;1137428;987365;1189376;;;;;;
314281,697;160229;13267;161792;975616;976535;1029120;1135845;989802;1190912;;;;;;
314285,843;161747;13311;156160;976535;984987;1029120;1138282;998298;1185280;;;;;;
314386,625;156159;11087;154112;984987;985859;1029120;1141146;996946;1183232;;;;;;
314468,154;153935;13799;156160;985859;986611;1029120;1139794;1000410;1185280;;;;;;
314503,189;151527;9471;156672;986611;987427;1029120;1138138;996898;1185792;;;;;;
314539,949;147199;9567;157184;987427;987539;1029120;1134626;997106;1186304;;;;;;
314621,737;148319;10115;156672;987539;988107;1029120;1135858;998222;1185792;;;;;;
314655,597;148867;9119;158208;988107;989585;1029120;1136974;998704;1187328;;;;;;
314667,221;150431;11299;158208;989585;990114;1029120;1140016;1001413;1187328;;;;;;
314689,761;152611;8627;158720;990114;992498;1029120;1142725;1001125;1187840;;;;;;
314715,061;150963;7359;158720;992498;994905;1029120;1143461;1002264;1187840;;;;;;
314739,803;149695;4703;158208;994905;995369;1029120;1144600;1000072;1187328;;;;;;
314747,012;146642;5747;158720;995370;996090;1029120;1142012;1001837;1187840;;;;;;
314755,743;148083;6682;159232;996090;997122;1029120;1144173;1003804;1188352;;;;;;
314784,633;149530;3327;158720;997122;998145;1029120;1146652;1001472;1187840;;;;;;
314806,779;146154;1940;158720;998145;1000337;1029120;1144299;1002277;1187840;;;;;;
314837,958;144276;3688;158720;1000337;1001393;1029120;1144613;1005081;1187840;;;;;;
314855,809;146024;929;158720;1001393;1003120;1029120;1147417;1004049;1187840;;;;;;
314880,852;143265;3908;158720;1003120;1003457;1029120;1146385;1007365;1187840;;;;;;
314886,460;146244;4752;159744;1003457;1003913;1029120;1149701;1008665;1188864;;;;;;
314913,201;148624;1348;159232;1003913;1005849;1029120;1152537;1007197;1188352;;;;;;
314934,434;145220;5766;160768;1005849;1006440;1029120;1151069;1012206;1189888;;;;;;
314943,026;151174;1489;159744;1006440;1008480;1029120;1157614;1009969;1188864;;;;;;
314957,694;146897;4132;161792;1008480;1009001;1029120;1155377;1013133;1190912;;;;;;
314979,988;151588;3812;160768;1009001;1009953;1029120;1160589;1013765;1189888;;;;;;
315078,824;151268;1249;162304;1009953;1011681;1029120;1161221;1012930;1191424;;;;;;
315099,561;150753;1427;162304;1011681;1011817;1029120;1162434;1013244;1191424;;;;;;
315108,535;150931;1750;162816;1011817;1012347;1029120;1162748;1014097;1191936;;;;;;
315128,646;151766;3796;162304;1012347;1012820;1029120;1164113;1016616;1191424;;;;;;
315161,025;153812;1524;163840;1012820;1014660;1029120;1166632;1016184;1192960;;;;;;
315194,155;154100;6261;163840;1014660;1015196;1029120;1168760;1021457;1192960;;;;;;
315205,054;158837;1088;163840;1015196;1017299;1029120;1174033;1018387;1192960;;;;;;
315216,956;153664;1313;163840;1017299;1017668;1029120;1170963;1018981;1192960;;;;;;
315248,966;153889;2063;164864;1017668;1018043;1029120;1171557;1020106;1193984;;;;;;
315296,893;156175;1873;164352;1018043;1019099;1029120;1174218;1020972;1193472;;;;;;
315307,646;155985;1216;165376;1019099;1019099;1029120;1175084;1020315;1194496;;;;;;
315313,206;156352;1504;164864;1019099;1019371;1029120;1175451;1020875;1193984;;;;;;
315335,270;156640;1246;166400;1019371;1020259;1029120;1176011;1021505;1195520;;;;;;
315376,949;158430;928;165888;1020259;1020859;1029120;1178689;1021787;1195008;;;;;;
315388,681;158112;1008;166912;1020859;1021275;1029120;1178971;1022283;1196032;;;;;;
315406,588;159216;1760;166400;1021275;1021659;1029120;1180491;1023419;1195520;;;;;;
315431,983;159968;1600;167424;1021659;1022003;1029120;1181627;1023603;1196544;;;;;;
315440,784;161344;2744;167424;1022003;1022387;1029120;1183347;1025131;1196544;;;;;;
315482,461;162488;4244;167936;1022387;1022963;1029120;1184875;1027207;1197056;;;;;;
315494,135;165012;2193;167936;1022963;1024940;1029120;1187975;1027133;1197056;;;;;;
315496,841;162961;1794;168448;1024940;1025515;1029120;1187901;1027309;1197568;;;;;;
315502,609;163074;992;167936;1025515;1025955;1029120;1188589;1026947;1197056;;;;;;
315517,189;162272;1921;168960;1025955;1026243;1029120;1188227;1028164;1198080;;;;;;
315536,898;164225;1152;168448;1026243;1026595;1029120;1190468;1027747;1197568;;;;;;
315557,648;163456;4659;167936;1026595;1027252;1029120;1190051;1031911;1197056;;;;;;
315564,650;166451;1029;168448;1027252;1029507;1029632;1193703;1030536;1198080;;;;;;
315564,666;1029;0;168448;1029507;974675;1053184;1030536;974675;1221632;186231;185865;786432;1216767;1160540;2008064
315593,673;161792;5113;166912;974675;974676;1053184;1136467;979789;1220096;;;;;;
315643,264;165881;2338;167936;974676;977728;1053184;1140557;980066;1221120;;;;;;
315651,807;163106;1280;168448;977728;978152;1053184;1140834;979432;1221632;;;;;;
315656,918;163072;4101;168448;978152;978664;1053184;1141224;982765;1221632;;;;;;
315667,457;165893;3467;168448;978664;979032;1053184;1144557;982499;1221632;;;;;;
315723,175;165259;4916;166912;979032;979897;1053184;1144291;984813;1220096;;;;;;
315756,437;166708;3700;167936;979897;980849;1053184;1146605;984549;1221120;;;;;;
315765,331;164468;1489;167936;980849;982705;1053184;1145317;984194;1221120;;;;;;
315776,095;162257;4755;167936;982705;982993;1053184;1144962;987748;1221120;;;;;;
315784,211;165523;7163;167936;982993;984056;1053184;1148516;991219;1221120;;;;;;
315789,908;167931;4453;164864;984056;984972;1053184;1151987;989425;1218048;;;;;;
315798,145;162149;3002;166400;984972;985829;1053184;1147121;988831;1219584;;;;;;
315813,955;160698;1612;166912;985829;987453;1053184;1146527;989065;1220096;;;;;;
315822,817;160332;2518;166912;987453;987756;1053184;1147785;990274;1220096;;;;;;
315826,282;161238;1717;167424;987756;988589;1053184;1148994;990306;1220608;;;;;;
315832,956;161461;4789;167424;988589;989004;1053184;1150050;993793;1220608;;;;;;
315853,144;164533;2800;167424;989004;990253;1053184;1153537;993053;1220608;;;;;;
315868,693;162544;896;167424;990253;991892;1053184;1152797;992788;1220608;;;;;;
315881,539;160640;5594;166400;991892;992372;1053184;1152532;997966;1219584;;;;;;
315893,995;164314;1728;166912;992372;994493;1053184;1156686;996221;1220096;;;;;;
315946,985;160448;4873;166400;994493;994765;1053184;1154941;999638;1219584;;;;;;
315979,871;163593;3040;166912;994765;995590;1053184;1158358;998630;1220096;;;;;;
316012,750;161760;3571;167936;995590;995933;1053184;1157350;999504;1221120;;;;;;
316073,326;163827;7131;167424;995933;996445;1053184;1159760;1003576;1220608;;;;;;
316088,455;167387;5005;166400;996445;996445;1053184;1163832;1001450;1219584;;;;;;
316093,490;163725;2628;166912;996445;997380;1053184;1160170;1000008;1220096;;;;;;
316255,409;161348;3714;167424;997380;998020;1053184;1158728;1001734;1220608;;;;;;
316307,678;162946;5144;166912;998020;998644;1053184;1160966;1003788;1220096;;;;;;
316341,628;164284;4004;167424;998644;999316;1053184;1162928;1003320;1220608;;;;;;
316373,582;163748;4596;167424;999316;999924;1053184;1163064;1004520;1220608;;;;;;
316395,874;164340;2816;167936;999924;999923;1053184;1164264;1002739;1221120;;;;;;
316447,377;163072;5851;167424;999923;999923;1053184;1162995;1005774;1220608;;;;;;
316608,079;166107;7651;164352;999923;1000879;1053184;1166030;1008530;1217536;;;;;;
316627,698;164323;3903;165888;1000879;1001822;1053184;1165202;1005725;1219072;;;;;;
316737,738;160575;7301;165376;1001822;1001822;1053184;1162397;1009123;1218560;;;;;;
316759,642;163973;4816;165888;1001822;1001822;1053184;1165795;1006638;1219072;;;;;;
316796,493;161488;7684;164864;1001822;1001823;1053184;1163310;1009507;1218048;;;;;;
316818,366;163332;6867;165376;1001823;1001822;1053184;1165155;1008689;1218560;;;;;;
316848,690;162515;6019;165376;1001822;1001822;1053184;1164337;1007841;1218560;;;;;;
316860,397;161667;6171;165376;1001822;1001822;1053184;1163489;1007993;1218560;;;;;;
316868,100;161819;7831;164352;1001822;1002438;1053184;1163641;1010269;1217536;;;;;;
316884,061;162455;5200;164864;1002438;1003597;1053184;1164893;1008797;1218048;;;;;;
316913,637;159824;5008;165376;1003597;1004421;1053184;1163421;1009429;1218560;;;;;;
316923,801;160656;6251;165376;1004421;1005421;1053184;1165077;1011672;1218560;;;;;;
316947,728;161899;7724;164864;1005421;1006085;1053184;1167320;1013809;1218048;;;;;;
316960,970;163372;4279;165376;1006085;1006621;1053184;1169457;1010900;1218560;;;;;;
316979,505;159927;4044;165376;1006621;1007430;1053184;1166548;1011474;1218560;;;;;;
317004,523;159692;3379;165376;1007430;1008525;1053184;1167122;1011904;1218560;;;;;;
317014,732;159027;4573;165888;1008525;1009197;1053184;1167552;1013770;1219072;;;;;;
317107,160;160733;1662;165376;1009197;1010869;1053184;1169930;1012531;1218560;;;;;;
317217,502;157822;896;165376;1010873;1011582;1053184;1168695;1012478;1218560;;;;;;
317241,305;156544;3667;165376;1011582;1011583;1053184;1168126;1015250;1218560;;;;;;
317297,381;159315;2849;165888;1011583;1011582;1053184;1170898;1014431;1219072;;;;;;
317310,561;159521;2977;165888;1011582;1011582;1053184;1171103;1014559;1219072;;;;;;
317365,462;159649;3879;166400;1011582;1011583;1053184;1171231;1015462;1219584;;;;;;
317475,341;161575;7284;165376;1011583;1011582;1053184;1173158;1018866;1218560;;;;;;
317492,916;164980;4993;165888;1011582;1011582;1053184;1176562;1016575;1219072;;;;;;
317498,381;161665;5043;165888;1011582;1011583;1053184;1173247;1016626;1219072;;;;;;
317506,799;161715;6961;165376;1011583;1012262;1053184;1173298;1019223;1218560;;;;;;
317540,177;163633;5554;165888;1012262;1012606;1053184;1175895;1018160;1219072;;;;;;
317576,263;162226;5332;166400;1012606;1013414;1053184;1174832;1018746;1219584;;;;;;
317601,914;162516;7608;164864;1013414;1014102;1053184;1175930;1021710;1218048;;;;;;
317611,011;164792;4672;165888;1014102;1014981;1053184;1178894;1019653;1219072;;;;;;
317667,063;160832;5397;165376;1014981;1016038;1053184;1175813;1021435;1218560;;;;;;
317699,477;161557;6520;165888;1016038;1017359;1053184;1177595;1023879;1219072;;;;;;
317711,074;163192;3744;165888;1017359;1018418;1053184;1180551;1022162;1219072;;;;;;
317719,937;160416;784;165888;1018418;1020538;1053184;1178834;1021322;1219072;;;;;;
317733,783;157456;6592;163328;1020538;1020890;1053184;1177994;1027482;1216512;;;;;;
317746,073;163264;1200;165376;1020890;1023066;1053184;1184154;1024266;1218560;;;;;;
317764,783;156848;5660;165376;1023066;1023291;1053184;1179914;1028951;1218560;;;;;;
317784,661;161301;2304;165376;1023291;1024336;1053184;1184592;1026640;1218560;;;;;;
317813,110;157952;7864;163840;1024336;1024931;1053184;1182288;1032795;1217024;;;;;;
317824,635;163512;8469;162816;1024931;1026703;1053184;1188443;1035172;1216000;;;;;;
317849,185;161045;1216;163840;1026703;1029804;1053184;1187748;1031020;1217024;;;;;;
317876,891;153792;2496;163840;1029804;1030776;1053184;1183596;1033272;1217024;;;;;;
317892,484;155072;4036;163840;1030776;1032776;1053184;1185848;1036812;1217024;;;;;;
317896,591;156612;832;164352;1032776;1034653;1053184;1189388;1035485;1217536;;;;;;
317917,138;154432;4447;164352;1034653;1034933;1053184;1189085;1039380;1217536;;;;;;
318010,218;158047;8952;162816;1034933;1035926;1053184;1192980;1044878;1216000;;;;;;
318025,008;161528;6389;163840;1035926;1036846;1053184;1197454;1043235;1217024;;;;;;
318027,063;158965;10948;160768;1036846;1039794;1053184;1195811;1050742;1213952;;;;;;
318055,662;160452;2496;162304;1039794;1042458;1053184;1200246;1044954;1215488;;;;;;
318093,890;152000;1521;162304;1042458;1043979;1053184;1194458;1045500;1215488;;;;;;
318111,098;151025;4257;162304;1043979;1044491;1053184;1195004;1048748;1215488;;;;;;
318126,903;153761;1362;163328;1044491;1046286;1053184;1198252;1047648;1216512;;;;;;
318155,979;152914;4005;163328;1046286;1046566;1053184;1199200;1050571;1216512;;;;;;
318175,825;155557;3104;164352;1046566;1047469;1053184;1202123;1050573;1217536;;;;;;
318194,075;156192;5797;163840;1047469;1048022;1053184;1203661;1053819;1217024;;;;;;
318198,487;158885;1389;164352;1048022;1049774;1053184;1206907;1051163;1217536;;;;;;
318207,014;154989;4957;164352;1049774;1050262;1053184;1204763;1055219;1217536;;;;;;
318207,032;4957;0;164352;1050262;983768;1061888;1055219;983768;1226240;186458;185956;786432;1241677;1169724;2012672
318215,755;153600;4595;165376;983768;983769;1061888;1137368;988364;1227264;;;;;;
318228,481;159731;4575;164864;983769;984852;1061888;1143500;989427;1226752;;;;;;
318243,894;159711;684;164864;984852;987236;1061888;1144563;987920;1226752;;;;;;
318257,581;156332;1057;165376;987236;987515;1061888;1143568;988572;1227264;;;;;;
318295,325;156705;4765;165888;987515;987884;1061888;1144220;992649;1227776;;;;;;
318321,657;160925;1119;165376;987884;990124;1061888;1148809;991243;1227264;;;;;;
318322,267;157279;5071;165888;990124;991020;1061888;1147403;996091;1227776;;;;;;
318322,818;161743;1127;165888;991020;993800;1061888;1152763;994927;1227776;;;;;;
318326,826;157799;1571;195072;993800;994039;1061888;1151599;995610;1256960;;;;;;
318333,889;188451;2963;195584;994039;994603;1061888;1182490;997566;1257472;;;;;;
318370,377;189843;3387;183808;994603;994930;1061888;1184446;998317;1245696;;;;;;
318371,937;183611;7267;221696;994930;997718;1061888;1178541;1004985;1283584;;;;;;
318403,207;221283;3487;209920;997718;999998;1061888;1219001;1003485;1271808;;;;;;
318423,099;209823;1399;200704;999998;1000694;1061888;1209821;1002093;1262592;;;;;;
318425,585;200567;800;193024;1000694;1000917;1061888;1201261;1001717;1254912;;;;;;
318428,820;192800;8187;193536;1000917;1001197;1061888;1193717;1009384;1255424;;;;;;
318491,683;193531;7116;186368;1001197;1006361;1061888;1194728;1013477;1248256;;;;;;
318551,015;186316;5188;178688;1006361;1007420;1061888;1192677;1012608;1240576;;;;;;
318621,084;178116;1407;168960;1007420;1009939;1061888;1185536;1011346;1230848;;;;;;
318690,102;168831;5832;167936;1009939;1010500;1061888;1178770;1016332;1229824;;;;;;
318713,878;167624;2449;159232;1010500;1011427;1061888;1178124;1013876;1221120;;;;;;
318722,563;159121;768;174080;1011427;1013111;1061888;1170548;1013879;1235968;;;;;;
318754,055;173824;4115;172544;1013111;1013463;1061888;1186935;1017578;1234432;;;;;;
318833,854;171539;3667;165888;1013463;1014111;1061888;1185002;1017778;1227776;;;;;;
318857,010;165459;4625;165888;1014111;1014769;1061888;1179570;1019394;1227776;;;;;;
318872,819;165393;3388;164352;1014769;1015449;1061888;1180162;1018837;1226240;;;;;;
318879,354;164156;4740;166912;1015449;1016121;1061888;1179605;1020861;1228800;;;;;;
318902,238;163460;4832;166912;1016121;1016681;1061888;1179581;1021513;1228800;;;;;;
318911,047;163552;6136;165888;1016681;1017065;1061888;1180233;1023201;1227776;;;;;;
318924,996;163832;4436;166400;1017065;1017569;1061888;1180897;1022005;1228288;;;;;;
318950,735;162132;4116;166912;1017569;1018481;1061888;1179701;1022597;1228800;;;;;;
319028,042;162836;7300;166400;1018481;1019041;1061888;1181317;1026341;1228288;;;;;;
319123,019;166020;4275;166912;1019041;1020130;1061888;1185061;1024405;1228800;;;;;;
319146,773;162483;832;166400;1020130;1022144;1061888;1182613;1022976;1228288;;;;;;
319201,001;159040;4148;166912;1022144;1022145;1061888;1181184;1026293;1228800;;;;;;
319291,635;162356;2973;166400;1022145;1022145;1061888;1184501;1025118;1228288;;;;;;
319340,813;161181;6609;165888;1022145;1022144;1061888;1183326;1028753;1227776;;;;;;
319432,686;164305;8700;166400;1022144;1022914;1061888;1186449;1031614;1228288;;;;;;
319442,465;166396;5905;163328;1022914;1023730;1061888;1189310;1029635;1225216;;;;;;
319466,848;160529;4144;164864;1023730;1024098;1061888;1184259;1028242;1226752;;;;;;
319480,710;158768;4990;165888;1024098;1025011;1061888;1182866;1030001;1227776;;;;;;
319513,992;161150;3392;165376;1025011;1025865;1061888;1186161;1029257;1227264;;;;;;
319556,890;159552;3136;165888;1025865;1026177;1061888;1185417;1029313;1227776;;;;;;
319618,931;159808;4929;165888;1026177;1026177;1061888;1185985;1031106;1227776;;;;;;
319639,052;161601;3632;166400;1026177;1026178;1061888;1187778;1029810;1228288;;;;;;
319649,323;161328;4030;166400;1026178;1026177;1061888;1187506;1030207;1228288;;;;;;
319724,798;161726;6153;165888;1026177;1026618;1061888;1187903;1032771;1227776;;;;;;
319797,849;163849;6019;166400;1026618;1026826;1061888;1190467;1032845;1228288;;;;;;
319817,124;163715;6675;165376;1026826;1026826;1061888;1190541;1033501;1227264;;;;;;
319832,584;163347;5151;165888;1026826;1026826;1061888;1190173;1031977;1227776;;;;;;
319868,816;161823;8673;163328;1026826;1028363;1061888;1188649;1037036;1225216;;;;;;
319878,460;163297;6370;164864;1028363;1028763;1061888;1191660;1035133;1226752;;;;;;
319904,820;160994;7427;164864;1028763;1029083;1061888;1189757;1036510;1226752;;;;;;
319912,350;162051;5151;164864;1029083;1030395;1061888;1191134;1035546;1226752;;;;;;
319923,038;159775;5571;165376;1030395;1031179;1061888;1190170;1036750;1227264;;;;;;
319927,524;160707;5636;164864;1031179;1032251;1061888;1191886;1037887;1226752;;;;;;
319933,495;160772;3419;165888;1032251;1033211;1061888;1193023;1036630;1227776;;;;;;
319939,938;160091;1632;158720;1033211;1035346;1061888;1193302;1036978;1220608;;;;;;
319950,657;158304;848;165376;1035346;1036314;1061888;1193650;1037162;1227264;;;;;;
319960,764;156496;889;156672;1036314;1036674;1061888;1192810;1037563;1218560;;;;;;
319987,217;156537;4213;165376;1036674;1036763;1061888;1193211;1040976;1227264;;;;;;
320008,170;159349;2485;164864;1036763;1038682;1061888;1196112;1041167;1226752;;;;;;
320014,927;157621;2048;165888;1038682;1038874;1061888;1196303;1040922;1227776;;;;;;
320027,402;158720;992;165888;1038874;1039107;1061888;1197594;1040099;1227776;;;;;;
320047,605;157664;7753;163840;1039107;1039386;1061888;1196771;1047139;1225728;;;;;;
320059,335;162377;4112;164864;1039386;1040253;1061888;1201763;1044365;1226752;;;;;;
320078,725;158736;6211;165376;1040253;1041337;1061888;1198989;1047548;1227264;;;;;;
320099,936;161859;5092;165376;1041337;1043257;1061888;1203196;1048349;1227264;;;;;;
320121,947;160740;4879;165888;1043257;1044000;1061888;1203997;1048879;1227776;;;;;;
320129,654;161039;3644;165376;1044000;1046131;1061888;1205039;1049775;1227264;;;;;;
320154,559;159804;6254;165888;1046131;1046371;1061888;1205935;1052625;1227776;;;;;;
320175,221;162926;1473;165888;1046371;1048251;1061888;1209297;1049724;1227776;;;;;;
320195,490;158145;5623;165888;1048251;1048795;1061888;1206396;1054418;1227776;;;;;;
320208,710;162295;2123;165888;1048795;1050597;1061888;1211090;1052720;1227776;;;;;;
320236,237;158795;3764;166400;1050597;1050981;1061888;1209392;1054745;1228288;;;;;;
320247,977;160948;1176;165888;1050981;1052877;1061888;1211929;1054053;1227776;;;;;;
320268,708;158360;4168;166400;1052877;1053205;1061888;1211237;1057373;1228288;;;;;;
320289,230;161864;4104;166400;1053205;1053877;1061888;1215069;1057981;1228288;;;;;;
320422,617;161800;3108;167424;1053877;1054333;1061888;1215677;1057441;1229312;;;;;;
320448,039;162340;6096;166912;1054333;1054725;1061888;1216673;1060821;1228800;;;;;;
320453,009;165328;960;165888;1054725;1056997;1061888;1220053;1057957;1227776;;;;;;
320474,310;158656;5317;166400;1056997;1057333;1061888;1215653;1062650;1228288;;;;;;
320501,633;163013;3552;166912;1057333;1058068;1061888;1220346;1061620;1228800;;;;;;
320515,405;161760;1261;166400;1058068;1059900;1061888;1219828;1061161;1228288;;;;;;
320515,449;1261;0;166400;1059900;985499;1062400;1061161;985499;1228800;186022;186019;786432;1247183;1171518;2015232
320621,543;158208;7446;164864;985499;985500;1062400;1143707;992946;1227264;;;;;;
320663,960;164118;3844;165888;985500;987301;1062400;1149618;991145;1228288;;;;;;
320685,949;160516;2464;166400;987301;987301;1062400;1147817;989765;1228800;;;;;;
320693,492;160160;2784;166400;987301;987301;1062400;1147461;990085;1228800;;;;;;
320753,484;160480;3972;166912;987301;988005;1062400;1147781;991977;1229312;;;;;;
320761,724;162692;2786;166912;988005;988165;1062400;1150697;990951;1229312;;;;;;
320794,711;161506;3716;167936;988165;988749;1062400;1149671;992465;1230336;;;;;;
320864,437;163972;3958;167424;988749;989357;1062400;1152721;993315;1229824;;;;;;
320920,949;164214;4080;167936;989357;989358;1062400;1153571;993438;1230336;;;;;;
320931,036;164848;3024;167936;989358;989357;1062400;1154206;992381;1230336;;;;;;
320952,443;163792;1485;168448;989357;991349;1062400;1153149;992834;1230848;;;;;;
320959,271;163277;4588;166400;991349;991805;1062400;1154626;996393;1228800;;;;;;
320971,372;166380;7159;165888;991805;992730;1062400;1158185;999889;1228288;;;;;;
320982,820;165879;832;159744;992730;994985;1062400;1158609;995817;1222144;;;;;;
320988,437;159451;4746;166912;994986;995241;1062400;1154437;999987;1229312;;;;;;
321004,899;162954;6779;165376;995241;995738;1062400;1158195;1002517;1227776;;;;;;
321010,581;164987;1056;165888;995738;998412;1062400;1160725;999468;1228288;;;;;;
321012,768;157728;2280;165888;998412;998884;1062400;1156140;1001164;1228288;;;;;;
321015,814;158952;1120;166400;998884;999028;1062400;1157836;1000148;1228800;;;;;;
321022,568;158816;1120;166400;999028;999372;1062400;1157844;1000492;1228800;;;;;;
321029,513;158816;1458;166912;999372;999540;1062400;1158188;1000998;1229312;;;;;;
321044,653;159666;5688;166400;999540;999948;1062400;1159206;1005636;1228800;;;;;;
321085,842;163896;2973;166912;999948;1000843;1062400;1163844;1003816;1229312;;;;;;
321103,815;161181;6681;165376;1000843;1001303;1062400;1162024;1007984;1227776;;;;;;
321129,158;164889;768;165888;1001303;1003305;1062400;1166192;1004073;1228288;;;;;;
321132,799;157440;4546;165888;1003305;1003538;1062400;1160745;1008084;1228288;;;;;;
321136,379;161218;3072;166400;1003538;1005681;1062400;1164756;1008753;1228800;;;;;;
321143,844;160256;1312;165888;1005681;1005729;1062400;1165937;1007041;1228288;;;;;;
321166,487;158496;992;166912;1005729;1006001;1062400;1164225;1006993;1229312;;;;;;
321189,095;159712;1294;166912;1006001;1006481;1062400;1165713;1007775;1229312;;;;;;
321216,004;160014;1242;167424;1006481;1006657;1062400;1166495;1007899;1229824;;;;;;
321226,278;160474;3684;166912;1006657;1007009;1062400;1167131;1010693;1229312;;;;;;
321285,602;162916;4755;166400;1007009;1007585;1062400;1169925;1012340;1228800;;;;;;
321359,594;163475;4383;166912;1007585;1008197;1062400;1171060;1012580;1229312;;;;;;
321374,102;163103;3807;167424;1008197;1008917;1062400;1171300;1012724;1229824;;;;;;
321395,490;163039;4176;166912;1008917;1009589;1062400;1171956;1013765;1229312;;;;;;
321447,498;163408;1136;167424;1009589;1011245;1062400;1172997;1012381;1229824;;;;;;
321465,925;160880;1088;167424;1011245;1011717;1062400;1172125;1012805;1229824;;;;;;
321513,074;160832;4293;167424;1011717;1011949;1062400;1172549;1016242;1229824;;;;;;
321572,346;163958;6546;166400;1012111;1012112;1062400;1176069;1018658;1228800;;;;;;
321663,198;166290;8484;164352;1012113;1012113;1062400;1178403;1020597;1226752;;;;;;
321688,558;164132;8739;164864;1012113;1012113;1062400;1176245;1020852;1227264;;;;;;
321704,235;164387;5919;162816;1012113;1012113;1062400;1176500;1018032;1225216;;;;;;
321719,866;158495;6352;163840;1012113;1012113;1062400;1170608;1018465;1226240;;;;;;
321752,532;158928;10116;161792;1012113;1013549;1062400;1171041;1023665;1224192;;;;;;
321791,040;160644;5280;162816;1013549;1014837;1062400;1174193;1020117;1225216;;;;;;
321813,400;155808;8222;162304;1014837;1014837;1062400;1170645;1023059;1224704;;;;;;
321839,928;158750;5088;162816;1014837;1015645;1062400;1173587;1020733;1225216;;;;;;
321859,594;155616;10285;161280;1015645;1015645;1062400;1171261;1025930;1223680;;;;;;
321871,035;159789;6194;162304;1015645;1016077;1062400;1175434;1022271;1224704;;;;;;
321874,189;155698;5297;163328;1016077;1017150;1062400;1171775;1022447;1225728;;;;;;
321882,535;156337;4399;162816;1017150;1018286;1062400;1173487;1022685;1225216;;;;;;
321887,672;155439;2144;163328;1018286;1020798;1062400;1173725;1022942;1225728;;;;;;
321900,704;153696;6952;163328;1020798;1021310;1062400;1174494;1028262;1225728;;;;;;
321910,338;158504;3519;163840;1021310;1021950;1062400;1179814;1025469;1226240;;;;;;
321918,466;155583;1184;163328;1021950;1024757;1062400;1177533;1025941;1225728;;;;;;
321924,710;153248;656;162816;1024757;1025349;1062400;1178005;1026005;1225216;;;;;;
321934,859;152208;993;163328;1025349;1025614;1062400;1177557;1026607;1225728;;;;;;
321992,132;152545;6094;163840;1025614;1025957;1062400;1178159;1032051;1226240;;;;;;
322018,127;158670;2193;163840;1025957;1027905;1062400;1184627;1030098;1226240;;;;;;
322049,808;154769;5939;163840;1027905;1027937;1062400;1182674;1033876;1226240;;;;;;
322054,621;158515;5795;163840;1027937;1029080;1062400;1186452;1034875;1226240;;;;;;
322065,773;158371;4244;164864;1029080;1030048;1062400;1187451;1034292;1227264;;;;;;
322070,054;157844;1057;163840;1030048;1032239;1062400;1187892;1033296;1226240;;;;;;
322092,352;154657;960;164864;1032239;1032415;1062400;1186896;1033375;1227264;;;;;;
322113,126;155584;672;164864;1032415;1032863;1062400;1187999;1033535;1227264;;;;;;
322168,419;155296;3587;165376;1032863;1033032;1062400;1188159;1036619;1227776;;;;;;
322219,590;158723;4200;164864;1033032;1033586;1062400;1191755;1037786;1227264;;;;;;
322240,294;159336;3888;166400;1033586;1034182;1062400;1192922;1038070;1228800;;;;;;
322251,858;161072;993;165888;1034182;1036070;1062400;1195254;1037063;1228288;;;;;;
322279,781;158177;7112;164352;1036070;1036406;1062400;1194247;1043518;1226752;;;;;;
322291,316;162760;1959;165376;1036406;1038582;1062400;1199166;1040541;1227776;;;;;;
322300,163;157607;4516;165888;1038582;1039089;1062400;1196189;1043605;1228288;;;;;;
322312,881;161188;4047;165888;1039089;1039713;1062400;1200277;1043760;1228288;;;;;;
322360,097;160719;5189;166400;1039713;1040569;1062400;1200432;1045758;1228800;;;;;;
322378,888;162885;3731;166400;1040569;1040897;1062400;1203454;1044628;1228800;;;;;;
322386,426;161427;864;166400;1040897;1042812;1062400;1202324;1043676;1228800;;;;;;
322398,196;158560;912;166400;1042812;1043084;1062400;1201372;1043996;1228800;;;;;;
322418,572;158608;8082;164352;1043084;1043541;1062400;1201692;1051623;1226752;;;;;;
322424,714;163730;4505;165376;1043541;1044934;1062400;1207271;1049439;1227776;;;;;;
322460,104;160153;1184;165888;1044934;1046550;1062400;1205087;1047734;1228288;;;;;;
322482,450;157344;5103;165376;1046550;1046990;1062400;1203894;1052093;1227776;;;;;;
322503,526;161263;1360;165888;1046990;1048848;1062400;1208253;1050208;1228288;;;;;;
322524,394;158032;3719;165888;1048848;1049193;1062400;1206880;1052912;1228288;;;;;;
322574,187;160391;6341;165376;1049193;1049665;1062400;1209584;1056006;1227776;;;;;;
322584,491;163013;1356;165888;1049665;1052090;1062400;1212678;1053446;1228288;;;;;;
322590,813;158028;3184;166400;1052090;1052305;1062400;1210118;1055489;1228800;;;;;;
322603,943;160368;752;165888;1052305;1054485;1062400;1212673;1055237;1228288;;;;;;
322612,558;157936;2303;166912;1054485;1054758;1062400;1212421;1057061;1229312;;;;;;
322628,758;160511;864;166400;1054758;1054925;1062400;1215269;1055789;1228800;;;;;;
322641,049;159072;4925;165888;1054925;1055365;1062400;1213997;1060290;1228288;;;;;;
322662,519;162621;3726;166400;1055365;1057190;1062400;1217986;1060916;1228800;;;;;;
322701,430;161422;7237;164864;1057190;1057904;1062400;1218612;1065141;1227264;;;;;;
322729,436;163909;1686;165888;1057904;1060296;1062400;1221813;1061982;1228288;;;;;;
322729,454;1686;0;165888;1060296;1002302;1078272;1061982;1002302;1244160;186189;186018;786432;1248171;1188320;2030592
322743,595;156672;4068;166400;1002302;1002302;1078272;1158974;1006370;1244672;;;;;;
322757,872;161252;1664;165888;1002302;1004194;1078272;1163554;1005858;1244160;;;;;;
322777,831;158848;1236;166912;1004194;1004834;1078272;1163042;1006070;1245184;;;;;;
322786,905;159444;8163;166400;1004834;1005502;1078272;1164278;1013665;1244672;;;;;;
322804,868;166371;1296;164352;1005502;1007726;1078272;1171873;1009022;1242624;;;;;;
322808,415;156944;832;165376;1007726;1008326;1078272;1164670;1009158;1243648;;;;;;
322818,908;156480;1788;165888;1008326;1008526;1078272;1164806;1010314;1244160;;;;;;
322849,430;157948;5062;165376;1008526;1008854;1078272;1166474;1013916;1243648;;;;;;
322857,615;161222;864;165888;1008854;1010790;1078272;1170076;1011654;1244160;;;;;;
322943,929;157536;7891;164864;1010790;1011030;1078272;1168326;1018921;1243136;;;;;;
322956,901;164563;5080;164864;1011030;1012122;1078272;1175593;1017202;1243136;;;;;;
322967,309;159704;4545;164864;1012122;1013020;1078272;1171826;1017565;1243136;;;;;;
322977,057;159169;2704;165376;1013020;1013859;1078272;1172189;1016563;1243648;;;;;;
322984,177;157840;4774;164864;1013859;1014451;1078272;1171699;1019225;1243136;;;;;;
322995,536;159910;2416;165888;1014451;1016644;1078272;1174361;1019060;1244160;;;;;;
323009,925;159088;2172;165888;1016644;1016987;1078272;1175732;1019159;1244160;;;;;;
323022,626;158844;3378;166912;1016987;1017403;1078272;1175831;1020781;1245184;;;;;;
323026,399;161586;770;166400;1017403;1019276;1078272;1178989;1020046;1244672;;;;;;
323032,966;158978;704;166912;1019276;1019436;1078272;1178254;1020140;1245184;;;;;;
323072,420;159424;8162;166912;1019436;1019875;1078272;1178860;1028037;1245184;;;;;;
323087,745;166882;3490;164864;1019875;1021058;1078272;1186757;1024548;1243136;;;;;;
323092,389;160162;4356;165888;1021058;1021991;1078272;1181220;1026347;1244160;;;;;;
323105,863;161028;4644;166400;1021991;1022567;1078272;1183019;1027211;1244672;;;;;;
323110,426;161828;1193;165888;1022567;1024583;1078272;1184395;1025776;1244160;;;;;;
323114,990;158377;3187;166912;1024583;1025135;1078272;1182960;1028322;1245184;;;;;;
323119,165;161395;4208;166400;1025135;1025726;1078272;1186530;1029934;1244672;;;;;;
323128,607;162416;2406;167424;1025726;1027446;1078272;1188142;1029852;1245696;;;;;;
323131,829;161638;1504;166912;1027446;1028714;1078272;1189084;1030218;1245184;;;;;;
323134,438;160736;2660;167424;1028714;1029514;1078272;1189450;1032174;1245696;;;;;;
323148,473;162404;6872;166912;1029514;1029769;1078272;1191918;1036641;1245184;;;;;;
323169,564;166616;2514;166912;1029769;1032105;1078272;1196385;1034619;1245184;;;;;;
323180,536;161234;1648;166912;1032105;1032705;1078272;1193339;1034353;1245184;;;;;;
323253,046;160368;4822;166912;1032705;1032968;1078272;1193073;1037790;1245184;;;;;;
323309,407;163542;1195;166912;1032968;1034793;1078272;1196510;1035988;1245184;;;;;;
323330,931;159915;1055;166912;1034793;1035300;1078272;1194708;1036355;1245184;;;;;;
323375,153;159775;3972;166912;1035300;1035652;1078272;1195075;1039624;1245184;;;;;;
323403,409;162692;928;167424;1035652;1037459;1078272;1198344;1038387;1245696;;;;;;
323434,261;160672;7676;167424;1037459;1039026;1078272;1198131;1046702;1245696;;;;;;
323439,669;167420;7578;162304;1039026;1040259;1078272;1206446;1047837;1240576;;;;;;
323461,995;162202;4161;159232;1040259;1041282;1078272;1202461;1045443;1237504;;;;;;
323504,953;158785;4273;165376;1041282;1041873;1078272;1200067;1046146;1243648;;;;;;
323528,578;159409;1898;164864;1041873;1043593;1078272;1201282;1045491;1243136;;;;;;
323541,986;157034;1507;165888;1043593;1044217;1078272;1200627;1045724;1244160;;;;;;
323546,935;158179;1305;165888;1044217;1044713;1078272;1202396;1046018;1244160;;;;;;
323561,600;157977;3211;166400;1044713;1045133;1078272;1202690;1048344;1244672;;;;;;
323577,202;160395;6223;165888;1045133;1046242;1078272;1205528;1052465;1244160;;;;;;
323590,689;163407;736;165888;1046242;1048489;1078272;1209649;1049225;1244160;;;;;;
323637,974;157250;3108;165888;1048490;1048769;1078272;1205740;1051877;1244160;;;;;;
323694,105;159780;2720;166912;1048769;1049137;1078272;1208549;1051857;1245184;;;;;;
323729,479;160928;768;166400;1049137;1050945;1078272;1210065;1051713;1244672;;;;;;
323737,505;158976;608;166912;1050945;1051209;1078272;1209921;1051817;1245184;;;;;;
323763,209;159328;3699;166912;1051209;1051450;1078272;1210537;1055149;1245184;;;;;;
323821,630;162419;916;167424;1051450;1053281;1078272;1213869;1054197;1245696;;;;;;
323827,490;160660;944;167424;1053281;1053280;1078272;1213941;1054224;1245696;;;;;;
323854,115;160688;921;167936;1053280;1053817;1078272;1213968;1054738;1246208;;;;;;
324035,469;161121;4481;167424;1053817;1054089;1078272;1214938;1058570;1245696;;;;;;
324077,927;164737;6084;165376;1054089;1054089;1078272;1218826;1060173;1243648;;;;;;
324096,824;163780;4364;166400;1054089;1054089;1078272;1217869;1058453;1244672;;;;;;
324104,857;162060;3904;166912;1054089;1054088;1078272;1216149;1057992;1245184;;;;;;
324206,257;162112;4547;166400;1054088;1055425;1078272;1216200;1059972;1244672;;;;;;
324237,266;162755;4771;166912;1055425;1055752;1078272;1218180;1060523;1245184;;;;;;
324281,350;163295;6564;165376;1055752;1055753;1078272;1219047;1062317;1243648;;;;;;
324320,950;165284;6579;164864;1055753;1055752;1078272;1221037;1062331;1243136;;;;;;
324366,333;162227;9725;165376;1055752;1057600;1078272;1217979;1067325;1243648;;;;;;
324382,977;165373;6129;161280;1057600;1058455;1078272;1222973;1064584;1239552;;;;;;
324433,953;157681;7191;163328;1058455;1058456;1078272;1216136;1065647;1241600;;;;;;
324491,394;158599;11769;159232;1059104;1059139;1078272;1217703;1070908;1237504;;;;;;
324511,307;159225;9581;157184;1059398;1060980;1078272;1218623;1070561;1235456;;;;;;
324523,252;157037;6919;161280;1060980;1060981;1078272;1218017;1067900;1239552;;;;;;
324538,687;153863;10179;160768;1060981;1061557;1078272;1214844;1071736;1239040;;;;;;
324551,126;157123;6831;161280;1061557;1063101;1078272;1218680;1069932;1239552;;;;;;
324566,097;153775;6014;160768;1063101;1064469;1078272;1216876;1070483;1239040;;;;;;
324575,311;152958;5691;162304;1064469;1065382;1078272;1217427;1071073;1240576;;;;;;
324584,907;154683;3439;161792;1065382;1066565;1078272;1220065;1070004;1240064;;;;;;
324598,647;152431;5087;162816;1066565;1067284;1078272;1218996;1072371;1241088;;;;;;
324625,150;155103;4004;162304;1067284;1068596;1078272;1222387;1072600;1240576;;;;;;
324659,323;154020;5102;163328;1068596;1069116;1078272;1222616;1074218;1241600;;;;;;
324670,981;156654;4356;163328;1069116;1069712;1078272;1225770;1074068;1241600;;;;;;
324697,876;155908;1408;163840;1069712;1071784;1078272;1225620;1073192;1242112;;;;;;
324746,750;153984;8549;161280;1071784;1072088;1078272;1225768;1080637;1239552;;;;;;
324806,084;161125;5116;163328;1072088;1072839;1078272;1233213;1077955;1241600;;;;;;
324819,542;156156;7684;162816;1072839;1072840;1078272;1228995;1080524;1241088;;;;;;
324918,211;158724;4004;163840;1072840;1073367;1078272;1231564;1077371;1242112;;;;;;
324956,638;156068;5204;163328;1073367;1073367;1078272;1229435;1078571;1241600;;;;;;
325023,350;157268;3936;164352;1073367;1073367;1078272;1230635;1077303;1242624;;;;;;
325082,393;157536;9945;163840;1073367;1073367;1078272;1230903;1083312;1242112;;;;;;
325102,676;163545;5080;163840;1073367;1073367;1078272;1236912;1078447;1242112;;;;;;
325122,187;157656;9011;161792;1073367;1073367;1078272;1231023;1082378;1240064;;;;;;
325132,982;161587;7451;162816;1073367;1073367;1078272;1234954;1080818;1241088;;;;;;
325142,171;157979;8351;162816;1073367;1074035;1078272;1231346;1082386;1241088;;;;;;
325144,686;158879;7603;162816;1074035;1075075;1078272;1232914;1082678;1241088;;;;;;
325152,594;158131;7752;162816;1075075;1075922;1078272;1233206;1083674;1241088;;;;;;
325169,745;158280;6363;163328;1075922;1077035;1078272;1234202;1083398;1241600;;;;;;
325169,765;6363;0;163328;1077035;1015038;1089024;1083398;1015038;1252352;187535;186195;786432;1270933;1201233;2038784
325178,304;151040;2985;162816;1015038;1015039;1089024;1166078;1018024;1251840;;;;;;
325184,278;154025;2496;163328;1015039;1015039;1089024;1169064;1017535;1252352;;;;;;
325191,387;154048;1451;153088;1015039;1016575;1089024;1169087;1018026;1242112;;;;;;
325235,655;153003;4641;163328;1016575;1017271;1089024;1169578;1021912;1252352;;;;;;
325276,358;155681;6449;162816;1017271;1018358;1089024;1172952;1024807;1251840;;;;;;
325288,611;157489;2368;163840;1018358;1020508;1089024;1175847;1022876;1252864;;;;;;
325345,555;154944;7658;160256;1020508;1022800;1089024;1175452;1030458;1249280;;;;;;
325356,583;160234;1520;163328;1022800;1025163;1089024;1183034;1026683;1252352;;;;;;
325375,898;153072;1632;163328;1025163;1025387;1089024;1178235;1027019;1252352;;;;;;
325394,433;153184;1936;163840;1025387;1025603;1089024;1178571;1027539;1252864;;;;;;
325492,090;154000;1075;163328;1025603;1025964;1089024;1179603;1027039;1252352;;;;;;
325562,951;153139;3664;164352;1025964;1026298;1089024;1179103;1029962;1253376;;;;;;
325726,170;156752;5491;163840;1026298;1026299;1089024;1183050;1031790;1252864;;;;;;
325754,939;158579;5571;164352;1026299;1026299;1089024;1184878;1031870;1253376;;;;;;
325769,632;159171;4945;164352;1026299;1026298;1089024;1185470;1031243;1253376;;;;;;
325798,108;158545;4767;165376;1026298;1026299;1089024;1184843;1031066;1254400;;;;;;
325888,605;159903;6851;164864;1026299;1026299;1089024;1186202;1033150;1253888;;;;;;
325971,741;161987;8695;162816;1026299;1026299;1089024;1188286;1034994;1251840;;;;;;
325979,567;161271;6768;163840;1026299;1026298;1089024;1187570;1033066;1252864;;;;;;
326000,403;159344;9480;161792;1026298;1026802;1089024;1185642;1036282;1250816;;;;;;
326020,451;160008;9799;160768;1026802;1027730;1089024;1186810;1037529;1249792;;;;;;
326022,855;160327;10422;160768;1027730;1028651;1089024;1188057;1039073;1249792;;;;;;
326185,360;157761;9020;156672;1029948;1031108;1089024;1187709;1040128;1245696;;;;;;
326237,094;156476;8235;161280;1031111;1031967;1089024;1187587;1040202;1250304;;;;;;
326245,361;155179;6632;160768;1031967;1033570;1089024;1187146;1040202;1249792;;;;;;
326282,583;153576;6927;162304;1033570;1034714;1089024;1187146;1041641;1251328;;;;;;
326305,184;155919;6195;161792;1034714;1035966;1089024;1190633;1042161;1250816;;;;;;
326316,544;155187;1475;161792;1035966;1038865;1089024;1191153;1040340;1250816;;;;;;
326384,326;150979;1690;162304;1038865;1039489;1089024;1189844;1041179;1251328;;;;;;
326488,592;151193;5129;162816;1039489;1040004;1089024;1190682;1045133;1251840;;;;;;
326522,211;155145;1120;162304;1040004;1041707;1089024;1195149;1042827;1251328;;;;;;
326531,387;151136;1264;162816;1041707;1041707;1089024;1192843;1042971;1251840;;;;;;
326554,945;151792;2259;162816;1041707;1042291;1089024;1193499;1044550;1251840;;;;;;
326581,448;152787;2032;163328;1042291;1042523;1089024;1195078;1044555;1252352;;;;;;
326593,091;153072;3870;162816;1042523;1042523;1089024;1195595;1046393;1251840;;;;;;
326606,260;154910;3500;164352;1042523;1042811;1089024;1197433;1046311;1253376;;;;;;
326624,124;156588;7404;163840;1042811;1043492;1089024;1199399;1050896;1252864;;;;;;
326655,171;160492;1504;163840;1043492;1046036;1089024;1203984;1047540;1252864;;;;;;
326789,626;154080;6878;163840;1046036;1046427;1089024;1200116;1053305;1252864;;;;;;
326799,800;159454;6774;162816;1046427;1046427;1089024;1205881;1053201;1251840;;;;;;
326818,395;158326;4982;163328;1046427;1047626;1089024;1204753;1052608;1252352;;;;;;
326830,202;156534;1559;164352;1047626;1049734;1089024;1204160;1051293;1253376;;;;;;
326844,864;154647;4145;163840;1049734;1050350;1089024;1204381;1054495;1252864;;;;;;
326869,592;157233;5225;164864;1050350;1050885;1089024;1207583;1056110;1253888;;;;;;
326896,002;159849;2441;164864;1050885;1053032;1089024;1210734;1055473;1253888;;;;;;
326909,495;157065;4804;165376;1053032;1053748;1089024;1210097;1058552;1254400;;;;;;
326936,860;160452;3888;165376;1053748;1054708;1089024;1214200;1058596;1254400;;;;;;
326960,608;159536;5587;165888;1054708;1055572;1089024;1214244;1061159;1254912;;;;;;
327066,919;162259;912;165888;1055572;1057356;1089024;1217831;1058268;1254912;;;;;;
327145,055;157584;5368;165888;1057356;1057356;1089024;1214940;1062724;1254912;;;;;;
327214,443;162040;7528;164352;1057356;1057356;1089024;1219396;1064884;1253376;;;;;;
327263,695;164200;4319;165376;1057356;1057356;1089024;1221556;1061675;1254400;;;;;;
327282,475;159455;6853;164864;1057356;1057356;1089024;1216811;1064209;1253888;;;;;;
327325,930;161989;6960;164352;1057356;1057356;1089024;1219345;1064316;1253376;;;;;;
327346,154;161584;6612;164864;1057356;1057356;1089024;1218940;1063968;1253888;;;;;;
327353,333;161236;6222;164864;1057356;1057356;1089024;1218592;1063578;1253888;;;;;;
327424,416;160846;6060;164864;1057356;1058348;1089024;1218202;1064408;1253888;;;;;;
327481,583;160684;6341;164864;1058348;1059436;1089024;1219032;1065777;1253888;;;;;;
327500,677;160965;6378;164864;1059436;1059900;1089024;1220401;1066278;1253888;;;;;;
327505,263;161002;4819;165376;1059900;1060428;1089024;1220902;1065247;1254400;;;;;;
327511,368;160438;6486;165376;1060427;1061060;1089024;1220865;1067546;1254400;;;;;;
327524,453;162134;7800;164352;1061060;1062179;1089024;1223194;1069979;1253376;;;;;;
327539,853;162424;4481;164864;1062179;1062884;1089024;1224603;1067365;1253888;;;;;;
327547,484;159105;1970;164352;1062884;1065187;1089024;1221989;1067157;1253376;;;;;;
327553,200;156594;1719;164864;1065187;1066131;1089024;1221781;1067850;1253888;;;;;;
327573,602;156343;6665;164864;1066131;1066558;1089024;1222474;1073223;1253888;;;;;;
327587,495;161289;5334;164864;1066558;1067512;1089024;1227847;1072846;1253888;;;;;;
327599,304;159958;4580;165376;1067512;1068330;1089024;1227470;1072910;1254400;;;;;;
327605,729;159716;1600;164864;1068330;1070177;1089024;1228046;1071777;1253888;;;;;;
327615,411;156736;1120;165376;1070177;1070809;1089024;1226913;1071929;1254400;;;;;;
327620,323;156758;2464;165376;1070809;1071257;1089024;1227567;1073721;1254400;;;;;;
327684,674;158112;3581;165888;1071257;1073156;1089024;1229369;1076737;1254912;;;;;;
327741,744;159741;4643;165376;1073156;1073928;1089024;1232897;1078571;1254400;;;;;;
327788,143;160803;736;165888;1073928;1076055;1089024;1234731;1076791;1254912;;;;;;
327884,643;157408;5204;165888;1076055;1076207;1089024;1233463;1081411;1254912;;;;;;
327932,816;161876;4009;166400;1076207;1076855;1089024;1238083;1080864;1255424;;;;;;
328005,546;161193;5283;165888;1076855;1076855;1089024;1238048;1082138;1254912;;;;;;
328015,944;162467;3487;166912;1076855;1076854;1089024;1239322;1080341;1255936;;;;;;
328020,305;161695;2783;166400;1076854;1077737;1089024;1238549;1080520;1255424;;;;;;
328106,118;160991;6760;165888;1077737;1078433;1089024;1238728;1085193;1254912;;;;;;
328124,513;164456;4709;166400;1078433;1080016;1089024;1242889;1084725;1255424;;;;;;
328137,747;162405;1581;166400;1080016;1081680;1089024;1242421;1083261;1255424;;;;;;
328181,670;159277;1216;166400;1081680;1082144;1089024;1240957;1083360;1255424;;;;;;
328226,583;158912;800;166400;1082144;1082640;1089024;1241056;1083440;1255424;;;;;;
328306,837;158496;3859;166400;1082640;1082921;1089024;1241136;1086780;1255424;;;;;;
328357,649;161555;4627;166912;1082921;1083605;1089024;1244476;1088232;1255936;;;;;;
328409,404;163111;2268;166912;1083604;1085811;1089024;1246715;1088079;1255936;;;;;;
328444,360;160988;6917;165888;1085811;1086196;1089024;1246799;1093113;1254912;;;;;;
328458,521;164613;1313;166400;1086196;1088023;1089024;1250809;1089336;1255424;;;;;;
328458,541;1313;0;166400;1088023;1018425;1092096;1089336;1018425;1258496;186698;186022;786432;1276034;1204447;2044928
328469,735;157696;6634;164352;1018425;1018425;1092096;1176121;1025059;1256448;;;;;;
328478,246;162282;4990;165376;1018425;1020254;1092096;1180707;1025244;1257472;;;;;;
328496,340;160638;2161;165888;1020254;1022350;1092096;1180892;1024511;1257984;;;;;;
328517,497;158833;3137;165888;1022350;1022846;1092096;1181183;1025983;1257984;;;;;;
328579,061;159809;2151;166400;1022846;1023382;1092096;1182655;1025533;1258496;;;;;;
328583,258;159847;4332;166400;1023382;1023993;1092096;1183229;1028325;1258496;;;;;;
328609,376;162028;2898;166912;1023993;1025827;1092096;1186021;1028725;1259008;;;;;;
328621,776;161618;1088;166912;1025827;1026219;1092096;1187445;1027307;1259008;;;;;;
328647,686;159808;832;166912;1026219;1026563;1092096;1186027;1027395;1259008;;;;;;
328671,246;159552;4981;166912;1026563;1026971;1092096;1186115;1031952;1259008;;;;;;
328701,550;163701;1664;166912;1026971;1029114;1092096;1190672;1030778;1259008;;;;;;
328719,033;160384;2521;166912;1029114;1030523;1092096;1189498;1033044;1259008;;;;;;
328775,176;161241;4438;167424;1030523;1031907;1092096;1191764;1036345;1259520;;;;;;
328808,291;164182;7661;167424;1031907;1031955;1092096;1196089;1039616;1259520;;;;;;
328845,655;167369;5225;164352;1031954;1033470;1092096;1199323;1038695;1256448;;;;;;
328854,303;161897;4268;165888;1033470;1033470;1092096;1195367;1037738;1257984;;;;;;
328867,604;160940;800;166400;1033470;1036033;1092096;1194410;1036833;1258496;;;;;;
328873,808;158496;880;166400;1036033;1036121;1092096;1194529;1037001;1258496;;;;;;
328944,145;158576;860;166400;1036121;1036385;1092096;1194697;1037245;1258496;;;;;;
329088,721;158556;1174;166400;1036385;1036761;1092096;1194941;1037935;1258496;;;;;;
329127,468;158870;3249;166912;1036761;1037173;1092096;1195631;1040422;1259008;;;;;;
329182,823;161969;6213;165376;1037173;1037173;1092096;1199142;1043386;1257472;;;;;;
329221,936;164933;7349;164352;1037173;1037173;1092096;1202106;1044522;1256448;;;;;;
329239,647;162997;4219;165376;1037173;1037174;1092096;1200170;1041393;1257472;;;;;;
329245,801;159867;4798;165888;1037174;1037173;1092096;1197041;1041971;1257984;;;;;;
329273,806;161470;4640;165888;1037173;1037992;1092096;1198643;1042632;1257984;;;;;;
329300,439;161312;7394;164864;1037992;1038864;1092096;1199304;1046258;1256960;;;;;;
329309,581;163036;6342;162304;1039837;1040701;1092096;1202873;1047043;1254400;;;;;;
329318,390;161990;4000;165376;1040705;1042422;1092096;1202695;1046422;1257472;;;;;;
329358,827;159136;3358;164864;1042422;1043510;1092096;1201558;1046868;1256960;;;;;;
329430,873;158494;4527;166400;1043510;1043975;1092096;1202004;1048502;1258496;;;;;;
329477,707;161702;2462;165888;1043974;1045872;1092096;1205676;1048334;1257984;;;;;;
329518,983;159646;3580;166400;1045872;1046658;1092096;1205518;1050238;1258496;;;;;;
329579,669;161276;2129;166400;1046658;1048314;1092096;1207934;1050443;1258496;;;;;;
329709,105;159825;4579;166912;1048314;1048314;1092096;1208139;1052893;1259008;;;;;;
329745,912;163299;4733;166912;1048314;1048314;1092096;1211613;1053047;1259008;;;;;;
329750,519;163453;7086;165888;1048314;1048314;1092096;1211767;1055400;1257984;;;;;;
329819,992;164782;4865;166400;1048314;1049586;1092096;1213096;1054451;1258496;;;;;;
329868,928;162561;6920;165376;1049586;1050529;1092096;1212147;1057449;1257472;;;;;;
329881,238;163592;5603;165888;1050529;1052035;1092096;1214121;1057638;1257984;;;;;;
329929,217;162275;1024;165888;1052035;1053937;1092096;1214310;1054961;1257984;;;;;;
329934,045;157696;993;165888;1053937;1054353;1092096;1211633;1055346;1257984;;;;;;
330027,480;157665;3538;165888;1054353;1054618;1092096;1212018;1058156;1257984;;;;;;
330108,666;160210;3650;165888;1054618;1055275;1092096;1214828;1058925;1257984;;;;;;
330173,236;160322;960;166400;1055275;1057081;1092096;1215597;1058041;1258496;;;;;;
330235,707;158656;6109;163840;1057081;1057290;1092096;1215737;1063399;1255936;;;;;;
330256,618;163805;6420;164864;1057290;1057289;1092096;1221095;1063709;1256960;;;;;;
330272,116;162068;4386;165376;1057289;1058282;1092096;1219357;1062668;1257472;;;;;;
330286,756;160034;7569;164864;1058282;1058842;1092096;1218316;1066411;1256960;;;;;;
330313,463;163217;704;156672;1058842;1063817;1092096;1222059;1064521;1248768;;;;;;
330337,499;156352;3539;165376;1063817;1064294;1092096;1220169;1067833;1257472;;;;;;
330348,734;158675;5795;164864;1064294;1064798;1092096;1222969;1070593;1256960;;;;;;
330359,420;160931;1104;165376;1064798;1067810;1092096;1225729;1068914;1257472;;;;;;
330397,059;156752;1056;165376;1067810;1068042;1092096;1224562;1069098;1257472;;;;;;
330412,431;156704;1612;165888;1068042;1068474;1092096;1224746;1070086;1257984;;;;;;
330422,579;157772;864;165376;1068474;1068674;1092096;1226246;1069538;1257472;;;;;;
330438,809;157024;1232;165888;1068674;1068978;1092096;1225698;1070210;1257984;;;;;;
330477,103;157904;784;165888;1068978;1069162;1092096;1226882;1069946;1257984;;;;;;
330531,803;157456;911;166400;1069162;1069482;1092096;1226618;1070393;1258496;;;;;;
330557,142;158607;1098;166400;1069482;1069794;1092096;1228089;1070892;1258496;;;;;;
330566,357;158794;2736;167424;1069794;1070196;1092096;1228588;1072932;1259520;;;;;;
330605,887;161968;4483;166912;1070196;1070461;1092096;1232164;1074944;1259008;;;;;;
330628,631;163715;1072;167424;1070461;1072396;1092096;1234176;1073468;1259520;;;;;;
330640,222;160304;3200;166912;1072396;1072635;1092096;1232700;1075835;1259008;;;;;;
330665,569;162432;4468;167424;1072635;1074473;1092096;1235067;1078941;1259520;;;;;;
330682,859;164212;2167;167424;1074473;1074889;1092096;1238685;1077056;1259520;;;;;;
330689,510;161911;2285;167936;1074889;1075209;1092096;1236800;1077494;1260032;;;;;;
330759,401;163053;1424;167936;1075209;1075905;1092096;1238262;1077329;1260032;;;;;;
330792,508;162192;993;168448;1075905;1076569;1092096;1238097;1077562;1260544;;;;;;
330815,745;162785;4579;166400;1076569;1076617;1092096;1239354;1081196;1258496;;;;;;
330829,424;166371;1219;168448;1076617;1078408;1092096;1242988;1079627;1260544;;;;;;
330843,393;162499;1025;167936;1078408;1078681;1092096;1240907;1079706;1260032;;;;;;
330860,925;162305;1104;168448;1078681;1078992;1092096;1240986;1080096;1260544;;;;;;
330881,531;162896;992;168448;1078992;1079296;1092096;1241888;1080288;1260544;;;;;;
331007,013;162784;816;168960;1079296;1079776;1092096;1242080;1080592;1261056;;;;;;
331043,150;163632;1024;168960;1079776;1079776;1092096;1243408;1080800;1261056;;;;;;
331080,455;163840;1917;169472;1079776;1079776;1092096;1243616;1081693;1261568;;;;;;
331115,144;165245;1215;168960;1079776;1079777;1092096;1245021;1080992;1261056;;;;;;
331141,281;164543;2559;169984;1079777;1079777;1092096;1244320;1082336;1262080;;;;;;
331177,968;167423;1669;169984;1079777;1079777;1092096;1247200;1081446;1262080;;;;;;
331212,813;166533;4448;168960;1079777;1079777;1092096;1246310;1084225;1261056;;;;;;
331232,457;168288;5123;169472;1079777;1079777;1092096;1248065;1084900;1261568;;;;;;
331265,731;168963;4129;167424;1079777;1079777;1092096;1248740;1083906;1259520;;;;;;
331285,145;165921;6619;168448;1079777;1079777;1092096;1245698;1086396;1260544;;;;;;
331306,893;168411;4641;165376;1079777;1079777;1092096;1248188;1084418;1257472;;;;;;
331381,914;163361;5219;166912;1079777;1079777;1092096;1243138;1084996;1259008;;;;;;
331406,626;163939;6431;165888;1079777;1079777;1092096;1243716;1086208;1257984;;;;;;
331415,915;164127;5439;163328;1079777;1079777;1092096;1243904;1085216;1255424;;;;;;
331433,426;163135;6915;164864;1079777;1080025;1092096;1242912;1086940;1256960;;;;;;
331457,701;162563;9299;165376;1080025;1080369;1092096;1242588;1089668;1257472;;;;;;
331479,670;164947;7058;162304;1080369;1080545;1092096;1245316;1087603;1254400;;;;;;
331497,619;159634;7891;160768;1080545;1080985;1092096;1240179;1088876;1252864;;;;;;
331532,708;160467;7376;163328;1080985;1081761;1092096;1241452;1089137;1255424;;;;;;
331546,854;158928;6686;163328;1081761;1082057;1092096;1240689;1088743;1255424;;;;;;
331574,515;158238;5582;163840;1082057;1082841;1092096;1240295;1088423;1255936;;;;;;
331589,087;157646;7384;163328;1082841;1083776;1092096;1240487;1091160;1255424;;;;;;
331595,547;159448;6548;163840;1083776;1084424;1092096;1243224;1090972;1255936;;;;;;
331599,733;159124;5917;163840;1084424;1085192;1092096;1243548;1091109;1255936;;;;;;
331603,975;158493;4288;164864;1085192;1085776;1092096;1243685;1090064;1256960;;;;;;
331613,942;158400;3649;164352;1085776;1087104;1092096;1244176;1090753;1256448;;;;;;
331632,400;157761;1424;163840;1087104;1089052;1092096;1244865;1090476;1255936;;;;;;
331648,886;155024;1473;164352;1089052;1089712;1092096;1244076;1091185;1256448;;;;;;
331672,089;155073;4948;164864;1089712;1090249;1092096;1244785;1095197;1256960;;;;;;
331703,458;159060;816;164352;1090249;1092168;1092608;1249309;1092984;1256960;;;;;;
331703,474;816;0;164352;1092168;1019330;1091584;1092984;1019330;1255936;187383;186040;786432;1280367;1205370;2042368
331724,010;154112;4628;165376;1019330;1019331;1091584;1173442;1023959;1256960;;;;;;
331733,261;159764;2304;164864;1019331;1021682;1091584;1179095;1023986;1256448;;;;;;
331746,478;157440;4627;165888;1021682;1021851;1091584;1179122;1026478;1257472;;;;;;
331780,418;160787;3425;165376;1021851;1023866;1091584;1182638;1027291;1256960;;;;;;
331786,438;159585;1875;166400;1023866;1024327;1091584;1183451;1026202;1257984;;;;;;
331800,660;159059;3908;165888;1024327;1024862;1091584;1183386;1028770;1257472;;;;;;
331808,628;161092;3184;166912;1024862;1025741;1091584;1185954;1028925;1258496;;;;;;
331831,882;161904;4925;166912;1025741;1026238;1091584;1187645;1031163;1258496;;;;;;
331889,489;163645;4324;167424;1026238;1026936;1091584;1189883;1031260;1259008;;;;;;
331929,233;163556;1623;166912;1026936;1029056;1091584;1190492;1030679;1258496;;;;;;
331975,952;160855;3892;167424;1029056;1029561;1091584;1189911;1033453;1259008;;;;;;
332019,215;163636;5550;167424;1029561;1030216;1091584;1193197;1035766;1259008;;;;;;
332045,008;165294;3443;167424;1030216;1030217;1091584;1195510;1033660;1259008;;;;;;
332069,081;163187;4146;167424;1030217;1030217;1091584;1193404;1034363;1259008;;;;;;
332107,495;163890;4031;167936;1030217;1030217;1091584;1194107;1034248;1259520;;;;;;
332113,908;164799;3807;167936;1030217;1030217;1091584;1195016;1034024;1259520;;;;;;
332152,600;164575;2209;168448;1030217;1032360;1091584;1194792;1034569;1260032;;;;;;
332188,607;164001;1056;163328;1032360;1033272;1091584;1196361;1034328;1254912;;;;;;
332357,377;162848;5289;167936;1033272;1033432;1091584;1196120;1038721;1259520;;;;;;
332410,581;166057;7139;167936;1033432;1033914;1091584;1199489;1041053;1259520;;;;;;
332453,341;167907;3232;165888;1033914;1034338;1091584;1201821;1037570;1257472;;;;;;
332466,876;161952;6179;165376;1034338;1034339;1091584;1196290;1040518;1256960;;;;;;
332473,308;164899;3504;166912;1034339;1035066;1091584;1199238;1038570;1258496;;;;;;
332479,527;161712;3280;166400;1035066;1035762;1091584;1196778;1039042;1257984;;;;;;
332528,924;161488;3005;167424;1035762;1036761;1091584;1197250;1039766;1259008;;;;;;
332652,168;162237;2480;166912;1036761;1037434;1091584;1198998;1039914;1258496;;;;;;
332767,493;161712;4435;167424;1037434;1037978;1091584;1199146;1042413;1259008;;;;;;
332783,681;164179;608;167424;1037978;1039984;1091584;1202157;1040592;1259008;;;;;;
332801,361;160352;768;167424;1039984;1040128;1091584;1200336;1040896;1259008;;;;;;
332822,284;160512;400;167424;1040128;1040424;1091584;1200640;1040824;1259008;;;;;;
332837,327;160144;2944;167424;1040424;1040617;1091584;1200568;1043561;1259008;;;;;;
332885,132;162688;4948;167424;1040617;1041954;1091584;1203305;1046902;1259008;;;;;;
332904,058;164692;2848;167936;1041954;1041955;1091584;1206646;1044803;1259520;;;;;;
332969,219;163104;7165;167424;1041955;1042641;1091584;1205059;1049806;1259008;;;;;;
333003,313;167421;7661;162816;1042641;1043879;1091584;1210062;1051540;1254400;;;;;;
333134,318;162793;7372;162816;1043879;1046396;1091584;1206672;1053768;1254400;;;;;;
333283,958;162508;5316;164352;1046396;1046396;1091584;1208904;1051712;1255936;;;;;;
333295,656;158916;4145;164352;1046396;1046396;1091584;1205312;1050541;1255936;;;;;;
333380,991;157745;9612;162816;1046396;1046397;1091584;1204141;1056009;1254400;;;;;;
333447,253;162188;8760;161792;1046397;1046396;1091584;1208585;1055156;1253376;;;;;;
333491,528;161336;6564;163328;1046396;1046396;1091584;1207732;1052960;1254912;;;;;;
333597,005;157604;7411;162816;1046396;1046396;1091584;1204000;1053807;1254400;;;;;;
333823,835;158451;7793;162816;1046396;1046397;1091584;1204847;1054190;1254400;;;;;;
333870,610;158321;7938;162816;1046397;1046396;1091584;1204718;1054334;1254400;;;;;;
333938,043;158466;11743;159744;1046396;1046396;1091584;1204862;1058139;1251328;;;;;;
334156,129;159199;10442;158208;1046396;1046396;1091584;1205595;1056838;1249792;;;;;;
334375,602;157898;13513;157184;1046396;1046396;1091584;1204294;1059909;1248768;;;;;;
334443,477;156361;11949;155136;1046396;1046396;1091584;1202757;1058345;1246720;;;;;;
334463,246;154797;10355;158208;1046396;1046397;1091584;1201193;1056752;1249792;;;;;;
334655,131;151667;13582;155136;1046397;1046396;1091584;1198064;1059978;1246720;;;;;;
334733,379;140542;16854;154624;1046396;1047468;1091584;1186938;1064322;1246208;;;;;;
334733,407;16854;0;154624;1047468;1021845;1091584;1064322;1021845;1246208;186877;186117;786432;1251199;1207962;2032640
334788,452;136704;4084;140800;1021845;1021846;1091584;1158549;1025930;1232384;;;;;;
334811,197;140788;3664;155136;1021846;1021846;1091584;1162634;1025510;1246720;;;;;;
334841,735;138832;4644;155136;1021846;1021846;1091584;1160678;1026490;1246720;;;;;;
334860,501;139812;3520;156160;1021846;1021846;1091584;1161658;1025366;1247744;;;;;;
335098,207;140224;5925;155648;1021846;1021846;1091584;1162070;1027771;1247232;;;;;;
335175,530;142629;6842;157696;1022656;1022657;1091584;1165285;1029499;1249280;;;;;;
335214,143;146106;9359;156672;1022660;1022661;1091584;1168766;1032020;1248256;;;;;;
335244,038;148623;8963;158208;1022661;1022661;1091584;1171284;1031624;1249792;;;;;;
335261,195;150275;8609;158208;1022661;1022660;1091584;1172936;1031269;1249792;;;;;;
335334,167;149921;9652;159232;1022660;1022661;1091584;1172581;1032313;1250816;;;;;;
335506,641;153012;8893;159232;1022661;1022660;1091584;1175673;1031553;1250816;;;;;;
335635,644;152253;12440;157696;1022660;1022661;1091584;1174913;1035101;1249280;;;;;;
335703,823;154776;8401;158720;1022661;1022661;1091584;1177437;1031062;1250304;;;;;;
335725,231;150737;8865;159744;1022661;1022660;1091584;1173398;1031525;1251328;;;;;;
335798,777;152737;11173;159232;1022660;1022660;1091584;1175397;1033833;1250816;;;;;;
335820,461;155045;8529;160256;1022660;1023276;1091584;1177705;1031805;1251840;;;;;;
335996,893;153425;11857;159744;1023276;1023548;1091584;1176701;1035405;1251328;;;;;;
336112,226;156753;8751;160256;1023548;1024068;1091584;1180301;1032819;1251840;;;;;;
336132,931;153647;11621;159744;1024068;1024228;1091584;1177715;1035849;1251328;;;;;;
336154,599;156517;8783;160256;1024228;1024732;1091584;1180745;1033515;1251840;;;;;;
336178,931;153627;9676;159744;1024732;1025996;1091584;1178359;1035672;1251328;;;;;;
336200,632;154572;7055;160768;1025996;1026788;1091584;1180568;1033843;1252352;;;;;;
336250,774;153487;8782;160768;1026788;1027916;1091584;1180275;1036698;1252352;;;;;;
336375,468;155214;9252;161792;1027916;1028420;1091584;1183130;1037672;1253376;;;;;;
336403,579;157220;6799;161280;1028420;1028420;1091584;1185640;1035219;1252864;;;;;;
336788,464;154767;9478;161792;1028420;1028420;1091584;1183187;1037898;1253376;;;;;;
336932,791;157958;11740;160256;1028420;1028420;1091584;1186378;1040160;1251840;;;;;;
337081,363;160220;12844;159232;1028420;1028452;1091584;1188640;1041296;1250816;;;;;;
337125,780;158252;12486;158208;1028452;1028788;1091584;1186704;1041274;1249792;;;;;;
337146,686;157894;11146;159744;1028788;1029404;1091584;1186682;1040550;1251328;;;;;;
337164,287;155530;9858;159744;1029404;1029692;1091584;1184934;1039550;1251328;;;;;;
337227,955;154242;10785;160256;1029692;1030268;1091584;1183934;1041053;1251840;;;;;;
337405,356;156193;10419;160256;1030268;1030404;1091584;1186461;1040823;1251840;;;;;;
337556,175;155827;10243;161280;1030404;1030884;1091584;1186231;1041127;1252864;;;;;;
337591,204;157187;9975;160768;1030884;1030884;1091584;1188071;1040859;1252352;;;;;;
337608,327;156919;9262;161792;1030884;1031236;1091584;1187803;1040498;1253376;;;;;;
337627,393;157230;8782;161280;1031236;1031324;1091584;1188466;1040106;1252864;;;;;;
337762,881;156750;12639;160768;1031324;1032084;1091584;1188074;1044723;1252352;;;;;;
337881,986;160095;11500;159232;1032084;1032244;1091584;1192179;1043744;1250816;;;;;;
337981,184;158956;11122;160768;1032244;1032244;1091584;1191200;1043366;1252352;;;;;;
338003,245;157554;14326;160768;1032244;1034001;1091584;1189798;1048327;1252352;;;;;;
338028,709;160758;10096;158720;1034001;1035297;1091584;1194759;1045393;1250304;;;;;;
338070,753;154480;10341;159744;1035297;1035845;1091584;1189777;1046186;1251328;;;;;;
338129,944;154725;8610;159744;1035845;1036453;1091584;1190570;1045063;1251328;;;;;;
338159,331;152994;9416;159744;1036453;1036453;1091584;1189447;1045869;1251328;;;;;;
338170,893;153800;8725;160256;1036453;1036837;1091584;1190253;1045562;1251840;;;;;;
338213,894;154133;7522;160256;1036837;1037901;1091584;1190970;1045423;1251840;;;;;;
338310,853;152930;9944;160768;1037901;1038724;1091584;1190831;1048668;1252352;;;;;;
338337,287;73335;6594;160256;1038724;1039084;1091584;1112059;1045678;1251840;;;;;;
338337,311;6594;0;160256;1039084;1019852;1091584;1045678;1019852;1251840;186458;185986;786432;1232136;1205838;2038272
338375,939;145920;1833;158720;1019852;1019853;1091584;1165772;1021686;1250304;;;;;;
338416,855;146217;2803;147456;1019853;1019853;1091584;1166070;1022656;1239040;;;;;;
338439,478;147187;2385;159232;1019853;1019853;1091584;1167040;1022238;1250816;;;;;;
338466,202;145745;5356;159232;1019853;1019853;1091584;1165598;1025209;1250816;;;;;;
338807,688;148716;5311;159744;1019853;1019853;1091584;1168569;1025164;1251328;;;;;;
338848,754;148936;9818;159232;1019853;1019853;1091584;1168789;1029671;1250816;;;;;;
338884,041;153690;4943;159744;1019853;1019853;1091584;1173543;1024796;1251328;;;;;;
338913,656;149327;7378;159744;1019853;1019853;1091584;1169180;1027231;1251328;;;;;;
338942,647;151762;5518;161280;1019853;1019853;1091584;1171615;1025371;1252864;;;;;;
339302,457;152462;7269;160768;1019853;1019853;1091584;1172315;1027122;1252352;;;;;;
339312,578;154213;11670;159744;1019853;1019852;1091584;1174066;1031522;1251328;;;;;;
339338,481;158102;7331;160768;1019852;1019852;1091584;1177954;1027183;1252352;;;;;;
339356,049;153522;7603;161792;1019853;1019852;1091584;1173375;1027455;1253376;;;;;;
339383,383;155571;9780;161280;1019852;1020308;1091584;1175423;1030088;1252864;;;;;;
339584,135;157748;9979;160768;1020308;1020917;1091584;1178056;1030896;1252352;;;;;;
339629,111;157435;13809;161280;1020917;1021086;1091584;1178352;1034895;1252864;;;;;;
339631,676;161265;13792;156672;1021086;1025932;1091584;1182351;1039724;1248256;;;;;;
339698,905;156640;14193;152576;1025932;1026620;1091584;1182572;1040813;1244160;;;;;;
339713,633;152433;16274;152576;1026620;1027396;1091584;1179053;1043670;1244160;;;;;;
339727,952;150418;11009;155136;1027396;1028444;1091584;1177814;1039453;1246720;;;;;;
339741,064;145153;12628;155136;1028444;1029188;1091584;1173597;1041816;1246720;;;;;;
339783,121;147796;10593;155136;1029188;1029796;1091584;1176984;1040389;1246720;;;;;;
339823,813;145761;7305;156160;1029796;1036180;1091584;1175557;1043485;1247744;;;;;;
339846,214;144521;4950;156160;1036180;1037388;1091584;1180701;1042338;1247744;;;;;;
339863,331;142166;4769;156160;1037388;1038348;1091584;1179554;1043117;1247744;;;;;;
339867,954;141985;5051;156160;1038348;1039108;1091584;1180333;1044159;1247744;;;;;;
339889,712;142267;3926;156672;1039108;1040387;1091584;1181375;1044313;1248256;;;;;;
339906,289;141654;5176;156160;1040387;1041043;1091584;1182041;1046219;1247744;;;;;;
339918,042;142904;3937;157184;1041043;1041531;1091584;1183947;1045468;1248768;;;;;;
339939,361;142689;3604;156672;1041531;1042043;1091584;1184220;1045647;1248256;;;;;;
339944,137;142356;3204;157696;1042043;1042579;1091584;1184399;1045783;1249280;;;;;;
339951,019;142980;2784;157184;1042579;1042963;1091584;1185559;1045747;1248768;;;;;;
339966,085;142560;1780;158208;1042963;1044540;1091584;1185523;1046320;1249792;;;;;;
339969,974;143057;5416;158208;1044701;1045376;1091584;1187758;1050792;1249792;;;;;;
339995,166;146728;3424;159744;1045380;1046030;1091584;1192108;1049454;1251328;;;;;;
340001,205;147296;640;159232;1046030;1047974;1091584;1193326;1048614;1250816;;;;;;
340019,724;144512;4545;160768;1047974;1048254;1091584;1192486;1052799;1252352;;;;;;
340030,694;149953;1024;159744;1048254;1050111;1091584;1198207;1051135;1251328;;;;;;
340060,533;146432;3700;161792;1050111;1050743;1091584;1196543;1054443;1253376;;;;;;
340087,611;151156;3732;160768;1050743;1051383;1091584;1201899;1055115;1252352;;;;;;
340092,162;151188;4664;163328;1051383;1051887;1091584;1202571;1056551;1254912;;;;;;
340117,656;155192;3840;162304;1051887;1052367;1091584;1207079;1056207;1253888;;;;;;
340133,464;154368;4052;164352;1052367;1053183;1091584;1206735;1057235;1255936;;;;;;
340139,682;157140;4182;163840;1053183;1053704;1091584;1210323;1057886;1255424;;;;;;
340155,115;157270;1152;164864;1053704;1055415;1091584;1210974;1056567;1256448;;;;;;
340160,973;155776;1204;164864;1055415;1055704;1091584;1211191;1056908;1256448;;;;;;
340167,176;155828;4363;165376;1055704;1055991;1091584;1211532;1060354;1256960;;;;;;
340183,506;159499;1904;164864;1055991;1057687;1091584;1215490;1059591;1256448;;;;;;
340191,973;157040;4923;165888;1057687;1058159;1091584;1214727;1063082;1257472;;;;;;
340246,755;161083;2351;165376;1058159;1059914;1091584;1219242;1062265;1256960;;;;;;
340264,610;158511;1216;165888;1059914;1060410;1091584;1218425;1061626;1257472;;;;;;
340305,664;157888;4355;165888;1060410;1060674;1091584;1218298;1065029;1257472;;;;;;
340358,365;161027;928;166400;1060674;1062809;1091584;1221701;1063737;1257984;;;;;;
340386,943;158624;688;166400;1062809;1063209;1091584;1221433;1063897;1257984;;;;;;
340423,000;158384;1866;166912;1063209;1063649;1091584;1221593;1065515;1258496;;;;;;
340466,646;160074;1025;166400;1063649;1064232;1091584;1223723;1065257;1257984;;;;;;
340490,854;159233;1409;167424;1064232;1064232;1091584;1223465;1065641;1259008;;;;;;
340559,617;160641;1696;166912;1064232;1064232;1091584;1224873;1065928;1258496;;;;;;
340580,753;160928;2336;167936;1064232;1064232;1091584;1225160;1066568;1259520;;;;;;
340617,877;162592;2256;167424;1064232;1064233;1091584;1226824;1066489;1259008;;;;;;
340667,564;162512;2816;168960;1064233;1064232;1091584;1226745;1067048;1260544;;;;;;
340708,689;165120;2912;168448;1064232;1064233;1091584;1229352;1067145;1260032;;;;;;
340774,607;165216;3878;168960;1064233;1064233;1091584;1229449;1068111;1260544;;;;;;
340909,941;166691;3812;166912;1064232;1064233;1091584;1230923;1068045;1258496;;;;;;
341119,833;166628;6647;165376;1064233;1066276;1091584;1230861;1072923;1256960;;;;;;
341249,707;165367;8164;166912;1066276;1068599;1091584;1231643;1076763;1258496;;;;;;
341281,909;166884;8176;161792;1068599;1072329;1091584;1235483;1080505;1253376;;;;;;
341435,550;161776;4543;158208;1072329;1072346;1091584;1234105;1076889;1249792;;;;;;
341750,450;158143;8875;161280;1072346;1072345;1091584;1230489;1081220;1252864;;;;;;
341773,545;158379;8913;158720;1072345;1072345;1091584;1230724;1081258;1250304;;;;;;
341809,818;158417;9697;159744;1072345;1072346;1091584;1230762;1082043;1251328;;;;;;
341811,383;156129;14320;156160;1072346;1073545;1091584;1228475;1087865;1247744;;;;;;
341924,850;156144;14034;152576;1073545;1073785;1091584;1229689;1087819;1244160;;;;;;
341940,396;50691;12448;155648;1073785;1074881;1091584;1124476;1087329;1247232;;;;;;
341940,427;12448;0;155648;1074881;1027669;1091584;1087329;1027669;1247232;186012;186009;786432;1273341;1213678;2033664
342011,308;137216;944;154624;1027669;1027670;1091584;1164885;1028614;1246208;;;;;;
342388,629;137136;3262;155648;1027670;1027669;1091584;1164806;1030931;1247232;;;;;;
342742,313;139454;5394;157184;1027669;1027669;1091584;1167123;1033063;1248768;;;;;;
342842,522;143634;7451;156160;1027669;1027669;1091584;1171303;1035120;1247744;;;;;;
342919,664;145691;5779;158720;1027669;1028030;1091584;1173360;1033809;1250304;;;;;;
342973,149;147091;5627;157696;1028030;1029013;1091584;1175121;1034640;1249280;;;;;;
343072,442;146939;3570;159744;1029013;1030069;1091584;1175952;1033639;1251328;;;;;;
343219,857;147442;5107;159232;1030069;1030357;1091584;1177511;1035464;1250816;;;;;;
343393,450;148979;4502;160768;1030357;1030357;1091584;1179336;1034859;1252352;;;;;;
343426,982;150422;7622;160256;1030357;1030357;1091584;1180779;1037979;1251840;;;;;;
343468,464;153542;6196;161792;1030357;1030357;1091584;1183899;1036553;1253376;;;;;;
343498,086;154164;4799;161280;1030357;1030357;1091584;1184521;1035156;1252864;;;;;;
343519,927;152767;5252;162816;1030357;1030357;1091584;1183124;1035609;1254400;;;;;;
343545,882;155268;7507;162304;1030357;1030357;1091584;1185625;1037864;1253888;;;;;;
343565,378;157523;5695;163328;1030357;1030357;1091584;1187880;1036052;1254912;;;;;;
343872,903;156735;7347;162816;1030357;1030957;1091584;1187092;1038304;1254400;;;;;;
344252,187;158327;7927;163328;1030957;1030957;1091584;1189284;1038884;1254912;;;;;;
344309,656;159284;8099;163328;1030957;1030957;1091584;1190241;1039056;1254912;;;;;;
344409,733;159651;9523;162304;1030957;1030957;1091584;1190608;1040480;1253888;;;;;;
344426,598;160051;12277;162816;1030957;1031089;1091584;1191008;1043366;1254400;;;;;;
344442,432;162805;11871;157696;1031089;1031930;1091584;1193894;1043801;1249280;;;;;;
344451,873;157279;7647;160256;1031930;1033016;1091584;1189209;1040663;1251840;;;;;;
344470,724;153055;7231;161280;1033016;1033528;1091584;1186071;1040759;1252864;;;;;;
344487,434;154175;6721;160768;1033528;1034313;1091584;1187703;1041034;1252352;;;;;;
344560,099;153665;5295;161792;1034313;1035600;1091584;1187978;1040895;1253376;;;;;;
344665,859;153754;6793;161792;1035600;1036512;1091584;1189354;1043305;1253376;;;;;;
344728,997;155273;6871;162816;1036512;1037760;1091584;1191785;1044631;1254400;;;;;;
344736,647;156887;5071;162304;1037760;1038080;1091584;1194647;1043151;1253888;;;;;;
344758,329;155087;5838;163328;1038080;1038608;1091584;1193167;1044446;1254912;;;;;;
344804,707;156878;3775;162816;1038608;1039520;1091584;1195486;1043295;1254400;;;;;;
344918,715;154815;6556;163328;1039520;1040447;1091584;1194335;1047003;1254912;;;;;;
345022,398;157596;4803;162816;1040447;1041327;1091584;1198043;1046130;1254400;;;;;;
345050,569;155843;4068;163840;1041327;1041327;1091584;1197170;1045395;1255424;;;;;;
345099,564;156644;4762;163840;1041327;1042476;1091584;1197971;1047238;1255424;;;;;;
345115,635;157338;3556;163840;1042476;1042995;1091584;1199814;1046551;1255424;;;;;;
345184,402;156132;3359;163840;1042995;1043731;1091584;1199127;1047090;1255424;;;;;;
345207,901;155935;4747;164352;1043731;1044195;1091584;1199666;1048942;1255936;;;;;;
345251,005;158347;4523;164352;1044195;1044797;1091584;1202542;1049320;1255936;;;;;;
345288,630;158123;5073;165376;1044797;1044797;1091584;1202920;1049870;1256960;;;;;;
345307,883;160209;6270;164864;1044797;1044797;1091584;1205006;1051067;1256448;;;;;;
345321,450;161406;4100;165376;1044797;1045381;1091584;1206203;1049481;1256960;;;;;;
345333,468;159748;4244;165376;1045381;1047019;1091584;1205129;1051263;1256960;;;;;;
345342,619;159892;1622;164864;1047019;1049339;1091584;1206911;1050961;1256448;;;;;;
345359,075;157270;2279;165376;1049339;1049659;1091584;1206609;1051938;1256960;;;;;;
345365,896;157927;3652;165888;1049659;1049995;1091584;1207586;1053647;1257472;;;;;;
345411,224;159812;4144;165376;1049995;1050718;1091584;1209807;1054862;1256960;;;;;;
345544,377;104249;877;165376;1050718;1053331;1091584;1154967;1054208;1256960;;;;;;
345544,396;877;0;165376;1053331;1032406;1091584;1054208;1032406;1256960;186344;185983;786432;1240552;1218389;2043392
345764,606;156672;6146;165888;1032406;1032407;1091584;1189078;1038553;1257472;;;;;;
345794,391;162818;1122;165888;1032407;1034637;1091584;1195225;1035759;1257472;;;;;;
345842,215;157794;5356;165888;1034637;1034934;1091584;1192431;1040290;1257472;;;;;;
345849,900;162028;5020;165888;1034934;1035841;1091584;1196962;1040861;1257472;;;;;;
345863,103;161692;928;165888;1035841;1037996;1091584;1197533;1038924;1257472;;;;;;
345979,501;157600;5443;165888;1037996;1038156;1091584;1195596;1043599;1257472;;;;;;
346040,003;162115;1105;165888;1038156;1040233;1091584;1200271;1041338;1257472;;;;;;
346095,015;157777;1008;165888;1040233;1040593;1091584;1198010;1041601;1257472;;;;;;
346148,000;157680;1424;165888;1040593;1040592;1091584;1198273;1042016;1257472;;;;;;
346305,653;158096;3424;166400;1040592;1040593;1091584;1198688;1044017;1257984;;;;;;
346361,170;160608;6561;165888;1040593;1040593;1091584;1201201;1047154;1257472;;;;;;
346452,956;163745;3652;166400;1040593;1040593;1091584;1204338;1044245;1257984;;;;;;
346662,356;160836;5991;165888;1040593;1040593;1091584;1201429;1046584;1257472;;;;;;
346722,737;163175;4558;166400;1040593;1040593;1091584;1203768;1045151;1257984;;;;;;
347149,160;161742;5450;165888;1040593;1040593;1091584;1202335;1046043;1257472;;;;;;
347262,681;162634;8486;163840;1040593;1040593;1091584;1203227;1049079;1255424;;;;;;
348034,617;163110;5614;164864;1040593;1040593;1091584;1203703;1046207;1256448;;;;;;
348113,007;160238;7908;163840;1040593;1040593;1091584;1200831;1048501;1255424;;;;;;
348295,804;161508;7726;161792;1040593;1040593;1091584;1202101;1048319;1253376;;;;;;
348428,580;161316;8595;162816;1040593;1040593;1091584;1201909;1049188;1254400;;;;;;
348517,184;160147;5998;163328;1040593;1040593;1091584;1200740;1046591;1254912;;;;;;
348553,353;157550;6700;163840;1040593;1040593;1091584;1198143;1047293;1255424;;;;;;
348587,892;159276;8414;161280;1040593;1040889;1091584;1199869;1049303;1252864;;;;;;
348713,750;160990;10456;161280;1040889;1041097;1091584;1201879;1051553;1252864;;;;;;
348760,279;159960;6786;162304;1041097;1041353;1091584;1201057;1048139;1253888;;;;;;
348776,323;156290;7325;162816;1041353;1041688;1091584;1197643;1049013;1254400;;;;;;
348797,290;157853;10189;160768;1041688;1041696;1091584;1199541;1051885;1252352;;;;;;
348818,954;160717;6721;162816;1041696;1042061;1091584;1202413;1048782;1254400;;;;;;
348846,867;156737;6382;162304;1042061;1042670;1091584;1198798;1049052;1253888;;;;;;
348976,218;156112;7784;163328;1042670;1043205;1091584;1198782;1050989;1254912;;;;;;
349034,322;159172;8920;160768;1043205;1043206;1091584;1202377;1052126;1252352;;;;;;
349063,535;160472;7094;163328;1043206;1043205;1091584;1203678;1050299;1254912;;;;;;
349103,248;158134;6487;162816;1043205;1043509;1091584;1201339;1049996;1254400;;;;;;
349107,681;157527;8563;163840;1043509;1043701;1091584;1201036;1052264;1255424;;;;;;
349125,005;161139;6382;163840;1043701;1044165;1091584;1204840;1050547;1255424;;;;;;
349143,699;158958;6622;164352;1044165;1044582;1091584;1203123;1051204;1255936;;;;;;
349147,451;25021;7617;163840;1044581;1045293;1091584;1069602;1052910;1255424;;;;;;
349147,479;7617;0;163840;1045293;1031379;1091584;1052910;1031379;1255424;186857;186135;786432;1239767;1217514;2041856
349226,116;153088;784;163328;1031379;1031379;1091584;1184467;1032163;1254912;;;;;;
349448,836;153360;3359;156160;1031379;1031379;1091584;1184739;1034738;1247744;;;;;;
349478,195;155926;3744;163840;1031380;1031379;1091584;1187306;1035123;1255424;;;;;;
349590,397;155808;7501;163328;1031379;1031379;1091584;1187187;1038880;1254912;;;;;;
349631,609;159565;4639;163840;1031379;1031379;1091584;1190944;1036018;1255424;;;;;;
349665,105;157215;5055;163840;1031379;1031379;1091584;1188594;1036434;1255424;;;;;;
349694,985;157631;5312;164352;1031379;1031379;1091584;1189010;1036691;1255936;;;;;;
349934,889;158912;8387;162304;1031379;1031380;1091584;1190291;1039767;1253888;;;;;;
350225,941;161987;4703;164352;1031380;1031379;1091584;1193367;1036082;1255936;;;;;;
350288,309;157791;8442;163840;1031379;1031379;1091584;1189170;1039821;1255424;;;;;;
350313,738;161530;7407;163840;1031379;1031380;1091584;1192909;1038787;1255424;;;;;;
350363,188;159983;11257;163840;1031380;1034286;1091584;1191363;1045543;1255424;;;;;;
350378,577;163833;11247;158720;1034286;1035104;1091584;1198119;1046351;1250304;;;;;;
350513,016;158703;6575;154112;1035104;1035128;1091584;1193807;1041703;1245696;;;;;;
350718,760;154031;11805;158720;1035128;1035280;1091584;1189159;1047085;1250304;;;;;;
350733,686;156189;12198;156672;1035280;1035280;1091584;1191469;1047478;1248256;;;;;;
350763,985;156582;10747;158720;1035280;1036113;1091584;1191862;1046860;1250304;;;;;;
350812,873;153083;7397;158720;1036113;1036590;1091584;1189196;1043987;1250304;;;;;;
350842,861;149733;9720;159744;1036590;1036718;1091584;1186323;1046438;1251328;;;;;;
350984,749;153547;7404;159232;1036718;1037308;1091584;1190265;1044712;1250816;;;;;;
350998,693;151276;9408;160256;1037308;1037307;1091584;1188584;1046715;1251840;;;;;;
351011,515;154816;6910;160256;1037307;1037883;1091584;1192123;1044793;1251840;;;;;;
351040,245;152318;5839;160768;1037883;1039011;1091584;1190201;1044850;1252352;;;;;;
351112,976;152271;5003;160768;1039011;1039684;1091584;1191282;1044687;1252352;;;;;;
351217,733;151435;7743;161280;1039684;1040300;1091584;1191119;1048043;1252864;;;;;;
351231,207;154687;7948;160768;1040300;1040299;1091584;1194987;1048247;1252352;;;;;;
351589,610;154892;5324;161792;1040299;1040820;1091584;1195191;1046144;1253376;;;;;;
351699,213;153804;9069;161792;1040820;1040819;1091584;1194624;1049888;1253376;;;;;;
352057,615;157549;8648;162304;1040819;1040820;1091584;1198368;1049468;1253888;;;;;;
352206,254;157640;9675;161792;1040820;1040819;1091584;1198460;1050494;1253376;;;;;;
352261,980;158667;6469;162304;1040819;1040820;1091584;1199486;1047289;1253888;;;;;;
352681,984;155325;7700;161792;1040819;1041140;1091584;1196144;1048840;1253376;;;;;;
352718,295;156692;8606;162816;1041140;1041171;1091584;1197832;1049777;1254400;;;;;;
352733,475;159134;8421;162816;1041171;1041187;1091584;1200305;1049608;1254400;;;;;;
352750,870;46054;6618;163328;1041187;1041211;1091584;1087241;1047829;1254912;;;;;;
352750,906;6618;0;163328;1041211;1030763;1091584;1047829;1030763;1254912;186975;185994;786432;1234804;1216757;2041344
352780,669;151040;1008;152064;1030763;1030763;1091584;1181803;1031771;1243648;;;;;;
352846,255;152048;5456;162816;1030763;1030763;1091584;1182811;1036219;1254400;;;;;;
352888,608;155472;8785;162304;1030763;1030763;1091584;1186235;1039548;1253888;;;;;;
353009,741;158801;7103;162816;1030763;1030764;1091584;1189564;1037867;1254400;;;;;;
353065,505;157119;8081;162304;1030764;1030763;1091584;1187883;1038844;1253888;;;;;;
353118,947;158097;8087;163328;1030763;1030763;1091584;1188860;1038850;1254912;;;;;;
353187,733;159639;6688;163328;1030763;1030764;1091584;1190402;1037452;1254912;;;;;;
353268,327;158240;7760;163840;1030764;1030764;1091584;1189004;1038524;1255424;;;;;;
353361,366;160336;6830;163840;1030764;1030764;1091584;1191100;1037594;1255424;;;;;;
353433,153;159406;8659;163328;1030764;1030764;1091584;1190170;1039423;1254912;;;;;;
353506,558;161235;10751;163328;1030764;1030763;1091584;1191999;1041514;1254912;;;;;;
353562,463;163327;9932;162304;1030763;1030764;1091584;1194090;1040696;1253888;;;;;;
353585,441;160460;10738;161280;1030764;1030763;1091584;1191224;1041501;1252864;;;;;;
353605,535;161266;9908;161792;1030763;1030763;1091584;1192029;1040671;1253376;;;;;;
353643,977;158388;11013;159744;1030763;1030763;1091584;1189151;1041776;1251328;;;;;;
353658,168;159493;9374;161792;1030763;1031180;1091584;1190256;1040554;1253376;;;;;;
353679,920;157342;9395;161280;1031180;1033082;1091584;1188522;1042477;1252864;;;;;;
353707,018;157363;8803;162304;1033082;1034130;1091584;1190445;1042933;1253888;;;;;;
353725,562;157795;8835;161792;1034130;1035247;1091584;1191925;1044082;1253376;;;;;;
353779,082;157827;7663;162816;1035247;1035391;1091584;1193074;1043054;1254400;;;;;;
353796,254;158191;8073;162816;1035391;1035885;1091584;1193582;1043958;1254400;;;;;;
353814,420;158601;9814;162816;1035885;1036790;1091584;1194486;1046604;1254400;;;;;;
353827,492;160342;7491;162816;1036790;1037683;1091584;1197132;1045174;1254400;;;;;;
353895,823;158019;5407;162816;1037683;1038579;1091584;1195702;1043986;1254400;;;;;;
353905,516;155935;7076;162816;1038579;1039554;1091584;1194514;1046630;1254400;;;;;;
353918,414;157558;5096;162816;1039555;1040436;1091584;1197113;1045532;1254400;;;;;;
353938,263;155624;4332;162816;1040436;1041468;1091584;1196060;1045800;1254400;;;;;;
353954,843;154860;7486;162816;1041468;1042011;1091584;1196328;1049497;1254400;;;;;;
354025,826;158014;5781;162816;1042011;1042831;1091584;1200025;1048612;1254400;;;;;;
354057,662;156309;3714;162304;1042831;1044189;1091584;1199140;1047903;1253888;;;;;;
354086,339;154242;4536;162816;1044189;1044957;1091584;1198431;1049493;1254400;;;;;;
354095,738;155064;1072;162304;1044957;1046892;1091584;1200021;1047964;1253888;;;;;;
354105,636;151600;929;151552;1046892;1047205;1091584;1198492;1048134;1243136;;;;;;
354123,156;151457;4420;162816;1047205;1047221;1091584;1198662;1051641;1254400;;;;;;
354141,936;154436;4368;162304;1047221;1047644;1091584;1201657;1052012;1253888;;;;;;
354145,533;154384;896;163328;1047644;1049836;1091584;1202028;1050732;1254912;;;;;;
354225,865;152448;4550;163328;1049836;1050084;1091584;1202284;1054634;1254912;;;;;;
354282,139;156038;973;163840;1050085;1052344;1091584;1206123;1053317;1255424;;;;;;
354359,550;153549;865;163840;1052344;1052393;1091584;1205893;1053258;1255424;;;;;;
354399,344;153441;4656;164352;1052393;1052617;1091584;1205834;1057273;1255936;;;;;;
354458,222;157744;4723;163840;1052617;1053564;1091584;1210361;1058287;1255424;;;;;;
354523,818;157811;3055;164864;1053564;1053563;1091584;1211375;1056618;1256448;;;;;;
354653,916;157679;3639;164864;1053563;1053563;1091584;1211242;1057202;1256448;;;;;;
354819,697;158263;8404;163328;1053563;1053564;1091584;1211826;1061968;1254912;;;;;;
354840,046;162004;8796;162816;1053564;1053564;1091584;1215568;1062360;1254400;;;;;;
354905,997;162396;5185;163840;1053564;1053563;1091584;1215960;1058748;1255424;;;;;;
354938,880;157249;6403;163328;1053563;1053564;1091584;1210812;1059967;1254912;;;;;;
355000,878;158467;8755;162816;1053564;1053563;1091584;1212031;1062318;1254400;;;;;;
355025,143;160307;8046;159744;1053563;1053564;1091584;1213870;1061610;1251328;;;;;;
355051,657;159598;6638;163328;1053564;1053564;1091584;1213162;1060202;1254912;;;;;;
355079,807;157678;8675;162816;1053564;1053563;1091584;1211242;1062238;1254400;;;;;;
355134,217;159715;7166;162816;1053563;1053564;1091584;1213278;1060730;1254400;;;;;;
355197,504;157694;7247;162816;1053564;1053563;1091584;1211258;1060810;1254400;;;;;;
355231,908;157775;8478;162304;1053563;1053564;1091584;1211338;1062042;1253888;;;;;;
355283,652;159006;8414;162816;1053564;1053564;1091584;1212570;1061978;1254400;;;;;;
355317,333;158942;9143;161792;1053564;1054539;1091584;1212506;1063682;1253376;;;;;;
355325,968;158647;8452;162304;1054539;1054876;1091584;1213186;1063328;1253888;;;;;;
355356,707;157956;10536;161280;1054876;1055864;1091584;1212832;1066400;1252864;;;;;;
355365,369;159016;7231;161792;1055864;1056576;1091584;1214880;1063807;1253376;;;;;;
355393,662;155711;7003;162816;1056576;1057502;1091584;1212287;1064505;1254400;;;;;;
355409,647;157019;9483;162304;1057502;1057789;1091584;1214521;1067272;1253888;;;;;;
355424,032;159499;10080;161280;1057789;1058189;1091584;1217288;1068269;1252864;;;;;;
355484,347;158560;8652;161792;1058189;1058525;1091584;1216749;1067177;1253376;;;;;;
355533,859;157132;7136;162304;1058525;1059630;1091584;1215657;1066766;1253888;;;;;;
355547,115;156640;4715;162304;1059630;1060455;1091584;1216270;1065170;1253888;;;;;;
355560,413;154219;5453;162304;1060455;1061455;1091584;1214674;1066908;1253888;;;;;;
355572,853;154957;5604;162304;1061455;1062160;1091584;1216412;1067764;1253888;;;;;;
355611,570;155108;3843;162816;1062160;1062599;1091584;1217268;1066442;1254400;;;;;;
355681,269;154371;6477;162816;1062599;1063589;1091584;1216970;1070066;1254400;;;;;;
355740,605;157005;5521;163328;1063589;1064196;1091584;1220594;1069717;1254912;;;;;;
355768,728;156673;8695;163328;1064197;1064197;1091584;1220870;1072892;1254912;;;;;;
355793,820;160086;6408;163328;1064197;1064316;1091584;1224283;1070724;1254912;;;;;;
355794,321;157960;6515;163328;1064316;1064838;1091584;1222276;1071353;1254912;;;;;;
355845,463;158067;3908;177152;1064838;1066157;1091584;1222905;1070065;1268736;;;;;;
355870,669;176964;6200;173568;1066157;1068013;1091584;1243121;1074213;1265152;;;;;;
355957,362;173112;5929;167424;1068013;1068797;1091584;1241125;1074726;1259008;;;;;;
355972,828;167209;4468;160256;1068797;1069798;1091584;1236006;1074266;1251840;;;;;;
355984,626;160116;4052;159232;1069798;1070910;1091584;1229914;1074962;1250816;;;;;;
355991,218;159188;2059;157696;1070910;1072662;1091584;1230098;1074721;1249280;;;;;;
355992,925;157195;4472;164864;1072662;1074054;1091584;1229857;1078526;1256448;;;;;;
356004,713;158584;2816;164352;1074054;1074406;1091584;1232638;1077222;1255936;;;;;;
356011,777;156928;4356;164864;1074406;1074711;1091584;1231334;1079067;1256448;;;;;;
356023,063;158980;3018;164864;1074711;1075516;1091584;1233691;1078534;1256448;;;;;;
356045,515;157642;2400;165376;1075516;1076035;1091584;1233158;1078435;1256960;;;;;;
356172,881;158048;3536;165376;1076035;1076636;1091584;1234083;1080172;1256960;;;;;;
356323,024;159184;6392;165376;1076636;1077802;1091584;1235820;1084194;1256960;;;;;;
356345,924;162040;5847;165376;1077802;1078396;1091584;1239842;1084243;1256960;;;;;;
356353,546;67998;288;164352;1078396;1080423;1091584;1146394;1080711;1255936;;;;;;
356353,560;288;0;164352;1080423;1046270;1091584;1080711;1046270;1255936;189534;185997;786432;1270245;1232267;2042368
356416,869;154624;3399;164864;1046270;1046271;1091584;1200894;1049670;1256448;;;;;;
356535,674;158023;6904;164352;1046271;1046617;1091584;1204294;1053521;1255936;;;;;;
356611,047;161528;4488;164864;1046617;1047727;1091584;1208145;1052215;1256448;;;;;;
356621,928;159112;1455;165376;1047727;1049831;1091584;1206839;1051286;1256960;;;;;;
356644,324;157103;1894;165376;1049831;1050310;1091584;1206934;1052204;1256960;;;;;;
356695,441;157528;2576;165888;1050311;1050806;1091584;1207839;1053382;1257472;;;;;;
356746,123;158736;1280;165376;1050806;1052647;1091584;1209542;1053927;1256960;;;;;;
356820,468;157440;4282;166400;1052647;1052647;1091584;1210087;1056929;1257984;;;;;;
356871,589;161466;8593;165888;1052647;1052647;1091584;1214113;1061240;1257472;;;;;;
357196,021;165777;5891;163840;1052647;1052648;1091584;1218424;1058539;1255424;;;;;;
357715,024;160515;8269;163328;1052648;1052648;1091584;1213163;1060917;1254912;;;;;;
357763,830;162893;5840;164352;1052648;1052647;1091584;1215541;1058487;1255936;;;;;;
357815,727;158928;7426;163840;1052647;1052648;1091584;1211575;1060074;1255424;;;;;;
358105,529;160514;9397;161792;1052648;1052648;1091584;1213162;1062045;1253376;;;;;;
358288,662;159925;5982;162816;1052648;1052648;1091584;1212573;1058630;1254400;;;;;;
358451,457;156510;6638;163328;1052648;1052648;1091584;1209158;1059286;1254912;;;;;;
358480,158;158190;8736;160768;1052648;1052647;1091584;1210838;1061383;1252352;;;;;;
358620,706;160288;11087;160768;1052647;1052648;1091584;1212935;1063735;1252352;;;;;;
358654,254;159567;10540;159232;1052648;1052647;1091584;1212215;1063187;1250816;;;;;;
358668,613;159020;8674;160768;1052647;1052647;1091584;1211667;1061321;1252352;;;;;;
358934,719;155078;10326;157184;1052700;1052701;1091584;1207778;1063027;1248768;;;;;;
358981,957;156758;14005;157184;1052703;1053342;1091584;1209461;1067347;1248768;;;;;;
359037,471;156341;11811;154624;1053342;1053598;1091584;1209683;1065409;1246208;;;;;;
359246,746;154147;7170;158720;1053598;1054405;1091584;1207745;1061575;1250304;;;;;;
359297,892;148994;8966;158208;1054405;1054601;1091584;1203399;1063567;1249792;;;;;;
359373,526;150790;8225;159744;1054601;1055041;1091584;1205391;1063266;1251328;;;;;;
359500,741;152097;9875;159232;1055041;1055057;1091584;1207138;1064932;1250816;;;;;;
359536,133;153747;10970;159232;1055057;1055145;1091584;1208804;1066115;1250816;;;;;;
359563,483;155354;10977;159744;1055145;1055537;1091584;1210499;1066514;1251328;;;;;;
359578,022;155361;10099;159744;1055537;1055785;1091584;1210898;1065884;1251328;;;;;;
359608,606;154483;8462;159744;1055785;1056497;1091584;1210268;1064959;1251328;;;;;;
359624,481;152846;7868;160768;1056497;1057665;1091584;1209343;1065533;1252352;;;;;;
359640,384;153754;8808;160256;1057665;1057913;1091584;1211419;1066721;1251840;;;;;;
359673,342;154728;7779;161280;1057913;1058965;1091584;1212641;1066744;1252864;;;;;;
359719,737;155011;8629;161280;1058965;1059856;1091584;1213976;1068485;1252864;;;;;;
359753,981;156085;5055;161792;1059856;1060965;1091584;1215941;1066020;1253376;;;;;;
359784,019;153535;5776;161792;1060965;1062158;1091584;1214500;1067934;1253376;;;;;;
359819,670;154256;4542;161792;1062158;1062350;1091584;1216414;1066892;1253376;;;;;;
359859,779;153022;3408;152064;1062350;1062846;1091584;1215372;1066254;1243648;;;;;;
359881,319;151888;3556;161280;1062846;1062846;1091584;1214734;1066402;1252864;;;;;;
359908,687;151012;3616;161280;1062846;1062846;1091584;1213858;1066462;1252864;;;;;;
359935,827;151072;3840;161792;1062846;1062846;1091584;1213918;1066686;1253376;;;;;;
359956,453;94022;3328;161280;1062846;1062845;1091584;1156868;1066173;1252864;;;;;;
359956,469;3328;0;161280;1062845;1042163;1091584;1066173;1042163;1252864;187504;185997;786432;1253677;1228160;2039296
359990,110;147968;1056;161792;1042163;1042164;1091584;1190131;1043220;1253376;;;;;;
360054,208;149536;1008;161792;1042164;1042163;1091584;1191700;1043171;1253376;;;;;;
360095,517;149488;752;161792;1042163;1042163;1091584;1191651;1042915;1253376;;;;;;
360129,822;149232;992;161792;1042163;1042163;1091584;1191395;1043155;1253376;;;;;;
360218,345;149424;1668;162304;1042164;1042164;1091584;1191588;1043832;1253888;;;;;;
360626,756;150660;6472;161792;1042164;1042163;1091584;1192824;1048635;1253376;;;;;;
360653,891;155464;6474;162304;1042163;1042164;1091584;1197627;1048638;1253888;;;;;;
360693,614;155978;4737;162304;1042164;1042164;1091584;1198142;1046901;1253888;;;;;;
360734,690;154241;8192;161792;1042164;1042163;1091584;1196405;1050355;1253376;;;;;;
360755,101;157696;5409;162304;1042163;1042164;1091584;1199859;1047573;1253888;;;;;;
360791,734;154913;7747;162816;1042164;1042164;1091584;1197077;1049911;1254400;;;;;;
360812,881;158275;7008;162816;1042164;1042163;1091584;1200439;1049171;1254400;;;;;;
360834,099;157536;6483;162816;1042163;1042164;1091584;1199699;1048647;1254400;;;;;;
360882,519;157011;9635;160256;1042164;1042164;1091584;1199175;1051799;1251840;;;;;;
360901,222;160163;10036;160256;1042164;1042164;1091584;1202327;1052200;1251840;;;;;;
360917,237;157492;8032;161280;1042164;1042372;1091584;1199656;1050404;1252864;;;;;;
360980,023;155488;7567;161792;1042372;1042548;1091584;1197860;1050115;1253376;;;;;;
360988,656;155535;6943;161280;1042548;1043460;1091584;1198083;1050403;1252864;;;;;;
361029,196;154911;8723;161280;1043460;1044040;1091584;1198371;1052763;1252864;;;;;;
361118,289;157203;6109;161792;1044040;1044735;1091584;1201243;1050844;1253376;;;;;;
361135,059;154589;10238;161280;1044735;1045685;1091584;1199324;1055923;1252864;;;;;;
361243,765;158718;8715;161792;1045685;1046787;1091584;1204403;1055502;1253376;;;;;;
361269,923;157195;5921;162304;1046787;1047546;1091584;1203982;1053467;1253888;;;;;;
361581,345;154913;8242;161792;1047546;1047650;1091584;1202459;1055892;1253376;;;;;;
361646,553;157234;10639;161280;1047650;1047650;1091584;1204884;1058289;1252864;;;;;;
361682,756;159119;9818;158720;1047650;1047651;1091584;1206769;1057469;1250304;;;;;;
361685,617;20122;12303;159232;1047651;1047651;1091584;1067773;1059954;1250816;;;;;;
361685,636;12303;0;159232;1047651;1051604;1091584;1059954;1051604;1250816;186681;186011;786432;1246635;1237615;2037248
361803,853;83058;7294;160256;1051604;1051605;1091584;1134662;1058899;1251840;;;;;;
361803,876;7294;0;160256;1051605;1052241;1091584;1058899;1052241;1251840;186013;186013;786432;1244912;1238254;2038272
361816,198;26447;6382;160768;1052241;1052242;1091584;1078688;1058624;1252352;;;;;;
361816,212;6382;0;160768;1052242;1051923;1091584;1058624;1051923;1252352;186018;186018;786432;1244642;1237941;2038784
361818,650;16850;6062;160768;1051923;1051924;1091584;1068773;1057986;1252352;;;;;;
361818,665;6062;0;160768;1051924;1052003;1091584;1057986;1052003;1252352;186020;186020;786432;1244006;1238023;2038784
362033,635;146432;5684;161280;1052003;1052004;1091584;1198435;1057688;1252864;;;;;;
362125,274;153140;6698;161280;1052004;1052004;1091584;1205144;1058702;1252864;;;;;;
362188,686;154154;7726;162304;1052004;1052003;1091584;1206158;1059729;1253888;;;;;;
362231,936;156718;8711;161792;1052003;1052004;1091584;1208721;1060715;1253376;;;;;;
362281,266;157703;7580;162816;1052004;1052004;1091584;1209707;1059584;1254400;;;;;;
362285,768;157596;7292;162304;1052004;1052004;1091584;1209600;1059296;1253888;;;;;;
362308,371;157308;9482;162304;1052004;1052003;1091584;1209312;1061485;1253888;;;;;;
362325,612;160010;7907;162816;1052003;1052004;1091584;1212013;1059911;1254400;;;;;;
362354,086;158435;11756;160256;1052004;1053652;1091584;1210439;1065408;1251840;;;;;;
362356,542;160236;13207;161792;1053652;1053652;1091584;1213888;1066859;1253376;;;;;;
362359,532;161687;13296;155648;1053652;1063840;1091584;1215339;1077136;1247232;;;;;;
362443,003;155632;7444;145408;1063840;1065025;1091584;1219472;1072469;1236992;;;;;;
362484,758;145172;7451;155136;1065025;1066057;1091584;1210197;1073508;1246720;;;;;;
362506,500;144667;5461;156160;1066057;1066304;1091584;1210724;1071765;1247744;;;;;;
362516,622;142677;7187;157184;1066304;1067289;1091584;1208981;1074476;1248768;;;;;;
362547,620;145939;4783;156672;1067289;1068152;1091584;1213228;1072935;1248256;;;;;;
362585,569;143535;4300;157184;1068152;1069376;1091584;1211687;1073676;1248768;;;;;;
362651,089;143564;6830;157184;1069376;1070376;1091584;1212940;1077206;1248768;;;;;;
362671,572;146094;3795;158208;1070376;1072683;1091584;1216470;1076478;1249792;;;;;;
362672,076;145107;6532;158208;1072683;1074046;1091584;1217790;1080578;1249792;;;;;;
362677,325;147761;1695;184320;1074629;1078860;1091584;1222390;1080555;1275904;;;;;;
362691,658;170143;5030;184832;1078865;1079139;1091584;1249008;1084169;1276416;;;;;;
362755,764;173478;2544;165376;1079139;1079859;1091584;1252617;1082403;1256960;;;;;;
362894,553;165360;6935;164352;1079859;1080606;1091584;1245219;1087541;1255936;;;;;;
362907,947;164119;4560;156672;1080606;1082172;1091584;1244725;1086732;1248256;;;;;;
362921,850;156624;6791;184832;1082172;1083012;1091584;1238796;1089803;1276416;;;;;;
362946,855;184455;5025;181248;1083012;1084931;1091584;1267467;1089956;1272832;;;;;;
362949,751;176545;7509;173568;1084931;1085787;1091584;1261476;1093296;1265152;;;;;;
362965,700;173397;3136;166912;1085787;1087551;1091584;1259184;1090687;1258496;;;;;;
363069,477;163392;3328;158720;1087551;1088063;1091584;1250943;1091391;1250304;;;;;;
363158,802;158464;7710;158208;1088063;1088638;1091584;1246527;1096348;1249792;;;;;;
363158,823;7710;0;158208;1088638;1059789;1132032;1096348;1059789;1290240;186703;186149;786432;1283051;1245938;2076672
363191,801;150016;5076;155648;1059789;1059790;1132032;1209805;1064866;1287680;;;;;;
363208,217;155604;3638;162816;1059790;1061566;1132032;1215394;1065204;1294848;;;;;;
363401,619;154166;6252;162816;1061566;1062285;1132032;1215732;1068537;1294848;;;;;;
363445,921;156780;4580;163840;1062285;1063415;1132032;1219065;1067995;1295872;;;;;;
363574,827;156644;4385;163328;1063415;1064255;1132032;1220059;1068640;1295360;;;;;;
363610,968;156449;5871;164352;1064255;1064255;1132032;1220704;1070126;1296384;;;;;;
363616,669;93160;10747;164352;1064255;1064687;1132032;1157415;1075434;1296384;;;;;;
363616,686;10747;0;164352;1064687;1063735;1132032;1075434;1063735;1296384;186336;186052;786432;1261770;1249787;2082816
363640,140;44253;6788;162304;1063735;1063736;1132032;1107988;1070524;1294336;;;;;;
363640,162;6788;0;162304;1063736;1062138;1132032;1070524;1062138;1294336;186053;186053;786432;1256577;1248191;2080768
363685,434;151552;4795;163328;1062138;1062139;1132032;1213690;1066934;1295360;;;;;;
363703,994;156347;5127;163840;1062139;1062139;1132032;1218486;1067266;1295872;;;;;;
363717,479;157191;5428;163328;1062139;1062138;1132032;1219330;1067566;1295360;;;;;;
363738,659;157348;7514;164352;1062139;1062139;1132032;1219487;1069653;1296384;;;;;;
363774,961;161114;8946;162816;1062139;1062138;1132032;1223253;1071084;1294848;;;;;;
363805,954;162546;4321;163840;1062138;1062659;1132032;1224684;1066980;1295872;;;;;;
363813,276;156385;4497;163328;1062659;1062659;1132032;1219044;1067156;1295360;;;;;;
363840,345;156561;9020;162816;1062659;1063500;1132032;1219220;1072520;1294848;;;;;;
363854,060;160536;6268;163328;1063500;1064818;1132032;1224036;1071086;1295360;;;;;;
363935,702;157820;3327;163840;1064818;1065234;1132032;1222638;1068561;1295872;;;;;;
363981,272;155863;6426;163840;1066694;1067268;1132032;1222557;1073694;1295872;;;;;;
364147,879;159002;7284;164352;1067288;1067289;1132032;1226290;1074573;1296384;;;;;;
364298,054;160884;10739;164352;1067289;1067830;1132032;1228173;1078569;1296384;;;;;;
364322,277;164339;10748;159232;1067830;1068695;1132032;1232169;1079443;1291264;;;;;;
364324,368;159228;13792;162304;1068695;1071782;1132032;1227923;1085574;1294336;;;;;;
364655,646;162272;12203;156160;1071782;1072709;1132032;1234054;1084912;1288192;;;;;;
364680,203;156075;2962;173056;1072709;1081248;1132032;1228784;1084210;1305088;;;;;;
364719,683;172946;5809;176128;1081248;1081736;1132032;1254194;1087545;1308160;;;;;;
364837,110;164529;6680;160768;1081736;1082632;1132032;1246265;1089312;1292800;;;;;;
364863,328;160280;3939;158720;1082632;1084903;1132032;1242912;1088842;1290752;;;;;;
364877,449;152419;4688;153600;1084903;1085135;1132032;1237322;1089823;1285632;;;;;;
364878,081;153168;7208;160256;1085135;1087795;1132032;1238303;1095003;1292288;;;;;;
364900,416;152104;448;159744;1087795;1092027;1132032;1239899;1092475;1291776;;;;;;
364995,588;145344;5007;160768;1092027;1092075;1132032;1237371;1097082;1292800;;;;;;
365037,327;150415;4200;159744;1092075;1092741;1132032;1242490;1096941;1291776;;;;;;
365055,135;149608;3811;161280;1092741;1093405;1132032;1242349;1097216;1293312;;;;;;
365081,445;150755;3956;160768;1093405;1094013;1132032;1244160;1097969;1292800;;;;;;
365093,156;150900;1201;161792;1094013;1096108;1132032;1244913;1097309;1293824;;;;;;
365136,153;149681;785;161792;1096108;1096503;1132032;1245789;1097288;1293824;;;;;;
365195,619;149265;736;161792;1096503;1096655;1132032;1245768;1097391;1293824;;;;;;
365204,398;147979;6249;161792;1096655;1097111;1132032;1244634;1103360;1293824;;;;;;
365257,402;154729;2960;162816;1097111;1097671;1132032;1251840;1100631;1294848;;;;;;
365379,133;152976;1256;162304;1097671;1099151;1132032;1250647;1100407;1294336;;;;;;
365440,410;151122;2954;163328;1099314;1100123;1132032;1250436;1103077;1295360;;;;;;
365505,706;153994;5763;162816;1100127;1100126;1132032;1254121;1105889;1294848;;;;;;
365545,945;156803;4577;164352;1100126;1100127;1132032;1256929;1104704;1296384;;;;;;
365571,055;157665;4766;163840;1100127;1100126;1132032;1257792;1104892;1295872;;;;;;
365612,156;157854;7330;163328;1100126;1100127;1132032;1257980;1107457;1295360;;;;;;
365612,851;159906;10663;163328;1100127;1100126;1132032;1260033;1110789;1295360;;;;;;
365740,496;163239;1679;161280;1100126;1102086;1132032;1263365;1103765;1293312;;;;;;
365770,647;151183;5939;162304;1102086;1102390;1132032;1253269;1108329;1294336;;;;;;
365789,550;155443;5295;163328;1102390;1103110;1132032;1257833;1108405;1295360;;;;;;
365841,319;156335;3587;162816;1103110;1104181;1132032;1259445;1107768;1294848;;;;;;
365865,094;154451;4966;164352;1104182;1104952;1132032;1258633;1109918;1296384;;;;;;
366006,150;158054;6313;163840;1104952;1105724;1132032;1263006;1112037;1295872;;;;;;
366027,307;159401;4644;164864;1105724;1106411;1132032;1265125;1111055;1296896;;;;;;
366158,456;158756;3408;164352;1106411;1107051;1132032;1265167;1110459;1296384;;;;;;
366228,919;157520;4973;165376;1107051;1108519;1132032;1264571;1113492;1297408;;;;;;
366262,760;160621;704;165376;1108519;1110642;1132032;1269140;1111346;1297408;;;;;;
366269,420;156352;802;165376;1110642;1110890;1132032;1266994;1111692;1297408;;;;;;
366286,723;156450;624;165376;1110890;1111058;1132032;1267340;1111682;1297408;;;;;;
366380,908;156272;7597;163328;1111058;1111338;1132032;1267330;1118935;1295360;;;;;;
366807,475;161197;2215;164352;1111345;1113533;1132032;1272542;1115748;1296384;;;;;;
366863,299;155815;7071;163840;1113536;1113536;1132032;1269351;1120607;1295872;;;;;;
367034,649;160671;6858;160768;1113536;1113537;1132032;1274207;1120395;1292800;;;;;;
367221,118;160458;9965;160768;1113537;1113536;1132032;1273995;1123501;1292800;;;;;;
367235,946;159469;6737;162304;1113536;1113537;1132032;1273005;1120274;1294336;;;;;;
367243,636;91640;6191;162816;1113537;1113537;1132032;1205177;1119728;1294848;;;;;;
367243,656;6191;0;162816;1113537;1062530;1132032;1119728;1062530;1294848;187496;186259;786432;1307224;1248789;2081280
367263,316;150016;1392;162304;1062530;1062530;1132032;1212546;1063922;1294336;;;;;;
367265,808;151408;1680;162816;1062530;1062530;1132032;1213938;1064210;1294848;;;;;;
367271,980;152208;2042;162816;1062530;1062531;1132032;1214738;1064573;1294848;;;;;;
367326,995;152570;7075;162304;1062531;1062531;1132032;1215101;1069606;1294336;;;;;;
367346,592;157603;8424;159232;1062531;1062530;1132032;1220134;1070954;1291264;;;;;;
367390,511;158952;6036;162816;1062530;1063382;1132032;1221482;1069418;1294848;;;;;;
367411,834;156052;3504;162304;1063382;1064320;1132032;1219434;1067824;1294336;;;;;;
367550,511;153510;1591;163328;1064320;1067060;1132032;1217830;1068651;1295360;;;;;;
367713,995;153143;9257;161280;1067060;1067284;1132032;1220203;1076541;1293312;;;;;;
367734,907;160809;8979;160256;1067284;1067283;1132032;1228093;1076262;1292288;;;;;;
367760,799;156435;5011;161280;1067299;1067300;1132032;1223734;1072311;1293312;;;;;;
367769,402;152467;6322;162816;1067304;1067304;1132032;1219771;1073626;1294848;;;;;;
367792,811;156338;3839;162304;1067304;1068263;1132032;1223642;1072102;1294336;;;;;;
367805,506;153855;3984;163328;1068263;1069046;1132032;1222118;1073030;1295360;;;;;;
367811,975;155024;2644;162816;1069046;1069934;1132032;1224070;1072578;1294848;;;;;;
367898,100;153684;4691;164352;1069934;1070680;1132032;1223618;1075371;1296384;;;;;;
367910,818;157779;4160;163840;1070680;1071501;1132032;1228459;1075661;1295872;;;;;;
367958,942;157248;1264;163840;1071501;1073777;1132032;1228749;1075041;1295872;;;;;;
368224,101;154657;3614;164352;1073776;1074457;1132032;1228433;1078071;1296384;;;;;;
368463,379;157214;8198;163840;1074457;1074457;1132032;1231671;1082655;1295872;;;;;;
368526,058;161798;6953;160768;1074457;1074457;1132032;1236255;1081410;1292800;;;;;;
368606,419;160553;11235;159744;1074457;1074947;1132032;1235010;1086182;1291776;;;;;;
368620,451;159715;7875;161792;1074947;1076865;1132032;1234662;1084740;1293824;;;;;;
368672,722;156355;8740;161792;1076865;1076865;1132032;1233220;1085605;1293824;;;;;;
368755,515;157220;9120;157696;1076865;1076865;1132032;1234085;1085985;1289728;;;;;;
368777,763;157600;8640;161280;1076865;1076865;1132032;1234465;1085505;1293312;;;;;;
368839,041;156096;12928;160768;1076865;1076865;1132032;1232961;1089793;1292800;;;;;;
369088,672;160384;14254;157184;1076865;1076865;1132032;1237249;1091119;1289216;;;;;;
369150,112;157102;17401;155648;1076865;1077047;1132032;1233967;1094448;1287680;;;;;;
369163,807;155641;11669;150016;1077047;1078166;1132032;1232688;1089835;1282048;;;;;;
369169,470;146837;12800;155136;1078166;1078166;1132032;1225003;1090966;1287168;;;;;;
369170,785;147968;15637;152064;1078166;1083018;1132032;1226134;1098655;1284096;;;;;;
369179,048;147733;8174;153600;1083018;1083491;1132032;1230751;1091665;1285632;;;;;;
369186,427;140270;3743;154624;1083491;1085559;1132032;1223761;1089302;1286656;;;;;;
369240,285;137887;4682;154624;1085559;1086280;1132032;1223446;1090962;1286656;;;;;;
369250,682;138826;5444;155136;1086280;1086968;1132032;1225106;1092412;1287168;;;;;;
369279,746;140100;3215;154624;1086968;1087479;1132032;1227068;1090694;1286656;;;;;;
369310,115;137871;4115;156160;1087479;1088561;1132032;1225350;1092676;1288192;;;;;;
369340,828;140819;4064;155648;1088561;1089416;1132032;1229380;1093480;1287680;;;;;;
369463,082;140768;5012;157184;1089416;1090216;1132032;1230184;1095228;1289216;;;;;;
369486,428;143764;4392;156672;1090216;1091192;1132032;1233980;1095584;1288704;;;;;;
369504,314;143144;688;157696;1091192;1093192;1132032;1234336;1093880;1289728;;;;;;
369521,597;140976;832;157696;1093192;1093384;1132032;1234168;1094216;1289728;;;;;;
369559,255;141120;4256;158720;1093384;1093625;1132032;1234504;1097881;1290752;;;;;;
369661,017;146080;6131;158208;1093625;1094312;1132032;1239705;1100443;1290240;;;;;;
369727,557;147955;4323;160256;1094312;1094312;1132032;1242267;1098635;1292288;;;;;;
369773,602;149219;3711;159744;1094312;1094312;1132032;1243531;1098023;1291776;;;;;;
369793,344;148607;7112;161280;1094312;1094312;1132032;1242919;1101424;1293312;;;;;;
369812,031;154568;6373;161280;1094312;1094313;1132032;1248880;1100686;1293312;;;;;;
369825,634;153829;7630;161792;1094313;1094312;1132032;1248142;1101942;1293824;;;;;;
369906,654;156110;9085;157696;1094312;1094936;1132032;1250422;1104021;1289728;;;;;;
369970,943;157565;7140;161792;1094936;1094936;1132032;1252501;1102076;1293824;;;;;;
370069,169;155108;8106;161280;1094936;1094936;1132032;1250044;1103042;1293312;;;;;;
370086,572;156074;10250;159744;1094936;1094936;1132032;1251010;1105186;1291776;;;;;;
370103,505;156682;10794;157696;1094936;1094936;1132032;1251618;1105730;1289728;;;;;;
370124,802;157226;10486;159232;1094936;1095481;1132032;1252162;1105967;1291264;;;;;;
370139,428;154870;9153;159744;1095481;1095984;1132032;1250351;1105137;1291776;;;;;;
370155,096;153537;8030;160256;1095984;1097080;1132032;1249521;1105110;1292288;;;;;;
370210,041;152926;10827;159744;1097080;1098212;1132032;1250006;1109039;1291776;;;;;;
370227,851;155723;6626;160256;1098212;1099331;1132032;1253935;1105957;1292288;;;;;;
370236,239;151522;5871;159744;1099331;1100834;1132032;1250853;1106705;1291776;;;;;;
370248,670;150767;4084;160768;1100834;1102210;1132032;1251601;1106294;1292800;;;;;;
370255,959;150516;3160;160768;1102210;1103347;1132032;1252726;1106507;1292800;;;;;;
370263,671;149592;2800;160768;1103347;1104161;1132032;1252939;1106961;1292800;;;;;;
370300,210;149232;6552;160768;1104161;1104465;1132032;1253393;1111017;1292800;;;;;;
370329,129;152984;2688;161280;1104465;1105894;1132032;1257449;1108582;1293312;;;;;;
370352,992;150144;832;161280;1105894;1107630;1132032;1256038;1108462;1293312;;;;;;
370391,615;148288;608;161280;1107630;1108014;1132032;1255918;1108622;1293312;;;;;;
370400,013;148064;2928;161280;1108014;1108270;1132032;1256078;1111198;1293312;;;;;;
370617,042;150384;4963;162304;1108270;1108872;1132032;1258654;1113835;1294336;;;;;;
370846,715;88609;1952;161792;1108872;1109676;1132032;1197481;1111628;1293824;;;;;;
370846,743;1952;0;161792;1109676;1066541;1132032;1111628;1066541;1293824;189277;186246;786432;1300905;1252787;2080256
371000,666;148992;4968;163328;1066541;1066542;1132032;1215533;1071510;1295360;;;;;;
371024,660;156008;959;162816;1066542;1068681;1132032;1222550;1069640;1294848;;;;;;
371098,936;151999;4329;164352;1068681;1068960;1132032;1220680;1073289;1296384;;;;;;
371120,871;156905;4648;163328;1068960;1068961;1132032;1225865;1073609;1295360;;;;;;
371144,204;157224;3359;164864;1068961;1068961;1132032;1226185;1072320;1296896;;;;;;
371326,237;157983;5364;164864;1068961;1068961;1132032;1226944;1074325;1296896;;;;;;
371377,558;159988;8922;162304;1068961;1068961;1132032;1228949;1077883;1294336;;;;;;
371440,179;161498;6755;163840;1068961;1068961;1132032;1230459;1075716;1295872;;;;;;
371488,646;159331;6143;163840;1068961;1068961;1132032;1228292;1075104;1295872;;;;;;
371723,350;158719;7955;160768;1068961;1068961;1132032;1227680;1076916;1292800;;;;;;
371743,923;160531;8109;163328;1068961;1068960;1132032;1229492;1077069;1295360;;;;;;
371754,132;159661;8049;159744;1068960;1068961;1132032;1228621;1077010;1291776;;;;;;
371788,664;159601;7439;162816;1068961;1069538;1132032;1228562;1076977;1294848;;;;;;
371818,442;157967;9106;159744;1069538;1070026;1132032;1227505;1079132;1291776;;;;;;
371856,823;159612;12782;158208;1070026;1070389;1132032;1229638;1083171;1290240;;;;;;
371879,385;158190;9992;160256;1070389;1071637;1132032;1228579;1081629;1292288;;;;;;
371899,087;155400;9526;160256;1071637;1072205;1132032;1227037;1081731;1292288;;;;;;
371908,676;154934;6079;160256;1072205;1073335;1132032;1227139;1079414;1292288;;;;;;
371929,834;151487;9480;159744;1073335;1074014;1132032;1224822;1083494;1291776;;;;;;
372139,432;154888;7578;160256;1074014;1074881;1132032;1228902;1082459;1292288;;;;;;
372240,327;152986;9252;161280;1074881;1076353;1132032;1227867;1085605;1293312;;;;;;
372254,609;156708;7298;161280;1076353;1076952;1132032;1233061;1084250;1293312;;;;;;
372263,972;154754;4427;161792;1076952;1078137;1132032;1231706;1082564;1293824;;;;;;
372277,385;152907;2960;151552;1078137;1079802;1132032;1231044;1082762;1283584;;;;;;
372295,427;151440;1477;161280;1079802;1081803;1132032;1231242;1083280;1293312;;;;;;
372307,396;148933;864;148480;1081803;1082122;1132032;1230736;1082986;1280512;;;;;;
372327,277;148320;1553;161280;1082122;1082371;1132032;1230442;1083924;1293312;;;;;;
372339,876;145880;11643;158720;1082370;1082907;1132032;1228250;1094550;1290752;;;;;;
372339,942;11643;0;158720;1082907;1075708;1132032;1094550;1075708;1290752;187936;186359;786432;1282486;1262067;2077184
372348,466;146944;6318;160256;1075708;1075709;1132032;1222652;1082027;1292288;;;;;;
372372,822;151214;4747;159744;1075709;1076646;1132032;1226923;1081393;1291776;;;;;;
372382,757;149643;4064;161280;1076646;1077547;1132032;1226289;1081611;1293312;;;;;;
372396,703;151008;2944;160768;1077547;1078163;1132032;1228555;1081107;1292800;;;;;;
372471,545;149888;3313;162304;1078163;1078669;1132032;1228051;1081982;1294336;;;;;;
372495,796;152305;4132;161792;1078669;1079221;1132032;1230974;1083353;1293824;;;;;;
372538,910;153124;3469;163328;1079221;1079885;1132032;1232345;1083354;1295360;;;;;;
372572,515;154509;5133;162816;1079885;1080424;1132032;1234394;1085557;1294848;;;;;;
372596,806;156173;640;163840;1080424;1082546;1132032;1236597;1083186;1295872;;;;;;
372602,491;153216;800;163840;1082546;1082819;1132032;1235762;1083619;1295872;;;;;;
372667,157;153376;4256;164352;1082819;1083059;1132032;1236195;1087315;1296384;;;;;;
372685,447;157344;5523;163840;1083059;1083741;1132032;1240403;1089264;1295872;;;;;;
372699,681;158611;1296;164352;1083741;1086370;1132032;1242352;1087666;1296384;;;;;;
372710,520;154896;3568;164352;1086370;1086850;1132032;1241266;1090418;1296384;;;;;;
372723,851;157168;1986;165376;1086850;1088977;1132032;1244018;1090963;1297408;;;;;;
372753,557;157122;8096;163328;1088977;1089345;1132032;1246099;1097441;1295360;;;;;;
372764,887;163232;2976;164864;1089345;1091611;1132032;1252577;1094587;1296896;;;;;;
372770,141;157088;3907;164352;1091611;1092284;1132032;1248699;1096191;1296384;;;;;;
372786,743;158019;3312;165888;1092284;1093075;1132032;1250303;1096387;1297920;;;;;;
372920,486;159472;1176;165376;1093075;1095246;1132032;1252547;1096422;1297408;;;;;;
372988,607;157336;845;165888;1095246;1095549;1132032;1252582;1096394;1297920;;;;;;
373069,454;157517;5273;165888;1095549;1095709;1132032;1253066;1100982;1297920;;;;;;
373090,427;161945;2832;165888;1095709;1096805;1132032;1257654;1099637;1297920;;;;;;
373163,671;159504;3492;165888;1096805;1097301;1132032;1256309;1100793;1297920;;;;;;
373199,328;160164;7909;164352;1097301;1097301;1132032;1257465;1105210;1296384;;;;;;
373216,486;163557;7232;163328;1097301;1097301;1132032;1260858;1104533;1295360;;;;;;
373231,006;162880;6449;163840;1097301;1097878;1132032;1260181;1104327;1295872;;;;;;
373253,800;160025;8879;162816;1098365;1099333;1132032;1258390;1108212;1294848;;;;;;
373270,453;162479;6284;163840;1099336;1099864;1132032;1261815;1106148;1295872;;;;;;
373284,436;158348;5006;163328;1099864;1101511;1132032;1258212;1106517;1295360;;;;;;
373297,750;157063;5801;164352;1101511;1102344;1132032;1258574;1108145;1296384;;;;;;
373309,241;159401;4453;164352;1102344;1103123;1132032;1261745;1107576;1296384;;;;;;
373325,838;158053;1732;164864;1103123;1105218;1132032;1261176;1106950;1296896;;;;;;
373343,177;156356;6523;164864;1105218;1105786;1132032;1261574;1112309;1296896;;;;;;
373359,931;161147;2752;164864;1105786;1106965;1132032;1266933;1109717;1296896;;;;;;
373391,963;157376;1520;164864;1106965;1108868;1132032;1264341;1110388;1296896;;;;;;
373411,657;156144;5553;164864;1108868;1109300;1132032;1265012;1114853;1296896;;;;;;
373432,211;160177;4147;164864;1109300;1110036;1132032;1269477;1114183;1296896;;;;;;
373441,999;158771;928;165376;1110036;1111834;1132032;1268807;1112762;1297408;;;;;;
373446,042;156576;3172;165376;1111834;1112387;1132032;1268410;1115559;1297408;;;;;;
373452,092;158820;904;165888;1112387;1114251;1132032;1271207;1115155;1297920;;;;;;
373459,111;157576;4256;165888;1114251;1114514;1132032;1271827;1118770;1297920;;;;;;
373473,271;160928;1453;166400;1114514;1116371;1132032;1275442;1117824;1298432;;;;;;
373490,226;158637;976;165888;1116371;1116770;1132032;1275008;1117746;1297920;;;;;;
373498,641;158160;3408;166912;1116770;1117107;1132032;1274930;1120515;1298944;;;;;;
373528,288;161616;3312;166400;1117107;1117716;1132032;1278723;1121028;1298432;;;;;;
373702,653;161520;7004;165376;1117716;1118052;1132032;1279236;1125056;1297408;;;;;;
373733,093;164700;4451;166400;1118052;1119228;1132032;1282752;1123679;1298432;;;;;;
373763,169;162147;1157;166400;1119228;1121076;1132032;1281375;1122233;1298432;;;;;;
373800,118;158853;3864;166400;1121076;1121455;1132032;1279929;1125319;1298432;;;;;;
373840,663;161474;2970;167424;1121454;1121919;1132032;1282928;1124889;1299456;;;;;;
373858,880;162202;7649;166912;1121919;1122658;1132032;1284121;1130307;1298944;;;;;;
373868,836;166881;5848;163840;1122658;1123810;1132032;1289539;1129658;1295872;;;;;;
373884,367;161496;2400;165376;1123810;1125689;1132032;1285306;1128089;1297408;;;;;;
373894,007;158048;640;165888;1125689;1126241;1132032;1283737;1126881;1297920;;;;;;
373910,140;157312;832;165888;1126241;1126457;1132032;1283553;1127289;1297920;;;;;;
373935,400;157504;736;165888;1126457;1126697;1132032;1283961;1127433;1297920;;;;;;
373967,513;157408;4275;165888;1126697;1127042;1132032;1284105;1131317;1297920;;;;;;
374033,683;160902;6247;164864;1127204;1127940;1132032;1288106;1134187;1296896;;;;;;
374061,650;161895;3762;165376;1127945;1129062;1132032;1289840;1132824;1297408;;;;;;
374069,123;159410;1089;165888;1129062;1130902;1132032;1288472;1131991;1297920;;;;;;
374069,257;1089;0;165888;1130902;1082009;1152000;1131991;1082009;1317888;189385;186139;786432;1321376;1268148;2104320
374077,407;156672;1511;165888;1082009;1082009;1152000;1238681;1083520;1317888;;;;;;
374104,721;158183;5809;165376;1082009;1083085;1152000;1240192;1088894;1317376;;;;;;
374114,969;162420;4901;165888;1083085;1083982;1152000;1245505;1088883;1317888;;;;;;
374151,529;161573;5677;165888;1083982;1084406;1152000;1245555;1090083;1317888;;;;;;
374160,696;162349;5649;162816;1084406;1085473;1152000;1246755;1091122;1314816;;;;;;
374169,195;162321;3668;165888;1085473;1086177;1152000;1247794;1089845;1317888;;;;;;
374176,660;159828;3584;165376;1086177;1086780;1152000;1246005;1090364;1317376;;;;;;
374184,206;159744;1024;166400;1086780;1088805;1152000;1246524;1089829;1318400;;;;;;
374189,110;158720;896;166400;1088805;1089109;1152000;1247525;1090005;1318400;;;;;;
374200,992;158592;5100;166400;1089109;1089326;1152000;1247701;1094426;1318400;;;;;;
374209,905;162796;448;166400;1089326;1091351;1152000;1252122;1091799;1318400;;;;;;
374235,150;158144;944;166400;1091351;1091591;1152000;1249495;1092535;1318400;;;;;;
374266,432;158640;4884;166400;1091591;1091848;1152000;1250231;1096732;1318400;;;;;;
374298,999;162580;1302;166400;1091848;1094071;1152000;1254428;1095373;1318400;;;;;;
374311,761;158998;704;166400;1094071;1094311;1152000;1253069;1095015;1318400;;;;;;
374508,830;158400;979;166912;1094311;1094552;1152000;1252711;1095531;1318912;;;;;;
374562,203;159187;6305;164864;1094552;1094929;1152000;1253739;1101234;1316864;;;;;;
374589,061;164513;2081;166400;1094929;1097145;1152000;1259442;1099226;1318400;;;;;;
374606,947;159265;4371;165888;1097145;1097986;1152000;1256410;1102357;1317888;;;;;;
374609,190;161555;3332;166912;1097986;1098881;1152000;1259541;1102213;1318912;;;;;;
374625,751;161540;7207;165888;1098881;1099153;1152000;1260421;1106360;1317888;;;;;;
374634,808;165415;2721;166400;1099153;1101447;1152000;1264568;1104168;1318400;;;;;;
374656,896;159905;1408;165888;1101447;1101823;1152000;1261352;1103231;1317888;;;;;;
374662,243;158592;3872;166912;1101823;1102088;1152000;1260415;1105960;1318912;;;;;;
374694,401;162080;3040;166400;1102088;1103401;1152000;1264168;1106441;1318400;;;;;;
374714,280;161248;5108;166400;1103401;1105162;1152000;1264649;1110270;1318400;;;;;;
374730,739;163828;4418;166912;1105162;1106184;1152000;1268990;1110602;1318912;;;;;;
374735,640;163138;896;166912;1106184;1107984;1152000;1269322;1108880;1318912;;;;;;
374780,596;159616;4989;166912;1107984;1108144;1152000;1267600;1113133;1318912;;;;;;
374786,634;163582;4750;166912;1108144;1109171;1152000;1271726;1113921;1318912;;;;;;
374818,252;163470;5113;166912;1109171;1109507;1152000;1272641;1114620;1318912;;;;;;
374823,280;163833;801;165888;1109507;1111969;1152000;1273340;1112770;1317888;;;;;;
374874,087;158497;3944;166400;1111969;1112146;1152000;1270466;1116090;1318400;;;;;;
374892,315;161436;4438;166912;1112146;1112866;1152000;1273582;1117304;1318912;;;;;;
374926,262;163154;4987;166912;1112866;1113289;1152000;1276020;1118276;1318912;;;;;;
374933,717;163707;608;166912;1113289;1115400;1152000;1276996;1116008;1318912;;;;;;
374938,429;159328;944;166912;1115400;1115640;1152000;1274728;1116584;1318912;;;;;;
374953,234;159664;3760;166912;1115640;1115880;1152000;1275304;1119640;1318912;;;;;;
374986,225;162480;5151;166912;1115880;1116875;1152000;1278360;1122026;1318912;;;;;;
375053,238;163871;4184;166912;1116875;1118489;1152000;1280746;1122673;1318912;;;;;;
375066,086;162904;963;166912;1118489;1120245;1152000;1281393;1121208;1318912;;;;;;
375091,924;159683;4404;166912;1120245;1120421;1152000;1279928;1124825;1318912;;;;;;
375128,608;163124;4068;166912;1120421;1121108;1152000;1283545;1125176;1318912;;;;;;
375194,692;162788;992;167424;1121108;1123056;1152000;1283896;1124048;1319424;;;;;;
375283,521;160736;7651;167424;1123056;1124774;1152000;1283792;1132425;1319424;;;;;;
375309,777;167146;5239;163328;1124773;1126567;1152000;1291919;1131806;1315328;;;;;;
375320,920;160887;6840;162816;1126567;1126567;1152000;1287454;1133407;1314816;;;;;;
375332,302;162488;3746;165376;1126567;1126567;1152000;1289055;1130313;1317376;;;;;;
375352,662;158820;6847;164864;1126567;1126943;1152000;1285387;1133790;1316864;;;;;;
375375,230;161983;3926;165376;1126943;1127782;1152000;1288926;1131708;1317376;;;;;;
375426,484;159062;4304;164864;1127782;1128198;1152000;1286844;1132502;1316864;;;;;;
375446,008;159440;4452;166400;1128198;1128198;1152000;1287638;1132650;1318400;;;;;;
375473,013;161636;8702;165888;1128198;1130621;1152000;1289834;1139323;1317888;;;;;;
375537,083;165886;9210;161280;1130621;1131706;1152000;1296507;1140916;1313280;;;;;;
375556,122;161274;9726;161792;1131706;1131706;1152000;1292980;1141432;1313792;;;;;;
375565,430;161690;8718;161280;1131705;1131706;1152000;1293395;1140424;1313280;;;;;;
375575,625;157198;6228;161792;1131706;1132330;1152000;1288904;1138558;1313792;;;;;;
375583,299;154708;5955;163328;1132330;1134628;1152000;1287038;1140583;1315328;;;;;;
375593,751;156995;6206;162816;1134628;1135603;1152000;1291623;1141809;1314816;;;;;;
375604,090;157246;5510;163840;1135603;1136419;1152000;1292849;1141929;1315840;;;;;;
375755,457;158086;5046;163840;1136419;1137715;1152000;1294505;1142761;1315840;;;;;;
375807,842;157622;4400;164352;1137715;1138443;1152000;1295337;1142843;1316352;;;;;;
375819,958;158000;2700;164352;1138443;1139219;1152000;1296443;1141919;1316352;;;;;;
375855,742;156300;5669;164864;1139219;1139435;1152000;1295519;1145104;1316864;;;;;;
376190,378;159781;6110;164352;1139435;1140679;1152000;1299216;1146789;1316352;;;;;;
376309,025;160222;5779;165376;1140679;1140679;1152000;1300901;1146458;1317376;;;;;;
376333,065;160915;4191;164864;1140679;1140679;1152000;1301594;1144870;1316864;;;;;;
376351,341;159327;4847;165888;1140679;1140679;1152000;1300006;1145526;1317888;;;;;;
376379,235;161007;6018;165376;1140679;1140679;1152000;1301686;1146697;1317376;;;;;;
376400,036;162178;8521;164864;1140679;1140679;1152000;1302857;1149200;1316864;;;;;;
376423,526;164169;9723;165376;1140679;1141766;1152000;1304848;1151489;1317376;;;;;;
376439,484;165371;6197;163328;1141766;1143790;1152000;1307137;1149987;1315328;;;;;;
376444,996;159797;6382;164352;1143790;1143982;1152000;1303587;1150364;1316352;;;;;;
376453,763;159982;4878;164864;1143982;1144763;1152000;1303964;1149641;1316864;;;;;;
376457,262;158990;4335;164352;1144763;1146139;1152000;1303753;1150474;1316352;;;;;;
376466,067;158447;3621;164864;1146139;1147034;1152000;1304586;1150655;1316864;;;;;;
376480,221;158245;992;155648;1147034;1149004;1152000;1305279;1149996;1307648;;;;;;
376497,636;155616;5951;164864;1149004;1149364;1152000;1304620;1155315;1316864;;;;;;
376506,254;160063;7265;164352;1149364;1150126;1152000;1309427;1157391;1316352;;;;;;
376506,276;7265;0;164352;1150126;1092360;1161728;1157391;1092360;1326080;189338;186555;786432;1346729;1278915;2112512
376530,811;154112;4148;164864;1092360;1092361;1161728;1246472;1096509;1326592;;;;;;
376546,614;158169;6938;164352;1092361;1093169;1161728;1250530;1100107;1326080;;;;;;
376557,390;161050;5408;164864;1093169;1095661;1161728;1254219;1101069;1326592;;;;;;
376563,302;160032;2067;164864;1095661;1097434;1161728;1255693;1099501;1326592;;;;;;
376603,195;156691;4723;165376;1097434;1097610;1161728;1254125;1102333;1327104;;;;;;
376653,304;159859;4130;164864;1097610;1098481;1161728;1257469;1102611;1326592;;;;;;
376672,176;159266;4996;165888;1098481;1099253;1161728;1257747;1104249;1327616;;;;;;
376677,625;161156;4671;165376;1099253;1100234;1161728;1260409;1104905;1327104;;;;;;
376708,790;160831;1088;165376;1100234;1102777;1161728;1261065;1103865;1327104;;;;;;
376714,400;157760;1271;165888;1102777;1103281;1161728;1260537;1104552;1327616;;;;;;
376801,303;157943;5768;165888;1103281;1103554;1161728;1261224;1109322;1327616;;;;;;
376885,579;162440;3824;165888;1103554;1104891;1161728;1265994;1108715;1327616;;;;;;
376926,676;160496;928;165376;1104891;1107067;1161728;1265387;1107995;1327104;;;;;;
376961,809;157600;5009;165888;1107067;1107547;1161728;1264667;1112556;1327616;;;;;;
376991,372;161681;7958;164864;1107547;1107547;1161728;1269228;1115505;1326592;;;;;;
377025,649;163606;6184;162304;1107547;1107548;1161728;1271153;1113732;1324032;;;;;;
377031,646;161832;7149;164864;1107548;1107548;1161728;1269380;1114697;1326592;;;;;;
377038,342;161773;3135;164864;1107548;1109165;1161728;1269321;1112300;1326592;;;;;;
377048,158;157759;1408;164864;1109165;1111548;1161728;1266924;1112956;1326592;;;;;;
377067,597;156032;4175;164864;1111548;1112285;1161728;1267580;1116460;1326592;;;;;;
377085,202;158799;5847;165376;1112285;1112764;1161728;1271084;1118611;1327104;;;;;;
377102,135;161495;794;165376;1112764;1114829;1161728;1274259;1115623;1327104;;;;;;
377124,559;156442;1125;165376;1114829;1114997;1161728;1271271;1116122;1327104;;;;;;
377144,007;156773;6700;162816;1114997;1115441;1161728;1271770;1122141;1324544;;;;;;
377173,122;162348;928;164864;1115441;1117583;1161728;1277789;1118511;1326592;;;;;;
377201,225;155552;576;164864;1117583;1117975;1161728;1273135;1118551;1326592;;;;;;
377225,928;155200;6012;163840;1117975;1118248;1161728;1273175;1124260;1325568;;;;;;
377292,230;159612;4284;164352;1118248;1119207;1161728;1277860;1123491;1326080;;;;;;
377313,152;157884;4724;165376;1119207;1119743;1161728;1277091;1124467;1327104;;;;;;
377322,428;159860;6665;164864;1119743;1120551;1161728;1279603;1127216;1326592;;;;;;
377335,184;161801;1712;164864;1120551;1122895;1161728;1282352;1124607;1326592;;;;;;
377350,311;156274;5208;164864;1122894;1123423;1161728;1279168;1128631;1326592;;;;;;
377363,393;159832;5490;165376;1123423;1124214;1161728;1283255;1129704;1327104;;;;;;
377369,241;160626;2688;164864;1124214;1125053;1161728;1284840;1127741;1326592;;;;;;
377401,248;157824;1040;165376;1125053;1127295;1161728;1282877;1128335;1327104;;;;;;
377419,020;156688;4519;165376;1127295;1127675;1161728;1283983;1132194;1327104;;;;;;
377438,340;160167;5443;165888;1127675;1128027;1161728;1287842;1133470;1327616;;;;;;
377457,241;162115;4565;165888;1128027;1129149;1161728;1290142;1133714;1327616;;;;;;
377483,507;161237;1253;165888;1129149;1131254;1161728;1290386;1132507;1327616;;;;;;
377492,476;157925;1724;165888;1131254;1131694;1161728;1289179;1133418;1327616;;;;;;
377502,353;158396;5472;165376;1131694;1132070;1161728;1290090;1137542;1327104;;;;;;
377514,975;162144;864;165888;1132070;1134395;1161728;1294214;1135259;1327616;;;;;;
377551,918;157536;5061;165888;1134395;1134555;1161728;1291931;1139616;1327616;;;;;;
377575,716;161733;4612;165888;1134555;1135261;1161728;1296288;1139873;1327616;;;;;;
377597,216;161284;4101;166400;1135261;1136228;1161728;1296545;1140329;1328128;;;;;;
377617,701;161285;2083;165888;1136228;1138180;1161728;1297513;1140263;1327616;;;;;;
377632,132;159267;6560;165376;1138180;1138911;1161728;1297447;1145471;1327104;;;;;;
377655,365;163232;992;165888;1138911;1141054;1161728;1302143;1142046;1327616;;;;;;
377677,702;157664;3154;166400;1141054;1141503;1161728;1298718;1144657;1328128;;;;;;
377711,326;160338;3417;165888;1141503;1141783;1161728;1301841;1145200;1327616;;;;;;
377729,227;160601;8185;163840;1141783;1142900;1161728;1302384;1151085;1325568;;;;;;
377743,306;163833;1312;165376;1142900;1145405;1161728;1306733;1146717;1327104;;;;;;
377754,671;156960;864;165376;1145405;1145844;1161728;1302365;1146708;1327104;;;;;;
377769,866;156351;5550;165376;1145844;1146245;1161728;1302195;1151795;1327104;;;;;;
377784,504;161198;4050;165888;1146245;1147060;1161728;1307443;1151110;1327616;;;;;;
377786,782;160210;3392;165376;1147060;1147918;1161728;1307270;1151310;1327104;;;;;;
377794,746;159552;3968;166400;1147918;1148638;1161728;1307470;1152606;1328128;;;;;;
377820,090;161664;5149;166400;1148638;1149198;1161728;1310302;1154347;1328128;;;;;;
377833,823;162845;1472;166400;1149198;1151390;1161728;1312043;1152862;1328128;;;;;;
377838,422;159168;3704;166400;1151390;1151894;1161728;1310558;1155598;1328128;;;;;;
377845,235;161391;2656;167424;1151894;1153647;1161728;1313285;1156303;1329152;;;;;;
377850,568;161814;5702;166912;1153646;1154553;1161728;1315460;1160255;1328640;;;;;;
377859,790;164934;7560;164864;1154553;1155137;1161728;1319487;1162697;1326592;;;;;;
377870,906;164232;4613;165888;1155137;1156384;1161728;1319369;1160997;1327616;;;;;;
377882,996;161285;1216;165376;1156384;1158692;1161728;1317669;1159908;1327104;;;;;;
377888,813;157888;4576;165888;1158692;1158956;1161728;1316580;1163532;1327616;;;;;;
377888,838;4576;0;165888;1158956;1104219;1173504;1163532;1104219;1339392;189067;186272;786432;1352599;1290491;2125824
377906,764;156672;6660;165376;1104219;1104220;1173504;1260891;1110880;1338880;;;;;;
377917,422;163326;1296;165888;1104219;1107587;1173504;1267545;1108883;1339392;;;;;;
377927,272;157968;6872;164864;1107587;1107883;1173504;1265555;1114755;1338368;;;;;;
377936,902;162520;2336;165376;1107883;1110945;1173504;1270403;1113281;1338880;;;;;;
377953,673;157984;2275;165888;1110945;1112322;1173504;1268929;1114597;1339392;;;;;;
377962,105;158435;1184;165376;1112322;1113229;1173504;1270757;1114413;1338880;;;;;;
377971,127;157344;1057;165888;1113229;1113542;1173504;1270573;1114599;1339392;;;;;;
377989,586;157729;5759;162816;1113542;1113877;1173504;1271271;1119636;1336320;;;;;;
378060,253;162431;543;165376;1113877;1116201;1173504;1276308;1116744;1338880;;;;;;
378104,883;156191;7264;163328;1116201;1116457;1173504;1272392;1123721;1336832;;;;;;
378136,831;162912;8590;161792;1116457;1116457;1173504;1279369;1125047;1335296;;;;;;
378141,869;160142;10475;162304;1116457;1116457;1173504;1276599;1126932;1335808;;;;;;
378184,432;162025;9242;160256;1116457;1118236;1173504;1278482;1127478;1333760;;;;;;
378231,060;156698;5411;161280;1118236;1120483;1173504;1274934;1125894;1334784;;;;;;
378309,961;152867;7142;161792;1120483;1121326;1173504;1273350;1128468;1335296;;;;;;
378321,078;155622;4911;161792;1121326;1121327;1173504;1276948;1126238;1335296;;;;;;
378327,348;153391;5617;163328;1121327;1122174;1173504;1274718;1127791;1336832;;;;;;
378332,941;156655;1152;162816;1122175;1125097;1173504;1278830;1126249;1336320;;;;;;
378342,280;152192;4769;163840;1125097;1125425;1173504;1277289;1130194;1337344;;;;;;
378352,975;156833;1872;163328;1125425;1127825;1173504;1282258;1129697;1336832;;;;;;
378359,130;153936;4068;164352;1127825;1129505;1173504;1281761;1133573;1337856;;;;;;
378383,636;157156;880;163840;1129505;1131209;1173504;1286661;1132089;1337344;;;;;;
378465,882;153968;5024;164864;1131209;1131737;1173504;1285177;1136761;1338368;;;;;;
378484,933;159136;5189;164352;1131737;1132562;1173504;1290873;1137751;1337856;;;;;;
378497,177;159301;5482;164864;1132562;1133155;1173504;1291863;1138637;1338368;;;;;;
378507,881;160106;672;164864;1133155;1135317;1173504;1293261;1135989;1338368;;;;;;
378517,059;155296;1296;164864;1135317;1135549;1173504;1290613;1136845;1338368;;;;;;
378526,566;155920;896;164864;1135549;1136117;1173504;1291469;1137013;1338368;;;;;;
378534,575;155520;3616;165888;1136117;1136485;1173504;1291637;1140101;1339392;;;;;;
378580,307;159776;5071;165376;1136485;1137026;1173504;1296261;1142097;1338880;;;;;;
378646,009;161231;6491;164864;1137026;1137787;1173504;1298257;1144278;1338368;;;;;;
378675,338;162139;976;165376;1137787;1139891;1173504;1299926;1140867;1338880;;;;;;
378681,662;156624;992;165376;1139891;1140387;1173504;1296515;1141379;1338880;;;;;;
378694,781;156640;1407;165376;1140387;1140579;1173504;1297027;1141986;1338880;;;;;;
378707,452;157055;2435;165888;1140579;1141043;1173504;1297634;1143478;1339392;;;;;;
378721,939;159107;5143;165888;1141043;1141603;1173504;1300150;1146746;1339392;;;;;;
378728,720;161815;4240;166400;1141603;1142499;1173504;1303418;1146739;1339904;;;;;;
378752,044;161424;1248;165888;1142499;1144250;1173504;1303923;1145498;1339392;;;;;;
378776,444;158432;1024;166400;1144250;1144658;1173504;1302682;1145682;1339904;;;;;;
378813,429;158720;6893;164864;1144658;1145043;1173504;1303378;1151936;1338368;;;;;;
378869,494;164589;4562;165888;1145043;1145043;1173504;1309632;1149605;1339392;;;;;;
378895,508;160722;5605;165376;1145043;1145042;1173504;1305765;1150647;1338880;;;;;;
378922,881;161765;3684;165888;1145042;1145043;1173504;1306807;1148727;1339392;;;;;;
378939,398;159844;6984;165376;1145043;1145042;1173504;1304887;1152026;1338880;;;;;;
378965,612;163144;5460;165376;1145042;1145043;1173504;1308186;1150503;1338880;;;;;;
379010,147;161108;7565;163328;1145043;1145042;1173504;1306151;1152607;1336832;;;;;;
379140,356;163213;10215;160768;1145042;1147218;1173504;1308255;1157433;1334272;;;;;;
379144,693;160743;6862;157696;1147218;1148344;1173504;1307961;1155206;1331200;;;;;;
379156,388;157390;8371;162304;1148344;1149040;1173504;1305734;1157411;1335808;;;;;;
379175,016;157875;5246;162304;1149040;1150168;1173504;1306915;1155414;1335808;;;;;;
379186,234;154750;5551;163328;1150168;1152221;1173504;1304918;1157772;1336832;;;;;;
379205,452;156591;11767;157696;1152221;1158638;1173504;1308812;1170405;1331200;;;;;;
379244,606;157687;6419;157696;1158638;1159408;1173504;1316325;1165827;1331200;;;;;;
379277,610;151827;4613;160256;1159408;1160803;1173504;1311235;1165416;1333760;;;;;;
379295,961;150021;1216;160256;1160803;1162722;1173504;1310824;1163938;1333760;;;;;;
379301,301;146624;896;160256;1162722;1162938;1173504;1309346;1163834;1333760;;;;;;
379323,306;146304;7203;160768;1162938;1163250;1173504;1309242;1170453;1334272;;;;;;
379375,795;153123;2944;160256;1163250;1163939;1173504;1316373;1166883;1333760;;;;;;
379438,483;148864;7466;161280;1163939;1164458;1173504;1312803;1171924;1334784;;;;;;
379483,003;154410;3421;160768;1164458;1164459;1173504;1318868;1167880;1334272;;;;;;
379556,611;150365;6957;161792;1164459;1164459;1173504;1314824;1171416;1335296;;;;;;
379584,113;154925;6199;161280;1164459;1164459;1173504;1319384;1170658;1334784;;;;;;
379617,297;154167;4192;162816;1164459;1164458;1173504;1318626;1168650;1336320;;;;;;
379643,647;154208;4337;162304;1164458;1164459;1173504;1318666;1168796;1335808;;;;;;
379702,138;154353;8529;162304;1164459;1164459;1173504;1318812;1172988;1335808;;;;;;
379724,318;159057;7438;162816;1164459;1164459;1173504;1323516;1171897;1336320;;;;;;
379768,049;157966;11306;159744;1164459;1164458;1173504;1322425;1175764;1333248;;;;;;
379816,183;158762;6308;161280;1164458;1164459;1173504;1323220;1170767;1334784;;;;;;
379859,938;153764;6623;162304;1164459;1164459;1173504;1318223;1171082;1335808;;;;;;
379997,246;155615;9180;161792;1164459;1164458;1173504;1320074;1173638;1335296;;;;;;
380018,394;158122;9154;161280;1164458;1164459;1173504;1322580;1173613;1334784;;;;;;
380045,787;157634;13291;161792;1164459;1164827;1173504;1322093;1178118;1335296;;;;;;
380146,465;161771;10981;156672;1164827;1165505;1173504;1326598;1176486;1330176;;;;;;
380167,368;154341;12167;155648;1165505;1165505;1173504;1319846;1177672;1329152;;;;;;
380176,595;155527;12455;156672;1165505;1165505;1173504;1321032;1177960;1330176;;;;;;
380190,843;152743;10562;157696;1165505;1165945;1173504;1318248;1176507;1331200;;;;;;
380227,769;150850;10031;158208;1165945;1166417;1173504;1316795;1176448;1331712;;;;;;
380245,458;151343;12085;158208;1166417;1166713;1173504;1317760;1178798;1331712;;;;;;
380295,262;153397;10583;158208;1166713;1166977;1173504;1320110;1177560;1331712;;;;;;
380463,403;151895;12915;154624;1166977;1167626;1173504;1318872;1180541;1328128;;;;;;
380569,065;154227;12343;157696;1167626;1168123;1173504;1321853;1180466;1331200;;;;;;
380605,615;152631;9409;157696;1168123;1168872;1173504;1320754;1178281;1331200;;;;;;
380640,408;149697;12346;158208;1168872;1169144;1173504;1318569;1181490;1331712;;;;;;
380685,417;153658;9633;158208;1169144;1169360;1173504;1322802;1178993;1331712;;;;;;
380730,964;150473;10194;159232;1169360;1169879;1173504;1319833;1180073;1332736;;;;;;
380785,328;153042;10451;158720;1169879;1170543;1173504;1322921;1180994;1332224;;;;;;
380807,602;153299;11258;159744;1170543;1171711;1173504;1323842;1182969;1333248;;;;;;
380814,664;155642;10410;159744;1171711;1172855;1173504;1327353;1183265;1333248;;;;;;
380814,752;10410;0;159744;1172855;1104709;1171456;1183265;1104709;1331200;190471;186143;786432;1373736;1290852;2117632
380821,261;144384;3275;158208;1104709;1104709;1171456;1249093;1107984;1329664;;;;;;
380832,507;146635;3630;147456;1104709;1104709;1171456;1251344;1108339;1318912;;;;;;
380851,744;146990;8382;159744;1104709;1104710;1171456;1251699;1113092;1331200;;;;;;
380862,880;151742;5642;158720;1104710;1104709;1171456;1256452;1110351;1330176;;;;;;
380885,777;149002;6634;159744;1104709;1104709;1171456;1253711;1111343;1331200;;;;;;
380907,806;151018;7130;159744;1104709;1104709;1171456;1255727;1111839;1331200;;;;;;
380988,917;151514;7961;160768;1104709;1104710;1171456;1256223;1112671;1332224;;;;;;
381001,980;153881;8270;160256;1104710;1104709;1171456;1258591;1112979;1331712;;;;;;
381016,359;154190;10941;160256;1104709;1104709;1171456;1258899;1115650;1331712;;;;;;
381038,032;157373;11752;158208;1104709;1104709;1171456;1262082;1116461;1329664;;;;;;
381103,738;158184;10848;160256;1104709;1104710;1171456;1262893;1115558;1331712;;;;;;
381119,454;156256;10716;160256;1104710;1104709;1171456;1260966;1115425;1331712;;;;;;
381156,722;156124;11758;159232;1104709;1104709;1171456;1260833;1116467;1330688;;;;;;
381228,925;155998;10398;159744;1104709;1104709;1171456;1260707;1115107;1331200;;;;;;
381469,330;154782;13175;158720;1104709;1104709;1171456;1259491;1117884;1330176;;;;;;
381488,354;156535;10159;159232;1104709;1107333;1171456;1261244;1117492;1330688;;;;;;
381545,182;153519;8577;159744;1107333;1107429;1171456;1260852;1116006;1331200;;;;;;
381599,175;152961;7648;159744;1107429;1108363;1171456;1260390;1116011;1331200;;;;;;
381660,593;152032;10615;160256;1108363;1108492;1171456;1260395;1119107;1331712;;;;;;
381675,344;156023;7825;160256;1108492;1109028;1171456;1264515;1116853;1331712;;;;;;
381689,657;153233;7791;160768;1109028;1109317;1171456;1262261;1117108;1332224;;;;;;
381721,838;153711;10131;160256;1109317;1109892;1171456;1263028;1120023;1331712;;;;;;
381742,337;156051;10332;160768;1109892;1110091;1171456;1265943;1120423;1332224;;;;;;
381818,416;156750;7967;160768;1110091;1110476;1171456;1266841;1118443;1332224;;;;;;
382014,169;154399;11806;160256;1110476;1110899;1171456;1264875;1122705;1331712;;;;;;
382044,482;158238;13858;160768;1110899;1111227;1171456;1269137;1125085;1332224;;;;;;
382063,534;160290;9178;158720;1111227;1111243;1171456;1271517;1120421;1330176;;;;;;
382127,345;153562;10432;159744;1111243;1111579;1171456;1264805;1122011;1331200;;;;;;
382145,257;154816;9773;160768;1111579;1111867;1171456;1266395;1121640;1332224;;;;;;
382152,867;155693;9043;160256;1111867;1112355;1171456;1267560;1121398;1331712;;;;;;
382207,533;154963;9810;161280;1112355;1112819;1171456;1267318;1122629;1332736;;;;;;
382256,290;156754;12608;160768;1112819;1113163;1171456;1269573;1125771;1332224;;;;;;
382266,475;159552;8657;160768;1113163;1113483;1171456;1272715;1122140;1332224;;;;;;
382304,015;155089;9507;160768;1113483;1114307;1171456;1268572;1123814;1332224;;;;;;
382309,207;155939;7999;161280;1114307;1114763;1171456;1270246;1122762;1332736;;;;;;
382345,936;155455;7160;161280;1114763;1115540;1171456;1270218;1122700;1332736;;;;;;
382356,073;154616;6495;161280;1115540;1116226;1171456;1270156;1122721;1332736;;;;;;
382387,120;153951;5474;153088;1116226;1117603;1171456;1270177;1123077;1324544;;;;;;
382502,606;152930;8136;161280;1117603;1118179;1171456;1270533;1126315;1332736;;;;;;
382523,790;155080;8384;160768;1118179;1118491;1171456;1273259;1126875;1332224;;;;;;
382547,158;155328;6607;161792;1118491;1118644;1171456;1273819;1125251;1333248;;;;;;
382550,780;155087;6165;161792;1118644;1118811;1171456;1273731;1124976;1333248;;;;;;
382563,086;154645;5055;161792;1118811;1119712;1171456;1273456;1124767;1333248;;;;;;
382573,650;153535;4783;161792;1119712;1120384;1171456;1273247;1125167;1333248;;;;;;
382600,558;153263;7567;162304;1120384;1120761;1171456;1273647;1128328;1333760;;;;;;
382623,892;156559;5568;161792;1120761;1121455;1171456;1277320;1127023;1333248;;;;;;
382648,089;154560;4432;162304;1121455;1122103;1171456;1276015;1126535;1333760;;;;;;
382668,745;153936;4464;162304;1122103;1122367;1171456;1276039;1126831;1333760;;;;;;
382700,758;153968;6723;162816;1122367;1122624;1171456;1276335;1129347;1334272;;;;;;
382720,369;156739;5200;162304;1122624;1122624;1171456;1279363;1127824;1333760;;;;;;
382746,265;155216;5279;163328;1122624;1122624;1171456;1277840;1127903;1334784;;;;;;
382810,735;156831;9141;160768;1122624;1122624;1171456;1279455;1131765;1332224;;;;;;
382830,058;160693;8355;162816;1122624;1122623;1171456;1283317;1130978;1334272;;;;;;
382854,052;158883;7409;162816;1122623;1122623;1171456;1281506;1130032;1334272;;;;;;
382863,523;157937;7199;163840;1122623;1122624;1171456;1280560;1129823;1335296;;;;;;
382889,141;159263;10163;162304;1122624;1123016;1171456;1281887;1133179;1333760;;;;;;
382905,596;162227;10326;161792;1123016;1123016;1171456;1285243;1133342;1333248;;;;;;
382993,172;159830;9312;162304;1123016;1123680;1171456;1282846;1132992;1333760;;;;;;
383050,092;158816;10090;161280;1123680;1123680;1171456;1282496;1133770;1332736;;;;;;
383094,552;158570;11303;160256;1123680;1123679;1171456;1282250;1134982;1331712;;;;;;
383120,349;159783;11517;159232;1123679;1124096;1171456;1283462;1135613;1330688;;;;;;
383131,776;156925;8929;160256;1124096;1124536;1171456;1281021;1133465;1331712;;;;;;
383153,639;154337;10261;160768;1124536;1124696;1171456;1278873;1134957;1332224;;;;;;
383168,167;156693;8817;160768;1124696;1125152;1171456;1281389;1133969;1332224;;;;;;
383170,331;155249;9024;161792;1125152;1125688;1171456;1280401;1134712;1333248;;;;;;
383302,393;156992;7734;161280;1125688;1127223;1171456;1282680;1134957;1332736;;;;;;
383361,071;155702;11080;161792;1127223;1127600;1171456;1282925;1138680;1333248;;;;;;
383369,764;159560;7801;161792;1127600;1128754;1171456;1287160;1136555;1333248;;;;;;
383383,823;156281;9144;162304;1128754;1129777;1171456;1285035;1138921;1333760;;;;;;
383389,653;158136;5794;161792;1129777;1131001;1171456;1287913;1136795;1333248;;;;;;
383396,286;154786;5814;161792;1131001;1131513;1171456;1285787;1137327;1333248;;;;;;
383404,901;154294;9354;161792;1131513;1131985;1171456;1285807;1141339;1333248;;;;;;
383409,752;157834;5463;161792;1131985;1133121;1171456;1289819;1138584;1333248;;;;;;
383424,742;153943;5565;161792;1133121;1133865;1171456;1287064;1139430;1333248;;;;;;
383446,811;154045;6962;162304;1133865;1134168;1171456;1287910;1141130;1333760;;;;;;
383484,906;155954;4607;161792;1134168;1135528;1171456;1290122;1140135;1333248;;;;;;
383502,454;153599;3618;162304;1135528;1136501;1171456;1289127;1140119;1333760;;;;;;
383558,333;153122;1121;151040;1136501;1138725;1171456;1289623;1139846;1322496;;;;;;
383609,663;150625;4115;161792;1138725;1138869;1171456;1289350;1142984;1333248;;;;;;
383627,354;152595;4158;161792;1138869;1139357;1171456;1291464;1143515;1333248;;;;;;
383669,858;152638;800;161280;1139357;1141770;1171456;1291995;1142570;1332736;;;;;;
383788,267;149280;5615;161792;1141770;1141930;1171456;1291050;1147545;1333248;;;;;;
383862,838;154095;4008;163328;1141930;1141931;1171456;1296025;1145939;1334784;;;;;;
383931,605;155048;3871;162816;1141930;1141930;1171456;1296978;1145801;1334272;;;;;;
383970,292;13134;8488;162304;1141930;1141930;1171456;1155064;1150418;1333760;;;;;;
383970,315;8488;0;162304;1141930;1113076;1171456;1150418;1113076;1333760;187826;186151;786432;1338244;1299227;2120192
384006,958;150528;4380;162816;1113076;1113077;1171456;1263604;1117457;1334272;;;;;;
384031,078;154908;3182;163328;1113077;1113077;1171456;1267985;1116259;1334784;;;;;;
384097,878;154734;6618;163328;1113077;1113077;1171456;1267811;1119695;1334784;;;;;;
384217,449;158170;6637;163840;1113077;1113077;1171456;1271247;1119714;1335296;;;;;;
384242,235;159213;4754;163840;1113077;1113076;1171456;1272290;1117830;1335296;;;;;;
384249,778;157330;8593;162304;1113076;1113076;1171456;1270406;1121669;1333760;;;;;;
384272,628;160145;9248;161280;1113076;1113077;1171456;1273221;1122325;1332736;;;;;;
384301,902;160800;8291;162816;1113077;1113077;1171456;1273877;1121368;1334272;;;;;;
384313,649;158819;8499;159232;1113077;1113077;1171456;1271896;1121576;1330688;;;;;;
384372,550;159027;6975;162816;1113077;1113076;1171456;1272104;1120051;1334272;;;;;;
384429,609;156991;10557;160768;1113076;1113077;1171456;1270067;1123634;1332224;;;;;;
384518,312;160535;10693;160768;1113077;1113076;1171456;1273612;1123769;1332224;;;;;;
384540,246;158149;10352;158208;1113239;1113239;1171456;1271388;1123591;1329664;;;;;;
384562,893;157808;12625;157696;1113243;1113243;1171456;1271051;1125868;1329152;;;;;;
384582,541;155985;9728;159232;1113243;1113242;1171456;1269228;1122970;1330688;;;;;;
384613,658;153088;11029;158720;1113242;1113929;1171456;1266330;1124958;1330176;;;;;;
384621,386;154389;9217;159232;1113929;1114273;1171456;1268318;1123490;1330688;;;;;;
384647,664;152577;8577;160256;1114273;1115162;1171456;1266850;1123739;1331712;;;;;;
384666,448;153473;8562;159744;1115162;1115521;1171456;1268635;1124083;1331200;;;;;;
384714,743;153458;8063;161280;1115521;1116387;1171456;1268979;1124450;1332736;;;;;;
384946,842;154649;10683;160768;1116387;1116388;1171456;1271036;1127071;1332224;;;;;;
384988,639;157627;9715;161280;1116388;1116919;1171456;1274015;1126634;1332736;;;;;;
385360,279;157171;10745;158208;1116919;1117358;1171456;1274090;1128103;1329664;;;;;;
385418,316;158188;8472;161280;1117359;1117863;1171456;1275547;1126335;1332736;;;;;;
385478,749;155416;10859;160768;1117863;1118239;1171456;1273279;1129098;1332224;;;;;;
385510,633;157803;10576;161280;1118239;1118967;1171456;1276042;1129543;1332736;;;;;;
385581,035;158032;10206;161280;1118967;1119463;1171456;1276999;1129669;1332736;;;;;;
385692,083;157662;8633;161280;1119463;1119919;1171456;1277125;1128552;1332736;;;;;;
385725,202;156089;9269;161280;1119919;1120327;1171456;1276008;1129596;1332736;;;;;;
385765,484;156725;10791;161792;1120327;1120487;1171456;1277052;1131278;1333248;;;;;;
385846,521;159271;8175;161792;1120487;1120991;1171456;1279758;1129166;1333248;;;;;;
385880,819;156655;10547;161792;1120991;1121198;1171456;1277646;1131745;1333248;;;;;;
386034,668;159027;11664;160256;1121198;1121391;1171456;1280225;1133055;1331712;;;;;;
386098,977;160144;12003;160256;1121391;1121551;1171456;1281535;1133554;1331712;;;;;;
386147,767;158215;11206;160768;1121551;1122041;1171456;1279766;1133247;1332224;;;;;;
386277,751;157638;11027;160768;1122041;1122373;1171456;1279679;1133400;1332224;;;;;;
386302,879;157459;11957;160768;1122373;1122829;1171456;1279832;1134786;1332224;;;;;;
386463,927;158389;9792;160768;1122829;1123365;1171456;1281218;1133157;1332224;;;;;;
386507,180;156033;10915;160768;1123364;1123820;1171456;1279397;1134735;1332224;;;;;;
386563,024;157347;13565;159744;1123820;1124140;1171456;1281167;1137705;1331200;;;;;;
386577,135;158973;10312;160256;1124140;1124792;1171456;1283113;1135104;1331712;;;;;;
386610,888;155720;11381;160768;1124792;1125336;1171456;1280512;1136717;1332224;;;;;;
386661,976;157301;9648;160256;1125336;1125625;1171456;1282637;1135273;1331712;;;;;;
386683,099;155568;9806;160768;1125625;1126357;1171456;1281193;1136163;1332224;;;;;;
386755,927;156238;13122;159744;1126357;1127036;1171456;1282595;1140158;1331200;;;;;;
386798,752;159554;9294;160256;1127036;1127197;1171456;1286590;1136491;1331712;;;;;;
386831,653;154702;9473;160256;1127197;1127524;1171456;1281899;1136997;1331712;;;;;;
386921,733;154881;11555;160768;1127524;1128044;1171456;1282405;1139599;1332224;;;;;;
386978,373;157987;11300;160768;1128044;1128620;1171456;1286031;1139920;1332224;;;;;;
387004,871;157732;10467;161280;1128620;1128892;1171456;1286352;1139359;1332736;;;;;;
387042,030;157411;8592;160768;1128892;1129549;1171456;1286303;1138141;1332224;;;;;;
387088,704;155536;8239;160768;1129549;1130483;1171456;1285085;1138722;1332224;;;;;;
387429,162;154671;9652;160768;1130483;1130772;1171456;1285154;1140424;1332224;;;;;;
387460,862;156084;10195;161792;1130772;1131284;1171456;1286856;1141479;1333248;;;;;;
387574,420;99004;7598;161280;1131283;1132003;1171456;1230287;1139601;1332736;;;;;;
387574,444;7598;0;161280;1132003;1108818;1171456;1139601;1108818;1332736;187666;186080;786432;1327267;1294898;2119168
387655,900;147959;4818;160256;1108818;1108818;1171456;1256777;1113636;1331712;;;;;;
387961,094;151250;4580;160768;1108818;1108818;1171456;1260068;1113398;1332224;;;;;;
388118,357;151012;5411;159744;1108818;1108819;1171456;1259830;1114230;1331200;;;;;;
388251,133;150683;6672;160256;1108818;1108819;1171456;1259501;1115491;1331712;;;;;;
388277,407;152080;7387;161280;1108819;1108819;1171456;1260899;1116206;1332736;;;;;;
388302,094;154331;8939;160768;1108819;1108819;1171456;1263150;1117758;1332224;;;;;;
388312,287;155883;9955;161280;1108819;1108819;1171456;1264702;1118774;1332736;;;;;;
388318,937;157411;10342;161280;1108819;1108818;1171456;1266230;1119160;1332736;;;;;;
388337,371;157798;7571;161280;1108818;1108819;1171456;1266616;1116390;1332736;;;;;;
388343,025;155027;9797;161280;1108819;1108818;1171456;1263846;1118615;1332736;;;;;;
388358,059;157253;10766;161280;1108818;1108818;1171456;1266071;1119584;1332736;;;;;;
388366,810;158222;7969;161280;1108818;1109306;1171456;1267040;1117275;1332736;;;;;;
388377,410;155425;8453;161792;1109306;1110754;1171456;1264731;1119207;1333248;;;;;;
388382,666;156421;8275;161280;1110754;1111730;1171456;1267175;1120005;1332736;;;;;;
388390,831;156243;6563;162304;1111730;1112738;1171456;1267973;1119301;1333760;;;;;;
388397,351;156067;7442;162304;1112738;1113849;1171456;1268805;1121291;1333760;;;;;;
388445,812;156946;7843;162816;1113849;1114890;1171456;1270795;1122733;1334272;;;;;;
388490,249;157859;4895;162304;1114890;1115922;1171456;1272749;1120817;1333760;;;;;;
388529,078;154911;8339;162816;1115922;1116634;1171456;1270833;1124973;1334272;;;;;;
388554,596;158867;7544;162816;1116634;1118047;1171456;1275501;1125591;1334272;;;;;;
388561,631;158072;4330;162304;1118277;1119645;1171456;1276349;1123975;1333760;;;;;;
388583,341;154858;3794;162816;1119649;1121226;1171456;1274507;1125020;1334272;;;;;;
388609,945;154322;896;161792;1121226;1123066;1171456;1275548;1123962;1333248;;;;;;
388613,532;150400;930;150528;1123066;1123451;1171456;1273466;1124381;1321984;;;;;;
388665,240;150434;4168;162304;1123451;1123683;1171456;1273885;1127851;1333760;;;;;;
388862,728;153160;3392;161792;1123683;1124018;1171456;1276843;1127410;1333248;;;;;;
388927,675;152384;4971;162816;1124018;1124644;1171456;1276402;1129615;1334272;;;;;;
388945,590;154987;2960;162304;1124644;1124644;1171456;1279631;1127604;1333760;;;;;;
389145,344;152976;7679;162304;1124644;1124644;1171456;1277620;1132323;1333760;;;;;;
389168,908;158207;5873;162816;1124644;1124644;1171456;1282851;1130517;1334272;;;;;;
389211,483;156401;9519;162304;1124644;1124644;1171456;1281045;1134163;1333760;;;;;;
389243,400;160047;9162;159744;1124644;1124644;1171456;1284691;1133806;1331200;;;;;;
389262,598;159690;7312;162304;1124644;1124644;1171456;1284334;1131956;1333760;;;;;;
389275,237;156304;7296;161792;1124644;1124644;1171456;1280948;1131940;1333248;;;;;;
389369,482;156288;8808;161792;1124644;1125396;1171456;1280932;1134204;1333248;;;;;;
389404,134;158312;10612;160256;1125396;1126708;1171456;1283708;1137320;1331712;;;;;;
389439,846;160116;7944;161792;1126708;1126708;1171456;1286824;1134652;1333248;;;;;;
389505,495;155912;9891;161280;1126708;1126708;1171456;1282620;1136599;1332736;;;;;;
389587,722;157859;10015;160256;1126708;1126708;1171456;1284567;1136723;1331712;;;;;;
389616,560;156447;8909;160768;1126708;1126709;1171456;1283155;1135618;1332224;;;;;;
389688,789;155341;12216;159232;1126709;1126708;1171456;1282050;1138924;1330688;;;;;;
389715,340;157624;11760;157184;1126708;1126708;1171456;1284332;1138468;1328640;;;;;;
389731,768;157168;10770;159232;1126708;1126708;1171456;1283876;1137478;1330688;;;;;;
389739,597;154130;11451;159232;1126708;1126708;1171456;1280838;1138159;1330688;;;;;;
389762,697;154757;10540;159232;1126708;1127997;1171456;1281465;1138537;1330688;;;;;;
389796,393;153900;9247;159232;1127997;1129148;1171456;1281897;1138395;1330688;;;;;;
389907,406;152607;10596;159744;1129148;1130212;1171456;1281755;1140808;1331200;;;;;;
389968,141;154980;8222;159744;1130212;1130804;1171456;1285192;1139026;1331200;;;;;;
390027,290;152606;8366;160768;1130804;1130804;1171456;1283410;1139170;1332224;;;;;;
390285,335;154286;9963;160256;1130804;1130804;1171456;1285090;1140767;1331712;;;;;;
390300,291;155883;8640;161280;1130804;1130804;1171456;1286687;1139444;1332736;;;;;;
390310,290;155584;8209;160768;1130804;1131500;1171456;1286388;1139709;1332224;;;;;;
390349,578;155153;6942;161792;1131500;1132772;1171456;1286653;1139714;1333248;;;;;;
390373,904;154910;8515;161280;1132772;1132996;1171456;1287682;1141511;1332736;;;;;;
390436,122;156483;9205;162304;1132996;1132996;1171456;1289479;1142201;1333760;;;;;;
390481,134;158197;7390;161792;1132996;1133484;1171456;1291193;1140874;1333248;;;;;;
390497,888;156382;6801;162304;1133484;1134059;1171456;1289866;1140860;1333760;;;;;;
390519,476;156305;9004;162304;1134059;1134683;1171456;1290364;1143687;1333760;;;;;;
390552,020;158508;6505;162816;1134683;1135035;1171456;1293191;1141540;1334272;;;;;;
390581,602;157026;7099;162816;1136008;1136433;1171456;1293034;1143532;1334272;;;;;;
390608,706;157627;8118;163328;1136436;1136763;1171456;1294063;1144881;1334784;;;;;;
390653,263;159158;6352;162816;1136763;1137163;1171456;1295921;1143515;1334272;;;;;;
390681,010;157392;8786;163328;1137163;1137508;1171456;1294555;1146294;1334784;;;;;;
390698,229;160338;6319;163328;1137508;1137660;1171456;1297846;1143979;1334784;;;;;;
390709,731;157871;8275;163328;1137660;1138017;1171456;1295531;1146292;1334784;;;;;;
390753,473;159827;8226;163328;1138017;1138169;1171456;1297844;1146395;1334784;;;;;;
390769,204;159778;6722;163840;1138169;1138257;1171456;1297947;1144979;1335296;;;;;;
390822,351;159298;8611;163840;1138257;1138345;1171456;1297555;1146956;1335296;;;;;;
390837,917;161187;8811;163840;1138345;1138785;1171456;1299532;1147596;1335296;;;;;;
390861,756;161387;6975;163840;1138785;1139105;1171456;1300172;1146080;1335296;;;;;;
390889,859;159551;6833;164352;1139105;1139433;1171456;1298656;1146266;1335808;;;;;;
390925,640;159921;8191;163840;1139433;1139665;1171456;1299354;1147856;1335296;;;;;;
391130,674;161279;9785;163328;1139665;1140146;1171456;1300944;1149931;1334784;;;;;;
391160,825;162361;10617;163328;1140146;1140305;1171456;1302507;1150922;1334784;;;;;;
391179,735;54006;7135;163328;1140305;1140609;1171456;1194311;1147744;1334784;;;;;;
391179,758;7135;0;163328;1140609;1115026;1171456;1147744;1115026;1334784;187665;186150;786432;1335409;1301176;2121216
391310,373;151552;4430;156160;1115026;1115027;1171456;1266578;1119457;1327616;;;;;;
391372,773;155982;3359;162816;1115027;1115027;1171456;1271009;1118386;1334272;;;;;;
391435,770;153887;6476;162816;1115027;1115027;1171456;1268914;1121503;1334272;;;;;;
391450,425;157004;5987;163328;1115027;1115027;1171456;1272031;1121014;1334784;;;;;;
391602,410;157027;7828;162816;1115027;1115027;1171456;1272054;1122855;1334272;;;;;;
391617,801;158868;5119;163328;1115027;1115027;1171456;1273895;1120146;1334784;;;;;;
391681,968;156671;6659;163328;1115027;1115026;1171456;1271698;1121685;1334784;;;;;;
391683,058;158211;6955;164352;1115026;1115026;1171456;1273237;1121981;1335808;;;;;;
391718,320;160043;7617;163840;1115026;1115026;1171456;1275069;1122643;1335296;;;;;;
391737,140;160705;6079;164352;1115026;1115027;1171456;1275731;1121106;1335808;;;;;;
391746,220;159679;6399;164352;1115027;1115027;1171456;1274706;1121426;1335808;;;;;;
391784,328;159999;6243;164864;1115027;1115595;1171456;1275026;1121838;1336320;;;;;;
391810,348;160867;7839;164864;1115595;1116387;1171456;1276462;1124226;1336320;;;;;;
391831,800;162463;5871;164864;1116387;1117651;1171456;1278850;1123522;1336320;;;;;;
391888,698;160495;4607;164864;1117651;1118043;1171456;1278146;1122650;1336320;;;;;;
391920,907;159231;4543;164864;1118043;1118387;1171456;1277274;1122930;1336320;;;;;;
391954,954;159167;5135;164864;1118387;1118387;1171456;1277554;1123522;1336320;;;;;;
391958,325;159759;7205;164864;1118387;1118387;1171456;1278146;1125592;1336320;;;;;;
391974,189;161829;5500;164864;1118387;1119091;1171456;1280216;1124591;1336320;;;;;;
391981,325;160124;4719;165376;1119091;1119515;1171456;1279215;1124234;1336832;;;;;;
391994,123;160367;5635;165376;1119515;1120355;1171456;1279882;1125990;1336832;;;;;;
392005,852;161283;3695;165376;1120355;1120811;1171456;1281638;1124506;1336832;;;;;;
392016,976;159343;5747;165376;1120811;1121227;1171456;1280154;1126974;1336832;;;;;;
392033,134;161395;6691;165888;1121227;1121779;1171456;1282622;1128470;1337344;;;;;;
392051,023;163363;5747;165888;1121779;1122555;1171456;1285142;1128302;1337344;;;;;;
392060,886;162419;2896;165888;1122555;1123721;1171456;1284974;1126617;1337344;;;;;;
392084,938;159568;2785;165888;1123721;1126170;1171456;1283289;1128955;1337344;;;;;;
392097,082;159457;4592;165888;1126170;1126594;1171456;1285627;1131186;1337344;;;;;;
392105,794;161264;1510;165888;1126594;1128830;1171456;1287858;1130340;1337344;;;;;;
392116,505;158182;1728;164864;1128830;1129690;1171456;1287012;1131418;1336320;;;;;;
392122,240;157376;960;165376;1129690;1130954;1171456;1287066;1131914;1336832;;;;;;
392162,691;156608;976;165376;1130954;1131618;1171456;1287562;1132594;1336832;;;;;;
392193,294;156624;4384;165376;1131618;1131914;1171456;1288242;1136298;1336832;;;;;;
392200,910;160032;5988;164864;1131914;1131914;1171456;1291946;1137902;1336320;;;;;;
392211,304;161636;2912;165376;1131914;1132458;1171456;1293550;1135370;1336832;;;;;;
392225,438;158560;1527;165888;1132458;1134986;1171456;1291018;1136513;1337344;;;;;;
392233,443;158199;1042;165888;1134986;1135354;1171456;1293185;1136396;1337344;;;;;;
392258,449;157700;976;165888;1135354;1135442;1171456;1293054;1136418;1337344;;;;;;
392293,206;157648;1528;165888;1135442;1135786;1171456;1293090;1137314;1337344;;;;;;
392317,938;158200;1210;166400;1135786;1135786;1171456;1293986;1136996;1337856;;;;;;
392347,909;158906;3882;166400;1135786;1135786;1171456;1294692;1139668;1337856;;;;;;
392415,549;161578;3793;166912;1135786;1135787;1171456;1297364;1139580;1338368;;;;;;
392464,471;162513;3216;166912;1135787;1135786;1171456;1298300;1139002;1338368;;;;;;
392478,787;161936;4288;167424;1135786;1135786;1171456;1297722;1140074;1338880;;;;;;
392497,774;164032;3376;167424;1135786;1135786;1171456;1299818;1139162;1338880;;;;;;
392555,151;163120;3696;167936;1135786;1135786;1171456;1298906;1139482;1339392;;;;;;
392561,324;164464;3920;167936;1135786;1135786;1171456;1300250;1139706;1339392;;;;;;
392591,612;164688;5732;166912;1135786;1135858;1171456;1300474;1141590;1338368;;;;;;
392618,284;165476;4824;167424;1135858;1135858;1171456;1301334;1140682;1338880;;;;;;
392665,961;164568;5423;167424;1135858;1136026;1171456;1300426;1141449;1338880;;;;;;
392680,938;165167;5150;165376;1136026;1136027;1171456;1301193;1141177;1336832;;;;;;
392699,572;164894;7187;165888;1136027;1136026;1171456;1300921;1143213;1337344;;;;;;
392744,432;164883;7155;164864;1136026;1136641;1171456;1300909;1143796;1336320;;;;;;
392767,691;164851;5534;165888;1136641;1136641;1171456;1301492;1142175;1337344;;;;;;
392782,272;162206;6032;165888;1136641;1136641;1171456;1298847;1142673;1337344;;;;;;
392829,683;162704;6206;164864;1136641;1136641;1171456;1299345;1142847;1336320;;;;;;
392843,914;161854;6585;165376;1136641;1136801;1171456;1298495;1143386;1336832;;;;;;
392917,908;162233;9704;163328;1136801;1137032;1171456;1299034;1146736;1334784;;;;;;
392928,711;163304;7678;161280;1137032;1137185;1171456;1300336;1144863;1332736;;;;;;
392974,074;161278;7134;163840;1137185;1137273;1171456;1298463;1144407;1335296;;;;;;
393021,014;159710;8443;161280;1137273;1137617;1171456;1296983;1146060;1332736;;;;;;
393058,959;161019;8867;162304;1137617;1137704;1171456;1298636;1146571;1333760;;;;;;
393147,540;159395;7134;162816;1137704;1138145;1171456;1297099;1145279;1334272;;;;;;
393193,443;157662;8068;163328;1138145;1138361;1171456;1295807;1146429;1334784;;;;;;
393236,734;159620;6848;163328;1138361;1138711;1171456;1297981;1145559;1334784;;;;;;
393346,422;158400;10631;161792;1138711;1138887;1171456;1297111;1149518;1333248;;;;;;
393364,148;161159;7873;162816;1138887;1139328;1171456;1300046;1147201;1334272;;;;;;
393378,943;158401;7343;163328;1139328;1139735;1171456;1297729;1147078;1334784;;;;;;
393400,342;158383;7072;162816;1139735;1140279;1171456;1298118;1147351;1334272;;;;;;
393444,768;158112;9182;162816;1140279;1140456;1171456;1298391;1149638;1334272;;;;;;
393491,979;160734;6815;163328;1140456;1140871;1171456;1301190;1147686;1334784;;;;;;
393528,451;158367;6623;163840;1140871;1141287;1171456;1299238;1147910;1335296;;;;;;
393583,083;159199;6992;163840;1141287;1141608;1171456;1300486;1148600;1335296;;;;;;
393619,964;159568;8579;164352;1141608;1142080;1171456;1301176;1150659;1335808;;;;;;
393655,846;162179;6687;164352;1142080;1142167;1171456;1304259;1148854;1335808;;;;;;
393667,065;160287;6743;164352;1142167;1142616;1171456;1302454;1149359;1335808;;;;;;
393765,602;160343;5983;164352;1142616;1143471;1171456;1302959;1149454;1335808;;;;;;
393792,866;159583;6175;164864;1143471;1143472;1171456;1303054;1149647;1336320;;;;;;
393828,472;160799;10082;164864;1143472;1143631;1171456;1304271;1153713;1336320;;;;;;
393842,078;164706;9799;161792;1143631;1143928;1171456;1308337;1153727;1333248;;;;;;
393858,088;161351;6975;163328;1143928;1144264;1171456;1305279;1151239;1334784;;;;;;
393872,972;158527;6752;163840;1144264;1144719;1171456;1302791;1151471;1335296;;;;;;
393949,115;159328;7252;163840;1144719;1144928;1171456;1304047;1152180;1335296;;;;;;
394039,919;159828;6287;164352;1144928;1145160;1171456;1304756;1151447;1335808;;;;;;
394100,938;159887;6111;164352;1145160;1145512;1171456;1305047;1151623;1335808;;;;;;
394129,777;159711;6403;164864;1145512;1145592;1171456;1305223;1151995;1336320;;;;;;
394196,979;160515;9038;164352;1145592;1145792;1171456;1306107;1154830;1335808;;;;;;
394216,658;163150;9230;163328;1145792;1146080;1171456;1308942;1155310;1334784;;;;;;
394236,259;161806;6751;163840;1146080;1146552;1171456;1307886;1153303;1335296;;;;;;
394307,918;159327;6847;164352;1146552;1146688;1171456;1305879;1153535;1335808;;;;;;
394387,355;160447;8016;164352;1146688;1146951;1171456;1307135;1154967;1335808;;;;;;
394414,462;161616;10510;162304;1146951;1147184;1171456;1308567;1157694;1333760;;;;;;
394585,205;162062;7939;163328;1147184;1147519;1171456;1309246;1155458;1334784;;;;;;
394612,012;159491;9714;162816;1147519;1147991;1171456;1307010;1157705;1334272;;;;;;
394642,509;161266;7091;163328;1147991;1148471;1171456;1309257;1155562;1334784;;;;;;
394652,870;158643;10008;162816;1148471;1148767;1171456;1307114;1158775;1334272;;;;;;
394668,263;161560;8176;163328;1148767;1149031;1171456;1310327;1157207;1334784;;;;;;
394674,095;159728;8661;163840;1149031;1149119;1171456;1308759;1157780;1335296;;;;;;
394703,889;160725;9816;163328;1149119;1149487;1171456;1309844;1159303;1334784;;;;;;
394730,198;161880;11296;161280;1149487;1149663;1171456;1311367;1160959;1332736;;;;;;
394744,324;160763;11687;161280;1149663;1150321;1171456;1310426;1162008;1332736;;;;;;
394761,813;161191;8580;162304;1150321;1150921;1171456;1311512;1159501;1333760;;;;;;
394783,858;141968;7859;161792;1150921;1151482;1171456;1292889;1159341;1333248;;;;;;
394783,881;7859;0;161792;1151482;1119972;1171456;1159341;1119972;1333248;186503;186165;786432;1345844;1306137;2119680
394804,214;148992;2016;161280;1119972;1119972;1171456;1268964;1121988;1332736;;;;;;
394843,911;150496;5376;161792;1119972;1119973;1171456;1270468;1125349;1333248;;;;;;
394850,584;153856;2873;160768;1119973;1119973;1171456;1273829;1122846;1332224;;;;;;
394858,205;150329;2927;161280;1119973;1119973;1171456;1270302;1122900;1332736;;;;;;
394891,466;150383;2895;161280;1119973;1119973;1171456;1270356;1122868;1332736;;;;;;
394908,280;150351;3435;161280;1119973;1119973;1171456;1270324;1123408;1332736;;;;;;
394929,450;150891;3433;161792;1119973;1119973;1171456;1270864;1123406;1333248;;;;;;
394948,547;151401;5888;161280;1119973;1119972;1171456;1271374;1125860;1332736;;;;;;
394975,274;153856;4368;162816;1119972;1119973;1171456;1273828;1124341;1334272;;;;;;
395075,837;154384;4913;162304;1119973;1119973;1171456;1274357;1124886;1333760;;;;;;
395099,332;154832;6041;163840;1120946;1120945;1171456;1275778;1126986;1335296;;;;;;
395151,724;158105;6881;163328;1120950;1120950;1171456;1279055;1127831;1334784;;;;;;
395203,484;158945;5887;164352;1120950;1120950;1171456;1279895;1126837;1335808;;;;;;
395254,274;158975;10352;163840;1120950;1120950;1171456;1279925;1131302;1335296;;;;;;
395278,265;163440;7906;161792;1120950;1120950;1171456;1284390;1128856;1333248;;;;;;
395330,326;158434;7022;162816;1120950;1121039;1171456;1279384;1128061;1334272;;;;;;
395380,952;157550;6830;163840;1121039;1121263;1171456;1278589;1128093;1335296;;;;;;
395390,905;158894;6686;163328;1121263;1121423;1171456;1280157;1128109;1334784;;;;;;
395415,534;158750;6900;164352;1121423;1121510;1171456;1280173;1128410;1335808;;;;;;
395480,570;160500;6782;164352;1121510;1121678;1171456;1282010;1128460;1335808;;;;;;
395502,289;160382;6790;164864;1121678;1121846;1171456;1282060;1128636;1336320;;;;;;
395540,852;161414;6366;164864;1121846;1122118;1171456;1283260;1128484;1336320;;;;;;
395562,804;160990;6284;165376;1122118;1122590;1171456;1283108;1128874;1336832;;;;;;
395568,170;161932;8096;165376;1122590;1122943;1171456;1284522;1131039;1336832;;;;;;
395579,549;163744;5858;165376;1122943;1123549;1171456;1286687;1129407;1336832;;;;;;
395593,673;161506;6747;165376;1123549;1124462;1171456;1285055;1131209;1336832;;;;;;
395647,648;162395;8897;163840;1124462;1125222;1171456;1286857;1134119;1335296;;;;;;
395686,426;163521;7091;164864;1125222;1125622;1171456;1288743;1132713;1336320;;;;;;
395748,814;161715;7571;165376;1125622;1125622;1171456;1287337;1133193;1336832;;;;;;
395772,904;163219;9722;165376;1125622;1127065;1171456;1288841;1136787;1336832;;;;;;
395795,377;165370;8674;162304;1127065;1127280;1171456;1292435;1135954;1333760;;;;;;
395800,389;161250;7468;163840;1127280;1127280;1171456;1288530;1134748;1335296;;;;;;
395815,928;160044;7711;164352;1127280;1127585;1171456;1287324;1135296;1335808;;;;;;
395831,539;161311;7409;164352;1127585;1127768;1171456;1288896;1135177;1335808;;;;;;
395854,789;161009;6783;164864;1127768;1128169;1171456;1288777;1134952;1336320;;;;;;
395876,726;161407;10212;164864;1128169;1128545;1171456;1289576;1138757;1336320;;;;;;
395894,559;164836;6786;162816;1128545;1129575;1171456;1293381;1136361;1334272;;;;;;
395925,220;159362;6240;163840;1129575;1130135;1171456;1288937;1136375;1335296;;;;;;
396009,473;158816;5951;164352;1130135;1130135;1171456;1288951;1136086;1335808;;;;;;
396054,596;159551;7087;164352;1130135;1130135;1171456;1289686;1137222;1335808;;;;;;
396104,466;160687;6303;164864;1130135;1130135;1171456;1290822;1136438;1336320;;;;;;
396205,140;160415;6239;164352;1130135;1130135;1171456;1290550;1136374;1335808;;;;;;
396229,399;160351;7043;164864;1130135;1130135;1171456;1290486;1137178;1336320;;;;;;
396282,751;161667;8259;164864;1130135;1130503;1171456;1291802;1138762;1336320;;;;;;
396303,558;162883;6686;164864;1130503;1130991;1171456;1293386;1137677;1336320;;;;;;
396331,717;161310;8576;164864;1130991;1131575;1171456;1292301;1140151;1336320;;;;;;
396455,260;163200;9150;163840;1131575;1131839;1171456;1294775;1140989;1335296;;;;;;
396468,199;162750;7555;164352;1131839;1132327;1171456;1294589;1139882;1335808;;;;;;
396532,989;161155;8931;163840;1132327;1132599;1171456;1293482;1141530;1335296;;;;;;
396708,710;162531;7509;164352;1132599;1132759;1171456;1295130;1140268;1335808;;;;;;
396764,569;161109;7154;164864;1132759;1133135;1171456;1293868;1140289;1336320;;;;;;
396821,422;161778;9203;163840;1133135;1133343;1171456;1294913;1142546;1335296;;;;;;
396870,784;163827;6783;164352;1133343;1133631;1171456;1297170;1140414;1335808;;;;;;
396931,653;160383;7103;164352;1133631;1133671;1171456;1294014;1140774;1335808;;;;;;
396996,848;160703;6719;164864;1133671;1134023;1171456;1294374;1140742;1336320;;;;;;
397040,884;161343;9406;164352;1134023;1134183;1171456;1295366;1143589;1335808;;;;;;
397072,882;164030;7731;164864;1134183;1134351;1171456;1298213;1142082;1336320;;;;;;
397112,590;161843;10229;164352;1134351;1135722;1171456;1296194;1145951;1335808;;;;;;
397166,134;164341;8451;163328;1135722;1136481;1171456;1300063;1144932;1334784;;;;;;
397188,593;161027;9315;162304;1136481;1136481;1171456;1297508;1145796;1333760;;;;;;
397211,799;161891;9217;163328;1136481;1137081;1171456;1298372;1146298;1334784;;;;;;
397298,994;160769;9199;163328;1137081;1137802;1171456;1297850;1147001;1334784;;;;;;
397314,122;160751;7742;163840;1137802;1138050;1171456;1298553;1145792;1335296;;;;;;
397345,676;159575;11130;163328;1138050;1138433;1171456;1297625;1149563;1334784;;;;;;
397502,900;163194;7994;163328;1138433;1138706;1171456;1301627;1146700;1334784;;;;;;
397529,832;159546;10899;162816;1138706;1138721;1171456;1298252;1149620;1334272;;;;;;
397923,970;162451;8419;162816;1138721;1139057;1171456;1301172;1147476;1334272;;;;;;
398268,595;158947;10435;162816;1139057;1139337;1171456;1298004;1149772;1334272;;;;;;
398303,611;160963;10883;161792;1139337;1139545;1171456;1300300;1150428;1333248;;;;;;
398326,379;160387;9310;162304;1139545;1139905;1171456;1299932;1149215;1333760;;;;;;
398387,252;149854;8671;162816;1139905;1140256;1171456;1289759;1148927;1334272;;;;;;
398387,275;8671;0;162816;1140256;1121343;1171456;1148927;1121343;1334272;186348;186005;786432;1335275;1307348;2120704
398418,285;150016;4204;162304;1121343;1121343;1171456;1271359;1125547;1333760;;;;;;
398477,395;154220;3391;161280;1121343;1121343;1171456;1275563;1124734;1332736;;;;;;
398504,811;151871;7584;161792;1121343;1121343;1171456;1273214;1128927;1333248;;;;;;
398553,474;156064;3999;161280;1121343;1121343;1171456;1277407;1125342;1332736;;;;;;
398573,099;152419;5305;161792;1121344;1121343;1171456;1273763;1126648;1333248;;;;;;
398703,200;153785;10992;160768;1121343;1121343;1171456;1275128;1132335;1332224;;;;;;
398751,514;158448;6787;161280;1121343;1121344;1171456;1279791;1128131;1332736;;;;;;
398775,364;154243;8122;162304;1121344;1121343;1171456;1275587;1129465;1333760;;;;;;
398791,019;157114;6289;161792;1121343;1121343;1171456;1278457;1127632;1333248;;;;;;
398809,775;155281;6591;162816;1121343;1121343;1171456;1276624;1127934;1334272;;;;;;
398934,567;156607;7893;162304;1121343;1121344;1171456;1277950;1129237;1333760;;;;;;
398970,269;157909;9108;162816;1121344;1121343;1171456;1279253;1130451;1334272;;;;;;
399042,239;159636;7793;162816;1121343;1121343;1171456;1280979;1129136;1334272;;;;;;
399092,166;158321;8209;163328;1121343;1121343;1171456;1279664;1129552;1334784;;;;;;
399130,699;159761;8321;163328;1121343;1121344;1171456;1281104;1129665;1334784;;;;;;
399288,156;159873;8661;163840;1121344;1121648;1171456;1281217;1130309;1335296;;;;;;
399325,970;160725;9536;163328;1121648;1122231;1171456;1282373;1131767;1334784;;;;;;
399347,906;161600;10949;162304;1122231;1122903;1171456;1283831;1133852;1333760;;;;;;
399688,088;161477;8143;162816;1122903;1123119;1171456;1284380;1131262;1334272;;;;;;
399891,923;158671;9363;162816;1123119;1123729;1171456;1281790;1133092;1334272;;;;;;
400036,384;159891;8974;162816;1123729;1124249;1171456;1283620;1133223;1334272;;;;;;
400068,303;159502;9086;163328;1124249;1124594;1171456;1283751;1133680;1334784;;;;;;
400249,323;160126;9200;162816;1125080;1125587;1171456;1285206;1134787;1334272;;;;;;
400371,669;160240;9830;163328;1125591;1125752;1171456;1285831;1135582;1334784;;;;;;
400482,241;161382;11761;163328;1125752;1127452;1171456;1287134;1139213;1334784;;;;;;
400588,648;163313;7633;160256;1127452;1128148;1171456;1290765;1135781;1331712;;;;;;
400633,890;156113;12391;161280;1128148;1128148;1171456;1284261;1140539;1332736;;;;;;
400670,956;160871;10865;160256;1128148;1128332;1171456;1289019;1139197;1331712;;;;;;
400716,855;157297;10187;160768;1128332;1128604;1171456;1285629;1138791;1332224;;;;;;
400863,140;156619;11011;160256;1128604;1128747;1171456;1285223;1139758;1331712;;;;;;
400955,620;157443;12930;159744;1128747;1129036;1171456;1286190;1141966;1331200;;;;;;
401016,983;159362;10062;160768;1129036;1129460;1171456;1288398;1139522;1332224;;;;;;
401293,375;155982;9700;160256;1129460;1130220;1171456;1285442;1139920;1331712;;;;;;
401338,854;155620;9370;161280;1130220;1130388;1171456;1285840;1139758;1332736;;;;;;
401661,751;156314;8960;160768;1130388;1130796;1171456;1286702;1139756;1332224;;;;;;
401699,991;155904;8302;161792;1130796;1131204;1171456;1286700;1139506;1333248;;;;;;
401991,343;143735;9811;161280;1131204;1131643;1171456;1274939;1141454;1332736;;;;;;
401991,370;9811;0;161280;1131643;1126161;1171456;1141454;1126161;1332736;186269;185988;786432;1327723;1312149;2119168
402029,412;147968;4688;160768;1126161;1126161;1171456;1274129;1130849;1332224;;;;;;
402051,557;152144;3359;151040;1126161;1126161;1171456;1278305;1129520;1322496;;;;;;
402062,428;150815;4755;160768;1126161;1126162;1171456;1276976;1130917;1332224;;;;;;
402089,093;151187;4223;160768;1126162;1126161;1171456;1277349;1130384;1332224;;;;;;
402226,590;150655;6083;160768;1126161;1126162;1171456;1276816;1132245;1332224;;;;;;
402296,670;152515;4767;160768;1126162;1126161;1171456;1278677;1130928;1332224;;;;;;
402378,122;151199;10450;160256;1126161;1126161;1171456;1277360;1136611;1331712;;;;;;
402410,925;156882;6358;160768;1126161;1126161;1171456;1283043;1132519;1332224;;;;;;
402436,786;152790;6897;161280;1126161;1126161;1171456;1278951;1133058;1332736;;;;;;
402446,438;153841;6506;160768;1126161;1126161;1171456;1280002;1132667;1332224;;;;;;
402471,674;153450;6449;162304;1126161;1126161;1171456;1279611;1132610;1333760;;;;;;
402476,548;155441;6591;161792;1126161;1126161;1171456;1281602;1132752;1333248;;;;;;
402547,170;155583;10213;161792;1126161;1126161;1171456;1281744;1136374;1333248;;;;;;
402666,827;159717;7541;162304;1126161;1126161;1171456;1285878;1133702;1333760;;;;;;
402783,386;157045;11390;160768;1126161;1126161;1171456;1283206;1137551;1332224;;;;;;
402806,165;159870;7647;161792;1126161;1126824;1171456;1286031;1134471;1333248;;;;;;
403017,030;156127;7507;162816;1126824;1127217;1171456;1282951;1134724;1334272;;;;;;
403048,879;157523;8770;162304;1127217;1127592;1171456;1284740;1136362;1333760;;;;;;
403135,961;158786;9438;161792;1127592;1127984;1171456;1286378;1137422;1333248;;;;;;
403150,250;158942;10390;162304;1127984;1128552;1171456;1286926;1138942;1333760;;;;;;
403159,578;159894;9942;161280;1128552;1128768;1171456;1288446;1138710;1332736;;;;;;
403187,339;158422;9557;161792;1128768;1129574;1171456;1287190;1139131;1333248;;;;;;
403209,909;158037;7471;162304;1129574;1129950;1171456;1287611;1137421;1333760;;;;;;
403319,507;156463;7759;161792;1129950;1130326;1171456;1286413;1138085;1333248;;;;;;
403368,923;156751;11214;161280;1130326;1130414;1171456;1287077;1141628;1332736;;;;;;
403418,253;159684;8273;161792;1130413;1130574;1171456;1290097;1138847;1333248;;;;;;
403564,226;156753;10694;161280;1130574;1130662;1171456;1287327;1141356;1332736;;;;;;
403610,516;159174;9102;161792;1130662;1131198;1171456;1289836;1140300;1333248;;;;;;
403656,994;157582;10756;161280;1131198;1131478;1171456;1288780;1142234;1332736;;;;;;
403700,974;159236;12803;161792;1131478;1131998;1171456;1290714;1144801;1333248;;;;;;
403757,138;161283;13001;158720;1131998;1132133;1171456;1293281;1145134;1330176;;;;;;
404007,993;158362;12282;157696;1132133;1132390;1171456;1290495;1144672;1329152;;;;;;
404048,522;157690;12618;158720;1132390;1132797;1171456;1290080;1145415;1330176;;;;;;
404061,817;155978;11413;159232;1132797;1133502;1171456;1288775;1144915;1330688;;;;;;
404074,245;154773;9280;159744;1133502;1133910;1171456;1288275;1143190;1331200;;;;;;
404298,989;153152;11991;159232;1133910;1134437;1171456;1287062;1146428;1330688;;;;;;
404320,095;155863;11395;159744;1134437;1134909;1171456;1290300;1146304;1331200;;;;;;
404329,505;155267;9423;159232;1134909;1135437;1171456;1290176;1144860;1330688;;;;;;
404482,731;153295;11479;159744;1135437;1135629;1171456;1288732;1147108;1331200;;;;;;
404528,018;155863;11168;159744;1135629;1136437;1171456;1291492;1147605;1331200;;;;;;
404777,970;155552;9952;160256;1136437;1136645;1171456;1291989;1146597;1331712;;;;;;
404834,136;155360;8879;160256;1136645;1137141;1171456;1292005;1146020;1331712;;;;;;
404865,653;154287;10771;160768;1137141;1137477;1171456;1291428;1148248;1332224;;;;;;
405009,835;157203;10219;160768;1137477;1137805;1171456;1294680;1148024;1332224;;;;;;
405038,444;156651;8799;161280;1137805;1138494;1171456;1294456;1147293;1332736;;;;;;
405051,628;156255;8623;161280;1138494;1138902;1171456;1294749;1147525;1332736;;;;;;
405157,705;156079;11201;161280;1138902;1139461;1171456;1294981;1150662;1332736;;;;;;
405173,883;158657;8316;161280;1139461;1140134;1171456;1298118;1148450;1332736;;;;;;
405247,377;155772;10588;161280;1140134;1140765;1171456;1295906;1151353;1332736;;;;;;
405398,701;157631;9685;161280;1140766;1140998;1171456;1298397;1150683;1332736;;;;;;
405434,268;157141;9896;161792;1140998;1141718;1171456;1298139;1151614;1333248;;;;;;
405457,325;158376;8207;161792;1141718;1142062;1171456;1300094;1150269;1333248;;;;;;
405495,847;156687;7759;161792;1142062;1142150;1171456;1298749;1149909;1333248;;;;;;
405595,235;114811;7247;161792;1142150;1142766;1171456;1256961;1150013;1333248;;;;;;
405595,258;7247;0;161792;1142766;1130295;1171456;1150013;1130295;1333248;186454;186070;786432;1336467;1316365;2119680
405893,803;148480;4279;160768;1130295;1130296;1171456;1278775;1134575;1332224;;;;;;
406024,468;151735;2831;150528;1130296;1130296;1171456;1282031;1133127;1321984;;;;;;
406061,873;150287;4803;160768;1130296;1130295;1171456;1280583;1135098;1332224;;;;;;
406170,946;151017;5091;160768;1130296;1130296;1171456;1281313;1135387;1332224;;;;;;
406346,817;151523;6740;161280;1130296;1130296;1171456;1281819;1137036;1332736;;;;;;
406389,473;153684;5262;160768;1130296;1130296;1171456;1283980;1135558;1332224;;;;;;
406406,272;152206;9367;160768;1130296;1130296;1171456;1282502;1139663;1332224;;;;;;
406433,044;156823;7347;161280;1130296;1130296;1171456;1287119;1137643;1332736;;;;;;
406462,139;154803;9251;161792;1130296;1130296;1171456;1285099;1139547;1333248;;;;;;
406472,402;157731;7534;161792;1130296;1130296;1171456;1288027;1137830;1333248;;;;;;
406481,342;156014;9595;162304;1130296;1130296;1171456;1286310;1139891;1333760;;;;;;
406509,870;159099;9747;159744;1130296;1130295;1171456;1289395;1140042;1331200;;;;;;
406531,814;159251;10510;160768;1130295;1130295;1171456;1289546;1140805;1332224;;;;;;
406562,526;157691;10709;161280;1130296;1130296;1171456;1287987;1141005;1332736;;;;;;
406577,158;158165;13793;157184;1130296;1131493;1171456;1288461;1145286;1328640;;;;;;
406600,746;157153;11821;155648;1131493;1132302;1171456;1288646;1144123;1327104;;;;;;
406665,809;155181;10137;159232;1132302;1132877;1171456;1287483;1143014;1330688;;;;;;
406686,999;152985;9474;158720;1132877;1132876;1171456;1285862;1142350;1330176;;;;;;
407006,824;151794;9395;160256;1132877;1133309;1171456;1284671;1142704;1331712;;;;;;
407037,207;153896;11310;159744;1133308;1133997;1171456;1287204;1145307;1331200;;;;;;
407436,670;156206;8735;160768;1133997;1134509;1171456;1290203;1143244;1332224;;;;;;
407563,271;154655;10233;160256;1134509;1135189;1171456;1289164;1145422;1331712;;;;;;
407578,288;156153;8336;160768;1135189;1135677;1171456;1291342;1144013;1332224;;;;;;
407666,366;154768;10355;160768;1135677;1136541;1171456;1290445;1146896;1332224;;;;;;
407698,277;156787;10133;161280;1136541;1136621;1171456;1293328;1146754;1332736;;;;;;
407763,311;157589;9167;161280;1136621;1136917;1171456;1294210;1146084;1332736;;;;;;
407781,813;156623;7624;161792;1136917;1137733;1171456;1293540;1145357;1333248;;;;;;
407789,358;156104;8587;161792;1137733;1138132;1171456;1293837;1146719;1333248;;;;;;
407824,270;157067;10015;161792;1138132;1138573;1171456;1295199;1148588;1333248;;;;;;
407999,698;158495;7795;161792;1138573;1139069;1171456;1297068;1146864;1333248;;;;;;
408058,137;156275;9121;162304;1139069;1139109;1171456;1295344;1148230;1333760;;;;;;
408073,659;158625;11438;161280;1139109;1139132;1171456;1297734;1150570;1332736;;;;;;
408176,278;160942;10899;161792;1139132;1139133;1171456;1300074;1150032;1333248;;;;;;
408220,095;159379;9615;161792;1139133;1139148;1171456;1298512;1148763;1333248;;;;;;
408226,923;158095;9136;162304;1139148;1139557;1171456;1297243;1148693;1333760;;;;;;
408234,480;158640;8751;162304;1139557;1139869;1171456;1298197;1148620;1333760;;;;;;
408242,496;158255;8464;162816;1139869;1140437;1171456;1298124;1148901;1334272;;;;;;
408270,979;158480;7191;162304;1140437;1141669;1171456;1298917;1148860;1333760;;;;;;
408282,755;157207;6911;162304;1141669;1142045;1171456;1298876;1148956;1333760;;;;;;
408333,541;156415;7155;162304;1142045;1142653;1171456;1298460;1149808;1333760;;;;;;
408360,678;156659;6591;162304;1142653;1143180;1171456;1299312;1149771;1333760;;;;;;
408381,621;156095;5471;162304;1143180;1144236;1171456;1299275;1149707;1333760;;;;;;
408388,492;154975;9523;162304;1144236;1144236;1171456;1299211;1153759;1333760;;;;;;
408403,866;159027;5119;162304;1144236;1145709;1171456;1303263;1150828;1333760;;;;;;
408442,797;154623;6499;162304;1145709;1146117;1171456;1300332;1152616;1333760;;;;;;
408482,455;156003;8231;162304;1146117;1146205;1171456;1302120;1154436;1333760;;;;;;
408501,144;157735;5503;162816;1146205;1146204;1171456;1303940;1151707;1334272;;;;;;
408509,502;156031;5887;162816;1146204;1146204;1171456;1302235;1152091;1334272;;;;;;
408534,256;156415;8291;162816;1146204;1146365;1171456;1302619;1154656;1334272;;;;;;
408542,379;158819;6527;162816;1146365;1146365;1171456;1305184;1152892;1334272;;;;;;
408550,188;157055;6554;163328;1146365;1146780;1171456;1303420;1153334;1334784;;;;;;
408553,435;158106;6948;163328;1146780;1147364;1171456;1304886;1154312;1334784;;;;;;
408563,605;158500;5392;163840;1147364;1148156;1171456;1305864;1153548;1335296;;;;;;
408572,881;157968;4160;163840;1148156;1149092;1171456;1306124;1153252;1335296;;;;;;
408596,441;156736;6591;164352;1150551;1151055;1171456;1307287;1157646;1335808;;;;;;
408631,278;159679;5474;163840;1151060;1151868;1171456;1310739;1157342;1335296;;;;;;
408642,881;158562;7532;164352;1151868;1152204;1171456;1310430;1159736;1335808;;;;;;
408692,610;161132;6084;164352;1152204;1152604;1171456;1313336;1158688;1335808;;;;;;
408703,156;159684;6034;164864;1152604;1152764;1171456;1312288;1158798;1336320;;;;;;
408720,209;160658;6135;164864;1152764;1153900;1171456;1313422;1160035;1336320;;;;;;
408730,028;160759;5170;165376;1153900;1154664;1171456;1314659;1159834;1336832;;;;;;
408739,324;160306;7439;164864;1154664;1155872;1171456;1314970;1163311;1336320;;;;;;
408765,255;162575;3169;164352;1155872;1156528;1171456;1318447;1159697;1335808;;;;;;
408778,365;157793;1204;156160;1156528;1159248;1171456;1314321;1160452;1327616;;;;;;
408795,530;155828;7558;164352;1159248;1159527;1171456;1315076;1167085;1335808;;;;;;
408872,349;161158;4741;164352;1159527;1160760;1171456;1320685;1165501;1335808;;;;;;
409139,716;158341;5043;164864;1160760;1160760;1171456;1319101;1165803;1336320;;;;;;
409155,867;159155;3987;164352;1160760;1160759;1171456;1319915;1164746;1335808;;;;;;
409168,448;158099;3839;164864;1160759;1160760;1171456;1318858;1164599;1336320;;;;;;
409198,477;58829;5902;164864;1160759;1160760;1171456;1219588;1166662;1336320;;;;;;
409198,496;5902;0;164864;1160760;1141111;1171456;1166662;1141111;1336320;186283;186087;786432;1352945;1327198;2122752
409323,580;154624;5107;165888;1141111;1141112;1171456;1295735;1146219;1337344;;;;;;
409336,702;161267;3119;165376;1141112;1141112;1171456;1302379;1144231;1336832;;;;;;
409443,845;159279;3491;165888;1141112;1141112;1171456;1300391;1144603;1337344;;;;;;
409480,258;159848;6767;163840;1141112;1141112;1171456;1300960;1147879;1335296;;;;;;
409501,178;163439;6120;165376;1141112;1141111;1171456;1304551;1147231;1336832;;;;;;
409573,471;161768;8288;164352;1141111;1141112;1171456;1302879;1149400;1335808;;;;;;
409592,701;163936;5152;165376;1141112;1141111;1171456;1305048;1146263;1336832;;;;;;
409714,192;160288;6771;164864;1141111;1141112;1171456;1301399;1147883;1336320;;;;;;
409734,522;161907;8222;164352;1141112;1141112;1171456;1303019;1149334;1335808;;;;;;
409759,647;162846;8766;163840;1141112;1141112;1171456;1303958;1149878;1335296;;;;;;
409826,085;163390;9794;162816;1141112;1141112;1171456;1304502;1150906;1334272;;;;;;
409854,306;161346;9435;161280;1141112;1141112;1171456;1302458;1150547;1332736;;;;;;
409882,777;160987;11038;160768;1141112;1141111;1171456;1302099;1152149;1332224;;;;;;
409921,565;159518;8654;161792;1141111;1141112;1171456;1300629;1149766;1333248;;;;;;
409999,084;157134;13266;158720;1141112;1141112;1171456;1298246;1154378;1330176;;;;;;
410023,534;158674;9390;160256;1141112;1141792;1171456;1299786;1151182;1331712;;;;;;
410030,511;154798;11838;159232;1141792;1141880;1171456;1296590;1153718;1330688;;;;;;
410056,955;156222;10892;155648;1141880;1142455;1171456;1298102;1153347;1327104;;;;;;
410072,789;155276;9551;159744;1142455;1142879;1171456;1297731;1152430;1331200;;;;;;
410121,897;153423;9371;159232;1142879;1143383;1171456;1296302;1152754;1330688;;;;;;
410219,749;153243;10913;159232;1143383;1143855;1171456;1296626;1154768;1330688;;;;;;
410323,796;155297;9855;159744;1143855;1144175;1171456;1299152;1154030;1331200;;;;;;
410345,844;154239;11002;160256;1144175;1144743;1171456;1298414;1155745;1331712;;;;;;
410514,615;156410;10451;160256;1144743;1145327;1171456;1301153;1155778;1331712;;;;;;
410584,343;155859;8700;160768;1145327;1145935;1171456;1301186;1154635;1332224;;;;;;
410607,947;154620;10699;160256;1145935;1146488;1171456;1300555;1157187;1331712;;;;;;
410640,460;156619;9987;160768;1146488;1147087;1171456;1303107;1157074;1332224;;;;;;
410922,198;156263;9933;160768;1147087;1147543;1171456;1303350;1157476;1332224;;;;;;
410996,453;156365;13546;159232;1147543;1147983;1171456;1303908;1161529;1330688;;;;;;
411009,882;158954;8960;160256;1147983;1148583;1171456;1306937;1157543;1331712;;;;;;
411056,554;154368;10515;160768;1148583;1148959;1171456;1302951;1159474;1332224;;;;;;
411443,534;156435;12348;160256;1148959;1149424;1171456;1305394;1161772;1331712;;;;;;
411467,270;158268;8996;160256;1149424;1149656;1171456;1307692;1158652;1331712;;;;;;
411563,690;154404;10485;160256;1149656;1149863;1171456;1304060;1160348;1331712;;;;;;
411582,847;155893;8590;160768;1149863;1150040;1171456;1305756;1158630;1332224;;;;;;
411590,308;155022;10003;160768;1150040;1150399;1171456;1305062;1160402;1332224;;;;;;
411649,940;156435;8462;161280;1150399;1150920;1171456;1306834;1159382;1332736;;;;;;
411664,901;155918;8542;161280;1150920;1151136;1171456;1306838;1159678;1332736;;;;;;
411702,576;155998;8014;161792;1151136;1151623;1171456;1307134;1159637;1333248;;;;;;
411714,032;155982;9934;161280;1151623;1151815;1171456;1307605;1161749;1332736;;;;;;
411741,880;157902;9907;161792;1151815;1152175;1171456;1309717;1162082;1333248;;;;;;
411837,423;158387;9875;161792;1152175;1153104;1171456;1310562;1162979;1333248;;;;;;
411888,836;158355;8175;162304;1153104;1153392;1171456;1311459;1161567;1333760;;;;;;
411913,028;157679;7263;162304;1153392;1154392;1171456;1311071;1161655;1333760;;;;;;
411933,682;156767;8275;162304;1154392;1154576;1171456;1311159;1162851;1333760;;;;;;
411970,056;157779;7999;162304;1154576;1155095;1171456;1312355;1163094;1333760;;;;;;
412033,975;157503;11276;161280;1155095;1155623;1171456;1312598;1166899;1332736;;;;;;
412297,637;159756;11612;160256;1155623;1155847;1171456;1315379;1167459;1331712;;;;;;
412340,316;160092;8546;161792;1155847;1156463;1171456;1315939;1165009;1333248;;;;;;
412353,407;156514;8064;161280;1156463;1156623;1171456;1312977;1164687;1332736;;;;;;
412369,966;156032;7903;161792;1156623;1156944;1171456;1312655;1164847;1333248;;;;;;
412394,307;156383;7825;161792;1156944;1157327;1171456;1313327;1165152;1333248;;;;;;
412429,886;156305;10983;161280;1157327;1157415;1171456;1313632;1168398;1332736;;;;;;
412470,354;159463;13030;161792;1157415;1157639;1171456;1316878;1170669;1333248;;;;;;
412493,572;161510;8701;160768;1157639;1158287;1171456;1319149;1166988;1332224;;;;;;
412509,579;156157;10067;161280;1158287;1158743;1171456;1314444;1168810;1332736;;;;;;
412519,786;157523;8078;161280;1158743;1159288;1171456;1316266;1167366;1332736;;;;;;
412545,829;155534;8046;161280;1159288;1159440;1171456;1314822;1167486;1332736;;;;;;
412563,603;155502;9363;161792;1159440;1159551;1171456;1314942;1168914;1333248;;;;;;
412587,335;157843;11543;160256;1159551;1159847;1171456;1317394;1171390;1331712;;;;;;
412599,062;160023;11289;161280;1159847;1160399;1171456;1319870;1171688;1332736;;;;;;
412624,076;158745;9779;161280;1160399;1161287;1171456;1319144;1171066;1332736;;;;;;
412751,228;157231;9729;161792;1161288;1161744;1171456;1318519;1171473;1333248;;;;;;
412769,513;158209;12067;160768;1161744;1162215;1171456;1319953;1174282;1332224;;;;;;
412783,606;160547;10119;161792;1162215;1162303;1171456;1322762;1172422;1333248;;;;;;
412801,398;74616;9969;161280;1162304;1162391;1171456;1236920;1172360;1332736;;;;;;
412801,421;9969;0;161280;1162391;1146293;1171456;1172360;1146293;1332736;186341;186174;786432;1358701;1332467;2119168
413117,237;147968;4323;160768;1146293;1146294;1171456;1294261;1150617;1332224;;;;;;
413179,672;151779;6366;161280;1146294;1146293;1171456;1298073;1152659;1332736;;;;;;
413194,153;153822;6483;161280;1146293;1146294;1171456;1300115;1152777;1332736;;;;;;
413207,676;153939;4783;152576;1146294;1146293;1171456;1300233;1151076;1324032;;;;;;
413216,684;152239;4852;160768;1146293;1146294;1171456;1298532;1151146;1332224;;;;;;
413219,221;151284;5843;160768;1146294;1146293;1171456;1297578;1152136;1332224;;;;;;
413245,183;152275;8179;161792;1146293;1146294;1171456;1298568;1154473;1333248;;;;;;
413258,506;156147;5455;161280;1146294;1146293;1171456;1302441;1151748;1332736;;;;;;
413270,605;153423;5923;161792;1146293;1146293;1171456;1299716;1152216;1333248;;;;;;
413278,522;154403;6917;161792;1146293;1146293;1171456;1300696;1153210;1333248;;;;;;
413488,718;155397;7201;162816;1146293;1146837;1171456;1301690;1154038;1334272;;;;;;
413839,392;157217;11442;161792;1146837;1147638;1171456;1304054;1159080;1333248;;;;;;
413876,221;161458;11408;160768;1147638;1147637;1171456;1309096;1159045;1332224;;;;;;
413914,980;158864;10427;158208;1147637;1147638;1171456;1306501;1158065;1329664;;;;;;
413934,470;157883;9564;160768;1147638;1147637;1171456;1305521;1157201;1332224;;;;;;
413945,015;155996;8263;160768;1147637;1147637;1171456;1303633;1155900;1332224;;;;;;
413956,108;154695;9150;161792;1147637;1147638;1171456;1302332;1156788;1333248;;;;;;
413971,291;157118;9107;161280;1147638;1147909;1171456;1304756;1157016;1332736;;;;;;
414002,944;157075;8686;162304;1147909;1148278;1171456;1304984;1156964;1333760;;;;;;
414045,439;157678;12532;161792;1148278;1148278;1171456;1305956;1160810;1333248;;;;;;
414068,089;161524;10658;160768;1148278;1148492;1171456;1309802;1159150;1332224;;;;;;
414139,677;158114;10863;158720;1148492;1149549;1171456;1306606;1160412;1330176;;;;;;
414163,769;158319;10991;160768;1149549;1149812;1171456;1307868;1160803;1332224;;;;;;
414214,256;157423;12021;158720;1149812;1149972;1171456;1307235;1161993;1330176;;;;;;
414240,187;158453;10386;160768;1149972;1150268;1171456;1308425;1160654;1332224;;;;;;
414321,894;156306;12237;160256;1150268;1150941;1171456;1306574;1163178;1331712;;;;;;
414346,251;158157;9457;160256;1150941;1151764;1171456;1309098;1161221;1331712;;;;;;
414385,819;154865;9075;160256;1151764;1152884;1171456;1306629;1161959;1331712;;;;;;
414401,841;154483;12117;159744;1152884;1153228;1171456;1307367;1165345;1331200;;;;;;
414411,769;157525;7918;160256;1153228;1153645;1171456;1310753;1161563;1331712;;;;;;
414435,355;153326;7984;160768;1153645;1153757;1171456;1306971;1161741;1332224;;;;;;
414478,213;153904;8735;160256;1153757;1154372;1171456;1307661;1163107;1331712;;;;;;
414551,845;154655;11694;159744;1154372;1154468;1171456;1309027;1166162;1331200;;;;;;
414614,074;157102;8959;160256;1154468;1154708;1171456;1311570;1163667;1331712;;;;;;
414628,499;154367;11778;159744;1154708;1155444;1171456;1309075;1167222;1331200;;;;;;
414686,172;157186;11462;160256;1156609;1157073;1171456;1313795;1168535;1331712;;;;;;
414697,795;156870;10357;160768;1157076;1157397;1171456;1313946;1167754;1332224;;;;;;
414714,159;156277;9765;160256;1157397;1158148;1171456;1313674;1167913;1331712;;;;;;
414725,650;155685;9425;161280;1158148;1158476;1171456;1313833;1167901;1332736;;;;;;
414760,319;156735;11623;161280;1158476;1158748;1171456;1315211;1170371;1332736;;;;;;
414829,624;159079;11526;160256;1158748;1159309;1171456;1317827;1170835;1331712;;;;;;
414893,819;157958;9232;160768;1159309;1159397;1171456;1317267;1168629;1332224;;;;;;
414948,536;155664;9102;161280;1159397;1159757;1171456;1315061;1168859;1332736;;;;;;
414988,773;156558;10629;161280;1159757;1160116;1171456;1316315;1170745;1332736;;;;;;
415005,911;158085;11669;161280;1160116;1160293;1171456;1318201;1171962;1332736;;;;;;
415023,752;159125;9905;161280;1160293;1160452;1171456;1319418;1170357;1332736;;;;;;
415026,572;157361;9169;161792;1160452;1160996;1171456;1317813;1170165;1333248;;;;;;
415080,456;157137;10760;161280;1160996;1162035;1171456;1318133;1172795;1332736;;;;;;
415160,513;158728;10691;161792;1162035;1163427;1171456;1320763;1174118;1333248;;;;;;
415399,177;159171;8976;161792;1163427;1164475;1171456;1322598;1173451;1333248;;;;;;
415432,365;157456;12112;160768;1164475;1164739;1171456;1321931;1176851;1332224;;;;;;
415469,026;159568;10020;161280;1164739;1164739;1171456;1324307;1174759;1332736;;;;;;
415491,833;157476;11301;161792;1164739;1164739;1171456;1322215;1176040;1333248;;;;;;
415500,387;159781;8368;157184;1164739;1165507;1171456;1324520;1173875;1328640;;;;;;
415528,175;156848;10612;161792;1165507;1166171;1171456;1322355;1176783;1333248;;;;;;
415592,881;158580;7759;161280;1166171;1166403;1171456;1324751;1174162;1332736;;;;;;
415858,410;155727;11694;160768;1166403;1166402;1171456;1322130;1178096;1332224;;;;;;
415874,595;159150;9013;161280;1166402;1166403;1171456;1325552;1175416;1332736;;;;;;
415924,160;156469;11999;160256;1166403;1166731;1171456;1322872;1178730;1331712;;;;;;
416068,362;158431;12784;159232;1166731;1167042;1171456;1325162;1179826;1330688;;;;;;
416209,595;159216;12354;160256;1167042;1167339;1171456;1326258;1179693;1331712;;;;;;
416229,253;157762;10510;160256;1167339;1167531;1171456;1325101;1178041;1331712;;;;;;
416404,295;155918;11488;160768;1167531;1168458;1171456;1323449;1179946;1332224;;;;;;
416405,007;19963;8334;160768;1168459;1169219;1171456;1188422;1177553;1332224;;;;;;
416405,030;8334;0;160768;1169219;1147940;1171456;1177553;1147940;1332224;186367;186188;786432;1363920;1334128;2118656
416455,351;146426;1675;157696;1147941;1147941;1171456;1294367;1149616;1329152;;;;;;
416479,581;145035;4020;159232;1147941;1147941;1171456;1292976;1151961;1330688;;;;;;
416484,634;147380;2852;158208;1147941;1147941;1171456;1295321;1150793;1329664;;;;;;
416918,381;145118;5150;158720;1147941;1147941;1171456;1293059;1153091;1330176;;;;;;
417054,822;147486;6166;159232;1147941;1147941;1171456;1295427;1154107;1330688;;;;;;
417415,416;149014;6413;158720;1147941;1147941;1171456;1296955;1154354;1330176;;;;;;
417438,633;149261;8629;160256;1147941;1147941;1171456;1297202;1156570;1331712;;;;;;
417450,109;153525;5554;159744;1147941;1147941;1171456;1301466;1153495;1331200;;;;;;
417470,804;150450;6458;160768;1147941;1147941;1171456;1298391;1154399;1332224;;;;;;
417519,148;152890;5614;160768;1147941;1147941;1171456;1300831;1153555;1332224;;;;;;
417554,928;152046;5742;161792;1147941;1147941;1171456;1299987;1153683;1333248;;;;;;
417618,238;153710;6318;161280;1147941;1147941;1171456;1301651;1154259;1332736;;;;;;
417642,881;154286;6576;162816;1147941;1147941;1171456;1302227;1154517;1334272;;;;;;
417654,660;156592;10660;160768;1147941;1147941;1171456;1304533;1158601;1332224;;;;;;
417668,126;160676;11582;159744;1147941;1147941;1171456;1308617;1159523;1331200;;;;;;
417679,317;158014;13416;160256;1147941;1148229;1171456;1305955;1161645;1331712;;;;;;
417683,667;159848;9093;159232;1148229;1148733;1171456;1308077;1157826;1330688;;;;;;
417687,616;153477;7183;159744;1148733;1149916;1171456;1302210;1157099;1331200;;;;;;
417691,265;151567;6575;160768;1149916;1150828;1171456;1301483;1157403;1332224;;;;;;
417694,673;152495;6385;160256;1150828;1151340;1171456;1303323;1157725;1331712;;;;;;
417696,847;152305;5551;161280;1151340;1151892;1171456;1303645;1157443;1332736;;;;;;
417704,945;152495;5328;160768;1151892;1152492;1171456;1304387;1157820;1332224;;;;;;
417723,522;152272;6115;161792;1152492;1153308;1171456;1304764;1159423;1333248;;;;;;
417757,922;154083;4169;161280;1153308;1154170;1171456;1307391;1158339;1332736;;;;;;
417770,891;152137;3897;161792;1154170;1154699;1171456;1306307;1158596;1333248;;;;;;
417791,585;152377;3616;161792;1154699;1154930;1171456;1307076;1158546;1333248;;;;;;
417818,295;152067;1629;161792;1154930;1157191;1171456;1306997;1158820;1333248;;;;;;
417867,919;150109;4769;161792;1157191;1157614;1171456;1307300;1162383;1333248;;;;;;
418000,392;153249;7262;162304;1157614;1157870;1171456;1310863;1165132;1333760;;;;;;
418030,922;156766;4289;162304;1157870;1157871;1171456;1314636;1162160;1333760;;;;;;
418049,962;153793;6067;163328;1157871;1157871;1171456;1311664;1163938;1334784;;;;;;
418073,522;156982;10669;161792;1157870;1157870;1171456;1314852;1168539;1333248;;;;;;
418081,865;161709;5746;162816;1157870;1157871;1171456;1319579;1163617;1334272;;;;;;
418090,962;155762;5503;162304;1157871;1158158;1171456;1313633;1163661;1333760;;;;;;
418504,844;155519;6660;163328;1158158;1159231;1171456;1313677;1165891;1334784;;;;;;
418543,738;158212;4735;163328;1159231;1159230;1171456;1317443;1163965;1334784;;;;;;
418563,695;156287;5956;164352;1159230;1159230;1171456;1315517;1165186;1335808;;;;;;
418824,525;159044;6732;163840;1159230;1159230;1171456;1318274;1165962;1335296;;;;;;
418875,465;159820;8565;163328;1159230;1159231;1171456;1319050;1167796;1334784;;;;;;
418925,877;161141;8931;161792;1159231;1159230;1171456;1320372;1168161;1333248;;;;;;
418946,407;161507;9155;162304;1159230;1159230;1171456;1320737;1168385;1333760;;;;;;
419046,683;159683;10007;160768;1159230;1159230;1171456;1318913;1169237;1332224;;;;;;
419062,614;160535;9806;161280;1159230;1159231;1171456;1319765;1169037;1332736;;;;;;
419072,639;158286;9123;161792;1159231;1159231;1171456;1317517;1168354;1333248;;;;;;
419076,436;157556;9143;161792;1159230;1159535;1171456;1316786;1168678;1333248;;;;;;
419132,936;157623;7982;161792;1159535;1160559;1171456;1317158;1168541;1333248;;;;;;
419181,695;156462;7886;162816;1160559;1161255;1171456;1317021;1169141;1334272;;;;;;
420008,624;135826;7611;162304;1161254;1161838;1171456;1297080;1169449;1333760;;;;;;
420008,652;7611;0;162304;1161838;1150542;1171456;1169449;1150542;1333760;186194;186107;786432;1355643;1336649;2120192
420086,195;150016;4931;162304;1150542;1150543;1171456;1300558;1155474;1333760;;;;;;
420136,741;155459;5443;162816;1150543;1150543;1171456;1306002;1155986;1334272;;;;;;
420184,350;155971;4307;162304;1150543;1150543;1171456;1306514;1154850;1333760;;;;;;
420719,833;154835;4541;162816;1150543;1150542;1171456;1305378;1155083;1334272;;;;;;
420745,307;155069;9140;162304;1150542;1150542;1171456;1305611;1159682;1333760;;;;;;
420773,246;159668;6258;162816;1150542;1150542;1171456;1310210;1156800;1334272;;;;;;
420782,765;156786;5311;163328;1150542;1150543;1171456;1307328;1155854;1334784;;;;;;
420903,683;156863;5985;163328;1150543;1150542;1171456;1307406;1156527;1334784;;;;;;
420918,798;157537;5695;163840;1150542;1150543;1171456;1308079;1156238;1335296;;;;;;
420971,459;158271;8593;163840;1150543;1150542;1171456;1308814;1159135;1335296;;;;;;
420987,888;161169;6240;163840;1150542;1150542;1171456;1311711;1156782;1335296;;;;;;
421010,989;158816;6383;163840;1150542;1150543;1171456;1309358;1156926;1335296;;;;;;
421065,147;158959;7153;164352;1150543;1150543;1171456;1309502;1157696;1335808;;;;;;
421072,084;160753;6687;164352;1150543;1150543;1171456;1311296;1157230;1335808;;;;;;
421091,402;160287;7199;164864;1150543;1150543;1171456;1310830;1157742;1336320;;;;;;
421352,427;161823;8837;163840;1150605;1150989;1171456;1312428;1159826;1335296;;;;;;
421413,235;163461;9093;164352;1150994;1151233;1171456;1314455;1160326;1335808;;;;;;
421651,418;162693;10007;163840;1151233;1151673;1171456;1313926;1161680;1335296;;;;;;
421674,103;163607;8590;162816;1151673;1152138;1171456;1315280;1160728;1334272;;;;;;
421685,737;160142;11444;163328;1152138;1152633;1171456;1312280;1164077;1334784;;;;;;
421700,936;162996;9845;161280;1152633;1153201;1171456;1315629;1163046;1332736;;;;;;
421724,012;159349;8782;162304;1153201;1153369;1171456;1312550;1162151;1333760;;;;;;
421735,820;158286;9939;162304;1153369;1153673;1171456;1311655;1163612;1333760;;;;;;
421748,805;159443;8430;162304;1153673;1154009;1171456;1313116;1162439;1333760;;;;;;
421832,950;157899;11119;160768;1154496;1154791;1171456;1312395;1165910;1332224;;;;;;
421932,961;159599;11419;160256;1154793;1154953;1171456;1314392;1166372;1331712;;;;;;
421983,284;159899;13820;158208;1154953;1155394;1171456;1314852;1169214;1329664;;;;;;
422037,671;158204;11742;159744;1155394;1155770;1171456;1313598;1167512;1331200;;;;;;
422189,320;156126;12168;158720;1155770;1155770;1171456;1311896;1167938;1330176;;;;;;
422239,675;155528;11245;159232;1155770;1156130;1171456;1311298;1167375;1330688;;;;;;
422364,420;154605;12776;158208;1156130;1156738;1171456;1310735;1169514;1329664;;;;;;
422389,292;155112;9365;158720;1156738;1157386;1171456;1311850;1166751;1330176;;;;;;
422484,963;151701;12957;158208;1157386;1157962;1171456;1309087;1170919;1329664;;;;;;
422509,560;155293;8885;158720;1157962;1158546;1171456;1313255;1167431;1330176;;;;;;
422743,338;151221;8609;159232;1158546;1159146;1171456;1309767;1167755;1330688;;;;;;
422773,693;151969;13409;157184;1159146;1159642;1171456;1311115;1173051;1328640;;;;;;
422788,717;156769;8740;158720;1159642;1160210;1171456;1316411;1168950;1330176;;;;;;
422803,525;151076;8964;158720;1160210;1160521;1171456;1311286;1169485;1330176;;;;;;
422817,118;151300;7986;159232;1160521;1160938;1171456;1311821;1168924;1330688;;;;;;
422838,387;151346;11631;159232;1160938;1161250;1171456;1312284;1172881;1330688;;;;;;
422936,625;154991;10962;159744;1161250;1161793;1171456;1316241;1172755;1331200;;;;;;
422993,755;154834;12422;159232;1161793;1162002;1171456;1316627;1174424;1330688;;;;;;
423048,113;156294;11499;159232;1162002;1162210;1171456;1318296;1173709;1330688;;;;;;
423082,090;154808;8161;159232;1162210;1162825;1171456;1317018;1170986;1330688;;;;;;
423102,614;151521;9945;159744;1162825;1163314;1171456;1314346;1173259;1331200;;;;;;
423131,957;153817;7695;159232;1163314;1164050;1171456;1317131;1171745;1330688;;;;;;
423161,057;151567;7921;160256;1164050;1164362;1171456;1315617;1172283;1331712;;;;;;
423613,128;98723;7443;159744;1164362;1164962;1171456;1263085;1172405;1331200;;;;;;
423613,153;7443;0;159744;1164962;1155002;1171456;1172405;1155002;1331200;186355;186178;786432;1358760;1341180;2117632
424593,399;144896;1799;158208;1155002;1155003;1171456;1299898;1156802;1329664;;;;;;
425483,110;145159;4955;159232;1155003;1155003;1171456;1300162;1159958;1330688;;;;;;
426068,203;148315;5474;159744;1155003;1155003;1171456;1303318;1160477;1331200;;;;;;
426893,023;149346;3440;159232;1155003;1155003;1171456;1304349;1158443;1330688;;;;;;
427012,736;147312;3744;159744;1155003;1155003;1171456;1302315;1158747;1331200;;;;;;
427217,676;27406;3438;159744;1155002;1155003;1171456;1182408;1158441;1331200;;;;;;
427217,698;3438;0;159744;1155003;1150675;1171456;1158441;1150675;1331200;186186;185784;786432;1344627;1336459;2117632
428348,642;144384;1753;159744;1150675;1150675;1171456;1295059;1152428;1331200;;;;;;
428429,561;146137;7411;159744;1150675;1150675;1171456;1296812;1158086;1331200;;;;;;
428449,972;151795;5811;160768;1150675;1150675;1171456;1302470;1156486;1332224;;;;;;
428456,272;151731;4702;160256;1150675;1150675;1171456;1302406;1155377;1331712;;;;;;
428459,902;150622;5507;161792;1150675;1150675;1171456;1301297;1156182;1333248;;;;;;
428574,158;153475;6462;161280;1150675;1150675;1171456;1304150;1157137;1332736;;;;;;
429852,828;154430;3918;162816;1150675;1150675;1171456;1305105;1154593;1334272;;;;;;
430822,614;105439;3726;162304;1150675;1150675;1171456;1256114;1154401;1333760;;;;;;
430822,649;3726;0;162304;1150675;1149697;1171456;1154401;1149697;1333760;186023;184567;786432;1340424;1334264;2120192
432181,136;150016;1439;162816;1149697;1149698;1171456;1299713;1151137;1334272;;;;;;
433588,681;151967;1310;162816;1149698;1149698;1171456;1301665;1151008;1334272;;;;;;
434028,118;151838;5555;163328;1149698;1149697;1171456;1301536;1155252;1334784;;;;;;
434123,174;156595;7904;162816;1149697;1149697;1171456;1306292;1157601;1334272;;;;;;
434141,106;158944;5326;163328;1149697;1149698;1171456;1308641;1155024;1334784;;;;;;
434430,933;63299;5326;162816;1149698;1149698;1171456;1212997;1155024;1334272;;;;;;
434430,959;5326;0;162816;1149698;1151925;1171456;1155024;1151925;1334272;185375;185372;786432;1340399;1337297;2120704
434646,718;151040;6649;164352;1151925;1151926;1171456;1302965;1158575;1335808;;;;;;
434696,154;160249;4227;164352;1151926;1151925;1171456;1312175;1156152;1335808;;;;;;
434725,196;157827;4591;164864;1151925;1151926;1171456;1309752;1156517;1336320;;;;;;
434730,313;158703;4435;164352;1151926;1151926;1171456;1310629;1156361;1335808;;;;;;
434763,980;158547;4239;165376;1151926;1151926;1171456;1310473;1156165;1336832;;;;;;
434782,406;159887;4719;165376;1151926;1151926;1171456;1311813;1156645;1336832;;;;;;
434918,291;160363;4845;166400;1151925;1151926;1171456;1312288;1156771;1337856;;;;;;
435302,213;162029;8684;165888;1151926;1151974;1171456;1313955;1160658;1337344;;;;;;
436163,846;165868;4404;164864;1151974;1151974;1171456;1317842;1156378;1336320;;;;;;
437618,270;159992;3596;165376;1151973;1151974;1171456;1311965;1155570;1336832;;;;;;
438037,249;45235;3342;165888;1151974;1151974;1171456;1197209;1155316;1337344;;;;;;
438037,273;3342;0;165888;1151974;1150435;1171456;1155316;1150435;1337344;186030;184727;786432;1341346;1335162;2123776
439195,313;155969;2047;165376;1150435;1150435;1171456;1306404;1152482;1336832;;;;;;
439241,554;158207;6862;164864;1150435;1150435;1171456;1308642;1157297;1336320;;;;;;
440040,406;162510;4081;165376;1150435;1150435;1171456;1312945;1154516;1336832;;;;;;
441477,911;159729;3982;165888;1150435;1150435;1171456;1310164;1154417;1337344;;;;;;
441640,287;15728;3262;165376;1150435;1150435;1171456;1166163;1153697;1336832;;;;;;
441640,305;3262;0;165376;1150435;1150470;1171456;1153697;1150470;1336832;185200;184653;786432;1338897;1335123;2123264
443018,341;156052;959;165888;1150470;1150470;1171456;1306522;1151429;1337344;;;;;;
444573,865;157631;1151;165888;1150470;1150470;1171456;1308101;1151621;1337344;;;;;;
445243,684;65821;1326;165888;1150470;1150471;1171456;1216291;1151797;1337344;;;;;;
445243,702;1326;0;165888;1150471;1150572;1171456;1151797;1150572;1337344;184737;184737;786432;1336534;1335309;2123776
446672,484;156672;1246;165888;1150572;1150572;1171456;1307244;1151818;1337344;;;;;;
448249,049;157918;1255;166400;1150572;1150572;1171456;1308490;1151827;1337856;;;;;;
448847,368;59971;1230;165888;1150572;1150572;1171456;1210543;1151802;1337344;;;;;;
448847,384;1230;0;165888;1150572;1150559;1171456;1151802;1150559;1337344;184754;184754;786432;1336556;1335313;2123776
450276,008;157184;1070;166400;1150559;1150560;1171456;1307743;1151630;1337856;;;;;;
451888,701;158766;1166;166400;1150560;1150560;1171456;1309326;1151726;1337856;;;;;;
452451,108;77069;1739;167424;1150560;1150560;1171456;1227629;1152299;1338880;;;;;;
452451,128;1739;0;167424;1150560;1150871;1171456;1152299;1150871;1338880;184770;184770;786432;1337069;1335641;2125312
453988,717;159232;815;166912;1150871;1150871;1171456;1310103;1151686;1338368;;;;;;
455602,966;160047;1646;167936;1150871;1150871;1171456;1310918;1152517;1339392;;;;;;
456054,166;53178;1325;167424;1150871;1150872;1171456;1204049;1152197;1338880;;;;;;
456054,186;1325;0;167424;1150872;1150535;1171456;1152197;1150535;1338880;184787;184781;786432;1336984;1335316;2125312
457588,718;160256;1037;168448;1150535;1150536;1171456;1310791;1151573;1339904;;;;;;
459218,249;162317;1166;167936;1150536;1150535;1171456;1312853;1151701;1339392;;;;;;
459656,891;53596;1357;168960;1150536;1150536;1171456;1204132;1151893;1340416;;;;;;
459656,912;1357;0;168960;1150536;1150549;1171456;1151893;1150549;1340416;184802;184802;786432;1336695;1335351;2126848
460818,031;162304;3949;168448;1150549;1150549;1171456;1312853;1154498;1339904;;;;;;
460855,542;166253;6648;166400;1150549;1150946;1171456;1316802;1157594;1337856;;;;;;
460934,829;166392;4722;164864;1150946;1150947;1171456;1317338;1155669;1336320;;;;;;
461050,911;164466;8181;162304;1150947;1155182;1171456;1315413;1163363;1333760;;;;;;
461179,276;162293;10149;164352;1155182;1155182;1171456;1317475;1165331;1335808;;;;;;
461195,980;164261;6366;160256;1155182;1155182;1171456;1319443;1161548;1331712;;;;;;
461229,451;155870;6631;162304;1155182;1155182;1171456;1311052;1161813;1333760;;;;;;
461677,975;156135;8472;161280;1155182;1155182;1171456;1311317;1163654;1332736;;;;;;
462456,605;156952;8181;156672;1155182;1155183;1171456;1312134;1163364;1328128;;;;;;
463100,909;156661;8632;161280;1155183;1155182;1171456;1311844;1163814;1332736;;;;;;
463166,153;156088;8648;156160;1155182;1155182;1171456;1311270;1163830;1327616;;;;;;
463186,947;156104;10492;159744;1155182;1155182;1171456;1311286;1165674;1331200;;;;;;
463259,608;36533;8127;160256;1155182;1155182;1171456;1191715;1163309;1331712;;;;;;
463259,629;8127;0;160256;1155182;1155349;1171456;1163309;1155349;1331712;186094;185674;786432;1349403;1341023;2118144
463657,102;145408;6488;160768;1155349;1155349;1171456;1300757;1161837;1332224;;;;;;
464981,107;152408;3846;160256;1155349;1155349;1171456;1307757;1159195;1331712;;;;;;
465502,409;149580;7015;161792;1155349;1155349;1171456;1304929;1162364;1333248;;;;;;
465549,749;154983;8216;161280;1155349;1155350;1171456;1310332;1163566;1332736;;;;;;
465843,711;156184;10543;159744;1155350;1155350;1171456;1311534;1165893;1331200;;;;;;
465943,033;156975;8040;160768;1155350;1155350;1171456;1312325;1163390;1332224;;;;;;
466098,214;154472;7541;161792;1155350;1155349;1171456;1309822;1162890;1333248;;;;;;
466588,691;155509;10269;161280;1155349;1155349;1171456;1310858;1165618;1332736;;;;;;
466862,405;36871;6304;161792;1155349;1155350;1171456;1192220;1161654;1333248;;;;;;
466862,434;6304;0;161792;1155350;1155301;1171456;1161654;1155301;1333248;186093;185872;786432;1347747;1341173;2119680
468265,437;147968;893;161280;1155301;1155302;1171456;1303269;1156195;1332736;;;;;;
469774,514;148861;776;160256;1155302;1155302;1171456;1304163;1156078;1331712;;;;;;
470465,356;75216;751;160768;1155302;1155301;1171456;1230518;1156052;1332224;;;;;;
470465,376;751;0;160768;1155301;1153529;1171456;1156052;1153529;1332224;185872;184815;786432;1341924;1338344;2118656
471818,328;146350;1132;160768;1153530;1153530;1171456;1299880;1154662;1332224;;;;;;
473316,242;147564;1582;160768;1153530;1153530;1171456;1301094;1155112;1332224;;;;;;
474068,072;82268;1262;161280;1153530;1153530;1171456;1235798;1154792;1332736;;;;;;
474068,091;1262;0;161280;1153530;1153519;1171456;1154792;1153519;1332736;184815;184815;786432;1339607;1338334;2119168
474193,772;147456;7180;161280;1153519;1153520;1171456;1300975;1160700;1332736;;;;;;
475288,705;154636;5246;161792;1153520;1153520;1171456;1308156;1158766;1333248;;;;;;
476692,595;153214;3198;161280;1153520;1153520;1171456;1306734;1156718;1332736;;;;;;
477671,171;103185;3294;162816;1153520;1153520;1171456;1256705;1156814;1334272;;;;;;
477671,195;3294;0;162816;1153520;1153704;1171456;1156814;1153704;1334272;185047;184672;786432;1341861;1338376;2120704
479094,685;150016;1278;162304;1153704;1153705;1171456;1303720;1154983;1333760;;;;;;
480604,483;151294;1215;163328;1153705;1153704;1171456;1304999;1154919;1334784;;;;;;
481274,411;72577;1279;163328;1153705;1153704;1171456;1226282;1154983;1334784;;;;;;
481274,430;1279;0;163328;1153704;1153833;1171456;1154983;1153833;1334784;184812;184812;786432;1339795;1338645;2121216
482696,892;151552;910;163840;1153833;1153834;1171456;1305385;1154744;1335296;;;;;;
484271,993;153486;1167;163840;1153834;1153834;1171456;1307320;1155001;1335296;;;;;;
484877,487;66776;975;164864;1153833;1153834;1171456;1220609;1154809;1336320;;;;;;
484877,503;975;0;164864;1153834;1153812;1171456;1154809;1153812;1336320;184820;184820;786432;1339629;1338632;2122752
486342,881;154112;909;164352;1153812;1153813;1171456;1307924;1154722;1335808;;;;;;
487888,730;155021;782;165376;1153813;1153813;1171456;1308834;1154595;1336832;;;;;;
488480,413;66599;718;165376;1153813;1153813;1171456;1220412;1154531;1336832;;;;;;
488480,430;718;0;165376;1153813;1153818;1171456;1154531;1153818;1336832;184821;184821;786432;1339352;1338639;2123264
489974,772;155648;1422;166400;1153818;1153819;1171456;1309466;1155241;1337856;;;;;;
491555,172;158606;1278;165888;1153819;1153819;1171456;1312425;1155097;1337344;;;;;;
492083,410;58840;1134;167424;1153819;1153819;1171456;1212659;1154953;1338880;;;;;;
492083,429;1134;0;167424;1153819;1153771;1171456;1154953;1153771;1338880;184822;184822;786432;1339775;1338593;2125312
493588,753;159232;942;166912;1153771;1153772;1171456;1313003;1154714;1338368;;;;;;
495218,259;160168;1261;167936;1153772;1153772;1171456;1313940;1155033;1339392;;;;;;
495687,238;52411;1071;167424;1153772;1153772;1171456;1206183;1154843;1338880;;;;;;
495687,254;1071;0;167424;1153772;1153806;1171456;1154843;1153806;1338880;184823;184820;786432;1339666;1338626;2125312
497190,223;160256;1037;168960;1153806;1153807;1171456;1314062;1154844;1340416;;;;;;
498818,291;163302;1547;168448;1153806;1153807;1171456;1317108;1155354;1339904;;;;;;
499290,204;50242;1166;169472;1153806;1153806;1171456;1204048;1154972;1340928;;;;;;
499290,222;1166;0;169472;1153806;1153806;1171456;1154972;1153806;1340928;184822;184822;786432;1339794;1338628;2127360
500790,280;163328;815;168960;1153806;1153806;1171456;1317134;1154621;1340416;;;;;;
502418,317;164094;1132;169984;1153807;1153807;1171456;1317901;1154939;1341440;;;;;;
502894,029;55461;687;169472;1153806;1153806;1171456;1209267;1154493;1340928;;;;;;
502894,047;687;0;169472;1153806;1153806;1171456;1154493;1153806;1340928;184823;184823;786432;1339316;1338629;2127360
504538,071;164352;1126;170496;1153806;1153807;1171456;1318158;1154933;1341952;;;;;;
506190,249;166502;1389;169984;1153807;1153807;1171456;1320309;1155196;1341440;;;;;;
506496,844;41186;1166;171008;1153807;1153807;1171456;1194993;1154973;1342464;;;;;;
506496,861;1166;0;171008;1153807;1153792;1171456;1154973;1153792;1342464;184823;184811;786432;1339796;1338603;2128896
508141,463;166912;1190;171008;1153792;1153793;1171456;1320704;1154983;1342464;;;;;;
509790,274;168102;1199;171520;1153793;1153793;1171456;1321895;1154992;1342976;;;;;;
510099,587;40668;1103;171008;1153793;1153793;1171456;1194461;1154896;1342464;;;;;;
510099,605;1103;0;171008;1153793;1153804;1171456;1154896;1153804;1342464;184823;184811;786432;1339719;1338615;2128896
511816,441;167424;815;171520;1153804;1153805;1171456;1321228;1154620;1342976;;;;;;
513391,872;168751;1486;171520;1153805;1153805;1171456;1322556;1155291;1342976;;;;;;
513702,416;34226;1071;172032;1153805;1153805;1171456;1188031;1154876;1343488;;;;;;
513702,440;1071;0;172032;1153805;1153792;1171456;1154876;1153792;1343488;184823;184811;786432;1339699;1338603;2129920
515195,872;168960;1739;172032;1153792;1153793;1171456;1322752;1155532;1343488;;;;;;
516906,025;170699;846;172032;1153793;1153792;1171456;1324492;1154638;1343488;;;;;;
517305,807;46323;750;172032;1153792;1153792;1171456;1200115;1154542;1343488;;;;;;
517305,836;750;0;172032;1153792;1153790;1171456;1154542;1153790;1343488;184829;184811;786432;1339371;1338601;2129920
518946,963;168960;1357;172032;1153790;1153790;1171456;1322750;1155147;1343488;;;;;;
520590,265;170317;1101;172032;1153790;1153791;1171456;1324107;1154892;1343488;;;;;;
520908,515;36564;846;172544;1153790;1153790;1171456;1190354;1154636;1344000;;;;;;
520908,534;846;0;172544;1153790;1153790;1171456;1154636;1153790;1344000;184826;184823;786432;1339462;1338613;2130432
522622,668;169984;687;172544;1153790;1153790;1171456;1323774;1154477;1344000;;;;;;
524199,028;170671;847;172544;1153790;1153790;1171456;1324461;1154637;1344000;;;;;;
524512,003;32896;559;172544;1153790;1153790;1171456;1186686;1154349;1344000;;;;;;
524512,020;559;0;172544;1153790;1153781;1171456;1154349;1153781;1344000;184823;184811;786432;1339172;1338592;2130432
526215,283;169984;815;172544;1153781;1153781;1171456;1323765;1154596;1344000;;;;;;
527804,693;170799;1415;172544;1153781;1153781;1171456;1324580;1155196;1344000;;;;;;
528115,179;32880;1071;172544;1153782;1153781;1171456;1186662;1154852;1344000;;;;;;
528115,195;1071;0;172544;1153781;1153794;1171456;1154852;1153794;1344000;184823;184823;786432;1339675;1338617;2130432
529834,779;169984;1006;172544;1153794;1153795;1171456;1323778;1154801;1344000;;;;;;
531410,367;170990;1390;172032;1153795;1153795;1171456;1324785;1155185;1343488;;;;;;
531718,445;31823;1198;172544;1153794;1153795;1171456;1185617;1154993;1344000;;;;;;
531718,463;1198;0;172544;1153795;1153782;1171456;1154993;1153782;1344000;184823;184812;786432;1339816;1338594;2130432
532229,929;169984;2016;168960;1153782;1157973;1171456;1323766;1159989;1340416;;;;;;
532285,303;168928;4064;171008;1157973;1158381;1171456;1326901;1162445;1342464;;;;;;
532383,392;170976;4094;167936;1158381;1159010;1171456;1329357;1163104;1339392;;;;;;
532510,483;167934;5616;169472;1159010;1162449;1171456;1326944;1168065;1340928;;;;;;
533918,274;169436;5614;163840;1162449;1163635;1171456;1331885;1169249;1335296;;;;;;
534264,990;163822;8695;166912;1163635;1163856;1171456;1327457;1172551;1338368;;;;;;
534418,895;166903;8170;161280;1163856;1166121;1171456;1330759;1174291;1332736;;;;;;
534471,819;161258;8814;162304;1166121;1166122;1171456;1327379;1174936;1333760;;;;;;
534523,148;161902;7873;161280;1166122;1166122;1171456;1328024;1173995;1332736;;;;;;
534556,048;156353;13310;156672;1166122;1167756;1171456;1322475;1181066;1328128;;;;;;
534628,353;156670;7102;157696;1167756;1169532;1171456;1324426;1176634;1329152;;;;;;
534628,383;7102;0;157696;1169532;1160496;1228288;1176634;1160496;1385984;186229;185834;786432;1362863;1346330;2172416
534663,048;144384;2576;159744;1160496;1160496;1228288;1304880;1163072;1388032;;;;;;
535761,756;146960;3644;160256;1160496;1160496;1228288;1307456;1164140;1388544;;;;;;
537186,854;148540;3087;159744;1160496;1160496;1228288;1309036;1163583;1388032;;;;;;
538233,348;136881;3516;161280;1160496;1160496;1228288;1297377;1164012;1389568;;;;;;
538233,374;3516;0;161280;1160496;1155622;1228288;1164012;1155622;1389568;186023;184678;786432;1350035;1340300;2176000
539587,800;146944;1239;160768;1155622;1155623;1228288;1302566;1156862;1389056;;;;;;
540690,296;148183;3633;162304;1155623;1155623;1228288;1303806;1159256;1390592;;;;;;
540784,052;152113;7119;161280;1155623;1155622;1228288;1307736;1162741;1389568;;;;;;
540838,251;155599;6404;162304;1155622;1155623;1228288;1311221;1162027;1390592;;;;;;
541013,290;155394;7129;161792;1155623;1155623;1228288;1311017;1162752;1390080;;;;;;
541142,446;156121;5741;162816;1155623;1155623;1228288;1311744;1161364;1391104;;;;;;
541290,292;155757;11360;161792;1155623;1155623;1228288;1311380;1166983;1390080;;;;;;
541836,511;70121;6763;161792;1155623;1155623;1228288;1225744;1162386;1390080;;;;;;
541836,533;6763;0;161792;1155623;1158337;1228288;1162386;1158337;1390080;185708;185493;786432;1348094;1343830;2176512
543191,401;148480;847;161792;1158337;1158337;1228288;1306817;1159184;1390080;;;;;;
543734,742;149222;4755;162304;1158337;1158337;1228288;1307559;1163092;1390592;;;;;;
543774,734;153747;3039;161792;1158337;1158337;1228288;1312084;1161376;1390080;;;;;;
544141,418;152031;4143;162816;1158337;1158337;1228288;1310368;1162480;1391104;;;;;;
544803,846;154159;5539;162304;1158337;1158337;1228288;1312496;1163876;1390592;;;;;;
545091,468;155555;5323;164352;1158337;1158337;1228288;1313892;1163660;1392640;;;;;;
545161,623;157899;4786;163328;1158337;1158337;1228288;1316236;1163123;1391616;;;;;;
545199,143;157362;9043;163328;1158337;1158337;1228288;1315699;1167380;1391616;;;;;;
545280,862;161619;5149;163840;1158337;1158337;1228288;1319956;1163486;1392128;;;;;;
545343,374;157725;8202;163328;1158337;1158337;1228288;1316062;1166539;1391616;;;;;;
545377,762;160778;6942;163840;1158337;1158337;1228288;1319115;1165279;1392128;;;;;;
545441,008;154247;5853;164352;1158337;1158337;1228288;1312584;1164190;1392640;;;;;;
545441,038;5853;0;164352;1158337;1159578;1228288;1164190;1159578;1392640;186766;186081;786432;1350956;1345659;2179072
545518,084;153088;5188;163840;1159578;1159579;1228288;1312666;1164767;1392128;;;;;;
545566,751;158276;2976;164864;1159579;1159579;1228288;1317855;1162555;1393152;;;;;;
545632,963;157600;3791;164864;1159579;1159579;1228288;1317179;1163370;1393152;;;;;;
545693,867;158415;6643;164864;1159579;1159579;1228288;1317994;1166222;1393152;;;;;;
545772,881;161267;4191;164864;1159579;1159579;1228288;1320846;1163770;1393152;;;;;;
545965,046;158815;9607;162816;1159579;1159579;1228288;1318394;1169186;1391104;;;;;;
546073,665;162183;4895;163840;1159579;1159579;1228288;1321762;1164474;1392128;;;;;;
546120,824;157471;7843;163328;1159579;1159579;1228288;1317050;1167422;1391616;;;;;;
546185,901;160419;6064;163840;1159579;1159579;1228288;1319998;1165643;1392128;;;;;;
546252,364;158640;8194;163328;1159579;1159579;1228288;1318219;1167773;1391616;;;;;;
546341,061;160770;7826;163840;1159579;1159579;1228288;1320349;1167405;1392128;;;;;;
546461,897;160402;7694;163840;1159579;1159579;1228288;1319981;1167273;1392128;;;;;;
546503,044;160270;6927;163840;1159579;1159579;1228288;1319849;1166506;1392128;;;;;;
546537,575;159486;8546;163840;1159579;1159579;1228288;1319065;1168125;1392128;;;;;;
546600,186;161122;8958;161792;1159579;1159579;1228288;1320701;1168537;1390080;;;;;;
546697,733;161534;7941;163328;1159579;1160340;1228288;1321113;1168281;1391616;;;;;;
546740,554;159493;11774;163328;1160340;1161818;1228288;1319833;1173592;1391616;;;;;;
546794,630;163326;7166;161280;1161818;1162466;1228288;1325144;1169632;1389568;;;;;;
546944,416;156670;8110;162304;1162466;1162466;1228288;1319136;1170576;1390592;;;;;;
547170,166;157614;12483;160256;1162466;1162755;1228288;1320080;1175238;1388544;;;;;;
547334,908;159939;8242;161280;1162755;1163074;1228288;1322694;1171316;1389568;;;;;;
547468,804;155698;8653;161792;1163074;1163290;1228288;1318772;1171943;1390080;;;;;;
547679,095;157133;7342;161792;1163290;1164004;1228288;1320423;1171346;1390080;;;;;;
547798,332;155822;10995;161280;1164004;1164260;1228288;1319826;1175255;1389568;;;;;;
547943,118;159475;8206;161792;1164260;1164699;1228288;1323735;1172905;1390080;;;;;;
548286,000;156686;10546;161280;1164699;1165068;1228288;1321385;1175614;1389568;;;;;;
548433,728;159026;7213;161792;1165068;1165164;1228288;1324094;1172377;1390080;;;;;;
548485,695;155693;7149;162304;1165164;1165364;1228288;1320857;1172513;1390592;;;;;;
548516,558;156141;9858;161792;1165364;1165659;1228288;1321505;1175517;1390080;;;;;;
548556,122;158850;7341;162304;1165659;1165988;1228288;1324509;1173329;1390592;;;;;;
548604,296;156333;7550;161792;1165988;1166075;1228288;1322321;1173625;1390080;;;;;;
548650,342;156542;11346;161280;1166075;1166759;1228288;1322617;1178105;1389568;;;;;;
548712,070;159826;7181;161792;1166759;1166984;1228288;1326585;1174165;1390080;;;;;;
548749,309;155661;7182;162304;1166984;1167320;1228288;1322645;1174502;1390592;;;;;;
548787,084;156174;11634;160768;1167320;1167543;1228288;1323494;1179177;1389056;;;;;;
548849,562;160626;6910;161792;1167543;1167943;1228288;1328169;1174853;1390080;;;;;;
548896,141;154870;9568;161280;1167943;1168422;1228288;1322813;1177990;1389568;;;;;;
548960,615;157536;6895;161792;1168422;1168534;1228288;1325958;1175429;1390080;;;;;;
549009,273;155375;8723;161792;1168534;1168910;1228288;1323909;1177633;1390080;;;;;;
549044,545;111759;7519;162304;1168910;1169310;1228288;1280669;1176829;1390592;;;;;;
549044,570;7519;0;162304;1169310;1165350;1228288;1176829;1165350;1390592;188725;186201;786432;1365554;1351551;2177024
549339,650;149504;5398;162304;1165350;1165351;1228288;1314854;1170749;1390592;;;;;;
549392,566;154902;1134;161280;1165351;1165351;1228288;1320253;1166485;1389568;;;;;;
549423,385;149614;5794;161792;1165351;1165351;1228288;1314965;1171145;1390080;;;;;;
550677,572;154274;4035;161792;1165351;1165351;1228288;1319625;1169386;1390080;;;;;;
550760,540;152515;6401;161792;1165351;1165351;1228288;1317866;1171752;1390080;;;;;;
550818,806;154881;5294;162816;1165351;1165351;1228288;1320232;1170645;1391104;;;;;;
550855,204;155310;10466;160768;1165351;1165351;1228288;1320661;1175817;1389056;;;;;;
550976,144;160482;5023;162304;1165351;1165351;1228288;1325833;1170374;1390592;;;;;;
551037,067;153966;8383;161792;1165350;1165351;1228288;1319316;1173734;1390080;;;;;;
551100,371;157375;6014;162816;1165351;1165351;1228288;1322726;1171365;1391104;;;;;;
551161,114;155460;8053;162304;1165351;1165351;1228288;1320811;1173404;1390592;;;;;;
551222,512;158069;8991;161792;1165351;1165351;1228288;1323420;1174342;1390080;;;;;;
551291,015;158495;7186;162304;1165351;1165351;1228288;1323846;1172537;1390592;;;;;;
551328,588;156690;11283;160768;1165351;1165350;1228288;1322041;1176633;1389056;;;;;;
551484,354;159763;7613;161792;1165350;1165351;1228288;1325113;1172964;1390080;;;;;;
551551,404;156093;10223;161280;1165351;1165655;1228288;1321444;1175878;1389568;;;;;;
551620,148;158703;9325;161792;1165655;1165839;1228288;1324358;1175164;1390080;;;;;;
551712,786;157805;7421;162304;1165839;1166808;1228288;1323644;1174229;1390592;;;;;;
551778,476;156413;9985;161792;1166808;1167095;1228288;1323221;1177080;1390080;;;;;;
551868,118;158977;8770;162304;1167095;1167479;1228288;1326072;1176249;1390592;;;;;;
551996,789;157762;9118;161792;1167479;1167759;1228288;1325241;1176877;1390080;;;;;;
552095,497;158110;8846;162816;1167759;1168015;1228288;1325869;1176861;1391104;;;;;;
552149,974;158862;7118;162304;1168015;1168231;1228288;1326877;1175349;1390592;;;;;;
552200,680;157134;9776;162816;1168231;1168719;1228288;1325365;1178495;1391104;;;;;;
552257,860;160304;7247;162816;1168719;1168919;1228288;1329023;1176166;1391104;;;;;;
552501,356;157775;7535;162816;1168919;1169183;1228288;1326694;1176718;1391104;;;;;;
552647,710;55120;6543;162816;1169183;1169575;1228288;1224303;1176118;1391104;;;;;;
552647,732;6543;0;162816;1169575;1166347;1228288;1176118;1166347;1391104;187903;186217;786432;1364021;1352564;2177536
553291,386;150299;3128;162304;1166348;1166348;1228288;1316647;1169476;1390592;;;;;;
553435,789;153656;7783;162816;1166348;1166348;1228288;1320004;1174131;1391104;;;;;;
553594,940;158311;6195;163328;1166348;1166348;1228288;1324659;1172543;1391616;;;;;;
553639,854;157235;4175;162816;1166348;1166348;1228288;1323583;1170523;1391104;;;;;;
553734,338;155215;6674;163328;1166348;1166348;1228288;1321563;1173022;1391616;;;;;;
553802,386;158226;4463;163328;1166348;1166348;1228288;1324574;1170811;1391616;;;;;;
554143,027;156015;7827;163328;1166348;1166348;1228288;1322363;1174175;1391616;;;;;;
554218,272;159379;7880;163328;1166348;1166348;1228288;1325727;1174228;1391616;;;;;;
554276,707;159432;8484;162816;1166348;1166348;1228288;1325780;1174832;1391104;;;;;;
554319,829;160036;10887;162816;1166348;1166347;1228288;1326384;1177234;1391104;;;;;;
554471,588;162439;9458;161792;1166347;1166347;1228288;1328786;1175805;1390080;;;;;;
554658,160;158962;7921;162304;1166347;1166348;1228288;1325309;1174269;1390592;;;;;;
554701,003;157425;10224;161792;1166348;1166347;1228288;1323773;1176571;1390080;;;;;;
554747,422;159728;9377;162304;1166347;1166348;1228288;1326075;1175725;1390592;;;;;;
555166,074;158881;9053;162304;1166348;1166348;1228288;1325229;1175401;1390592;;;;;;
555456,138;158557;11351;161280;1166348;1166740;1228288;1324905;1178091;1389568;;;;;;
555970,932;160855;10351;160768;1166740;1167012;1228288;1327595;1177363;1389056;;;;;;
556251,632;119047;7133;161280;1167012;1167244;1228288;1286059;1174377;1389568;;;;;;
556251,656;7133;0;161280;1167244;1165101;1228288;1174377;1165101;1389568;187237;186309;786432;1361614;1351410;2176000
557262,537;147456;1267;159744;1165101;1165102;1228288;1312557;1166369;1388032;;;;;;
557328,203;147699;4894;160768;1165102;1165102;1228288;1312801;1169996;1389056;;;;;;
557456,311;151326;4294;160768;1165102;1165102;1228288;1316428;1169396;1389056;;;;;;
558895,108;150726;2973;160768;1165102;1165102;1228288;1315828;1168075;1389056;;;;;;
559854,699;98295;2909;160768;1165102;1165102;1228288;1263397;1168011;1389056;;;;;;
559854,723;2909;0;160768;1165102;1162716;1228288;1168011;1162716;1389056;186493;184688;786432;1354504;1347404;2175488
560894,954;146432;1654;160768;1162716;1162717;1228288;1309148;1164371;1389056;;;;;;
561068,147;148086;7183;161280;1162717;1162717;1228288;1310803;1169900;1389568;;;;;;
561362,751;154127;4521;160768;1162717;1162717;1228288;1316844;1167238;1389056;;;;;;
561415,219;151465;6727;162304;1162717;1162717;1228288;1314182;1169444;1390592;;;;;;
561530,199;155719;6883;161792;1162717;1162717;1228288;1318436;1169600;1390080;;;;;;
561619,209;155875;9059;161280;1162717;1162717;1228288;1318592;1171776;1389568;;;;;;
561672,762;157539;8467;161792;1162717;1162717;1228288;1320256;1171184;1390080;;;;;;
561744,439;156947;7817;162304;1162717;1162717;1228288;1319664;1170534;1390592;;;;;;
561803,366;156809;12559;161792;1162717;1162717;1228288;1319526;1175276;1390080;;;;;;
561865,721;161551;8336;159744;1162717;1162717;1228288;1324268;1171053;1388032;;;;;;
561898,465;154768;8383;160768;1162717;1162717;1228288;1317485;1171100;1389056;;;;;;
562033,106;154795;13811;157184;1162717;1163578;1228288;1317512;1177389;1385472;;;;;;
562073,796;157171;10051;159232;1163578;1163577;1228288;1320749;1173628;1387520;;;;;;
562114,807;153411;11379;158208;1163577;1163577;1228288;1316988;1174956;1386496;;;;;;
562718,322;153653;11857;154624;1163578;1163578;1228288;1317231;1175435;1382912;;;;;;
563458,297;84221;5695;158720;1163577;1163873;1228288;1247798;1169568;1387008;;;;;;
563458,345;5695;0;158720;1163873;1164732;1228288;1169568;1164732;1387008;186301;184837;786432;1355869;1349569;2173440
563553,992;141824;5338;158208;1164732;1164733;1228288;1306556;1170071;1386496;;;;;;
563683,184;147162;3630;158720;1164733;1164733;1228288;1311895;1168363;1387008;;;;;;
563720,565;145966;4404;158720;1164733;1164733;1228288;1310699;1169137;1387008;;;;;;
563955,724;146740;8145;159744;1164733;1164733;1228288;1311473;1172878;1388032;;;;;;
563992,164;151505;4686;158720;1164733;1164733;1228288;1316238;1169419;1387008;;;;;;
564042,584;148046;6597;160256;1164733;1164732;1228288;1312779;1171329;1388544;;;;;;
564067,515;151493;7395;159744;1164732;1164732;1228288;1316225;1172127;1388032;;;;;;
564103,231;152291;8211;161280;1164732;1164732;1228288;1317023;1172943;1389568;;;;;;
564111,468;155667;6720;161280;1164732;1164733;1228288;1320399;1171453;1389568;;;;;;
564173,457;154176;6922;162304;1164733;1164732;1228288;1318909;1171654;1390592;;;;;;
564770,563;155914;9219;161792;1164732;1164732;1228288;1320646;1173951;1390080;;;;;;
564933,760;158211;7918;162816;1164732;1164733;1228288;1322943;1172651;1391104;;;;;;
565370,091;157934;7694;162304;1164733;1164733;1228288;1322667;1172427;1390592;;;;;;
565436,567;157710;5887;163328;1164733;1164733;1228288;1322443;1170620;1391616;;;;;;
565523,452;156927;5742;162816;1164733;1164733;1228288;1321660;1170475;1391104;;;;;;
565635,073;156782;8590;163328;1164733;1165596;1228288;1321515;1174186;1391616;;;;;;
565675,987;160142;5615;163328;1165596;1165820;1228288;1325738;1171435;1391616;;;;;;
565786,478;157167;5985;163840;1165820;1165924;1228288;1322987;1171909;1392128;;;;;;
565930,894;158049;6580;163328;1165924;1166084;1228288;1323973;1172664;1391616;;;;;;
565964,980;158644;7877;163840;1166084;1166100;1228288;1324728;1173977;1392128;;;;;;
566281,172;160453;7798;163840;1166100;1166203;1228288;1326553;1174001;1392128;;;;;;
566613,524;160374;7776;164352;1166203;1166444;1228288;1326577;1174220;1392640;;;;;;
566707,945;161376;8357;164352;1166444;1166635;1228288;1327820;1174992;1392640;;;;;;
567061,444;115320;6814;164352;1166636;1166692;1228288;1281956;1173506;1392640;;;;;;
567061,482;6814;0;164352;1166692;1169503;1228288;1173506;1169503;1392640;187093;186074;786432;1360599;1355577;2179072
568368,193;153600;831;154624;1169503;1169504;1228288;1323103;1170335;1382912;;;;;;
568705,008;154431;6838;163840;1169504;1169503;1228288;1323935;1176341;1392128;;;;;;
568859,162;159414;5656;163840;1169503;1169504;1228288;1328917;1175160;1392128;;;;;;
569242,725;158232;6514;164864;1169504;1169504;1228288;1327736;1176018;1393152;;;;;;
569374,752;160626;6261;164352;1169504;1169504;1228288;1330130;1175765;1392640;;;;;;
569644,396;160373;7516;164864;1169504;1169504;1228288;1329877;1177020;1393152;;;;;;
569687,227;162140;8965;163840;1169504;1169504;1228288;1331644;1178469;1392128;;;;;;
569731,327;163582;6636;164864;1169504;1169503;1228288;1333086;1176139;1393152;;;;;;
569756,296;160748;8985;164352;1169503;1169504;1228288;1330251;1178489;1392640;;;;;;
569820,155;163097;9567;163328;1169504;1169504;1228288;1332601;1179071;1391616;;;;;;
570019,688;162143;8768;161792;1169504;1169504;1228288;1331647;1178272;1390080;;;;;;
570101,574;161344;7550;163840;1169504;1169504;1228288;1330848;1177054;1392128;;;;;;
570129,282;159614;9763;163328;1169504;1169504;1228288;1329118;1179267;1391616;;;;;;
570333,695;161618;9229;163328;1169504;1169504;1228288;1331122;1178733;1391616;;;;;;
570515,841;160781;11769;163328;1169504;1169766;1228288;1330285;1181535;1391616;;;;;;
570645,324;163321;11771;158208;1169766;1170697;1228288;1333087;1182468;1386496;;;;;;
570664,539;131314;8175;160768;1170696;1171423;1228288;1302010;1179598;1389056;;;;;;
570664,563;8175;0;160768;1171423;1174017;1228288;1179598;1174017;1389056;186190;186184;786432;1365788;1360201;2175488
570727,881;146432;992;159232;1174017;1174017;1228288;1320449;1175009;1387520;;;;;;
570754,576;146400;912;146432;1174017;1174017;1228288;1320417;1174929;1374720;;;;;;
570783,335;146320;4851;160256;1174017;1174018;1228288;1320337;1178869;1388544;;;;;;
570818,263;149747;3770;159744;1174018;1174018;1228288;1323765;1177788;1388032;;;;;;
571025,690;148666;4195;160768;1174018;1174017;1228288;1322684;1178212;1389056;;;;;;
571261,976;150627;5891;160768;1174017;1174018;1228288;1324644;1179909;1389056;;;;;;
571301,386;152323;4787;161792;1174018;1174018;1228288;1326341;1178805;1390080;;;;;;
571396,220;153267;6309;161792;1174018;1174018;1228288;1327285;1180327;1390080;;;;;;
571459,679;154789;5827;163328;1174018;1174018;1228288;1328807;1179845;1391616;;;;;;
571478,724;156867;10631;161792;1174018;1174018;1228288;1330885;1184649;1390080;;;;;;
571576,254;161671;6111;162816;1174018;1174018;1228288;1335689;1180129;1391104;;;;;;
571583,222;155615;6319;161792;1174018;1174018;1228288;1329633;1180337;1390080;;;;;;
571612,744;155765;7284;163328;1174017;1174018;1228288;1329782;1181302;1391616;;;;;;
571666,861;158836;7052;163328;1174018;1174017;1228288;1332854;1181069;1391616;;;;;;
571691,164;158604;7056;163840;1174017;1174018;1228288;1332621;1181074;1392128;;;;;;
571728,117;159632;6590;163840;1174018;1174178;1228288;1333650;1180768;1392128;;;;;;
571752,327;159166;7054;164864;1174178;1174226;1228288;1333344;1181280;1393152;;;;;;
572075,545;161166;7343;164352;1174226;1174849;1228288;1335392;1182192;1392640;;;;;;
572115,569;161455;9187;163840;1174849;1174945;1228288;1336304;1184132;1392128;;;;;;
572140,601;162787;6926;164352;1174945;1175514;1228288;1337732;1182440;1392640;;;;;;
572187,799;160526;9940;163328;1175514;1176041;1228288;1336040;1185981;1391616;;;;;;
572214,088;162516;7489;163840;1176041;1176322;1228288;1338557;1183811;1392128;;;;;;
572296,989;160065;7449;164352;1176322;1176602;1228288;1336387;1184051;1392640;;;;;;
572418,385;160537;8288;163840;1176602;1176944;1228288;1337139;1185232;1392128;;;;;;
572491,439;161376;6627;164352;1176944;1177488;1228288;1338320;1184115;1392640;;;;;;
572522,216;160227;10730;164352;1177488;1178582;1228288;1337715;1189312;1392640;;;;;;
572581,818;164330;7135;162304;1178582;1178742;1228288;1342912;1185877;1390592;;;;;;
572690,757;158687;8679;163328;1178742;1178743;1228288;1337429;1187422;1391616;;;;;;
572740,991;160231;9815;163328;1178743;1178951;1228288;1338974;1188766;1391616;;;;;;
572811,898;161367;7758;163328;1178951;1179103;1228288;1340318;1186861;1391616;;;;;;
572843,821;159310;8049;163840;1179103;1179150;1228288;1338413;1187199;1392128;;;;;;
572922,739;160113;7838;163328;1179150;1179495;1228288;1339263;1187333;1391616;;;;;;
572982,076;159902;7872;164352;1179495;1179623;1228288;1339397;1187495;1392640;;;;;;
573097,167;160960;10482;163840;1179623;1180222;1228288;1340583;1190704;1392128;;;;;;
573619,576;163570;7166;163840;1180222;1180510;1228288;1343792;1187676;1392128;;;;;;
573662,951;159742;6816;163840;1180510;1181062;1228288;1340252;1187878;1392128;;;;;;
573903,386;159392;7763;163840;1181062;1181078;1228288;1340454;1188841;1392128;;;;;;
573943,417;160339;7486;163840;1181078;1181143;1228288;1341417;1188629;1392128;;;;;;
574007,244;160062;8595;164352;1181143;1181598;1228288;1341205;1190193;1392640;;;;;;
574160,595;162195;10250;164352;1181598;1181726;1228288;1343793;1191976;1392640;;;;;;
574267,523;129711;6670;163328;1181726;1182847;1228288;1311437;1189517;1391616;;;;;;
574267,547;6670;0;163328;1182847;1178464;1228288;1189517;1178464;1391616;186268;186183;786432;1375785;1364647;2178048
574473,511;152576;4147;157184;1178464;1178465;1228288;1331040;1182612;1385472;;;;;;
574670,174;156723;3379;162304;1178465;1178465;1228288;1335188;1181844;1390592;;;;;;
574723,112;153907;4863;162816;1178465;1178465;1228288;1332372;1183328;1391104;;;;;;
575835,340;155391;4220;163328;1178465;1178465;1228288;1333856;1182685;1391616;;;;;;
575941,769;155772;8781;160768;1178465;1178464;1228288;1334237;1187245;1389056;;;;;;
576090,338;160333;5745;163328;1178464;1178465;1228288;1338797;1184210;1391616;;;;;;
576722,334;156597;8451;162816;1178465;1178464;1228288;1335062;1186915;1391104;;;;;;
577343,418;159491;8293;162816;1178464;1178464;1228288;1337955;1186757;1391104;;;;;;
577427,749;158821;11197;161792;1178464;1178464;1228288;1337285;1189661;1390080;;;;;;
577494,120;161725;9296;161792;1178464;1178464;1228288;1340189;1187760;1390080;;;;;;
577524,704;157776;9546;161792;1178464;1178465;1228288;1336240;1188011;1390080;;;;;;
577650,524;158026;10067;160768;1178465;1178464;1228288;1336491;1188531;1389056;;;;;;
577700,742;157523;10816;158720;1178464;1178464;1228288;1335987;1189280;1387008;;;;;;
577870,483;142325;8782;161280;1178465;1178465;1228288;1320790;1187247;1389568;;;;;;
577870,531;8782;0;161280;1178465;1176084;1228288;1187247;1176084;1389568;186242;186231;786432;1373489;1362315;2176000
578249,777;146944;5742;160768;1176084;1176085;1228288;1323028;1181827;1389056;;;;;;
578306,791;152686;6538;161792;1176085;1176085;1228288;1328771;1182623;1390080;;;;;;
578322,284;154506;6016;161280;1176085;1176085;1228288;1330591;1182101;1389568;;;;;;
578346,169;153984;6547;162304;1176085;1176085;1228288;1330069;1182632;1390592;;;;;;
578388,741;155539;8651;161792;1176085;1176085;1228288;1331624;1184736;1390080;;;;;;
578539,438;157643;7827;162816;1176085;1176084;1228288;1333728;1183911;1391104;;;;;;
578694,644;157843;8677;162304;1176084;1176085;1228288;1333927;1184762;1390592;;;;;;
578750,497;158693;7280;163328;1176085;1176084;1228288;1334778;1183364;1391616;;;;;;
578862,210;158320;9155;162816;1176084;1176085;1228288;1334404;1185240;1391104;;;;;;
578877,937;160195;8972;162816;1176085;1176085;1228288;1336280;1185057;1391104;;;;;;
578886,819;159500;8082;162816;1176085;1176085;1228288;1335585;1184167;1391104;;;;;;
578924,146;158610;11768;159232;1176085;1178769;1228288;1334695;1190537;1387520;;;;;;
578951,448;159224;11286;159232;1178769;1178768;1228288;1337993;1190054;1387520;;;;;;
579024,395;158742;13217;158720;1178768;1178768;1228288;1337510;1191985;1387008;;;;;;
579064,568;157601;13875;158720;1178768;1178768;1228288;1336369;1192643;1387008;;;;;;
579124,681;158259;13061;157696;1178768;1179392;1228288;1337027;1192453;1385984;;;;;;
579153,804;154373;11518;158208;1179392;1180016;1228288;1333765;1191534;1386496;;;;;;
579259,771;152830;12590;158208;1180016;1180632;1228288;1332846;1193222;1386496;;;;;;
579290,215;153902;11024;158208;1180632;1181281;1228288;1334534;1192305;1386496;;;;;;
579364,435;152336;12570;157696;1181281;1182071;1228288;1333617;1194641;1385984;;;;;;
579403,412;153882;12828;158208;1182071;1182503;1228288;1335953;1195331;1386496;;;;;;
579502,677;154140;12046;158208;1182503;1183159;1228288;1336643;1195205;1386496;;;;;;
579519,968;153358;11118;158208;1183159;1183495;1228288;1336517;1194613;1386496;;;;;;
579935,415;152430;14279;157696;1183495;1184263;1228288;1335925;1198542;1385984;;;;;;
579993,830;155591;11733;158208;1184263;1184463;1228288;1339854;1196196;1386496;;;;;;
580015,787;153042;16363;155648;1184463;1184872;1228288;1337505;1201235;1383936;;;;;;
580068,756;155627;8799;157184;1184872;1187919;1228288;1340499;1196718;1385472;;;;;;
580102,197;147732;10227;157696;1187919;1187919;1228288;1335651;1198146;1385984;;;;;;
580148,908;150003;13231;157184;1187919;1188583;1228288;1337922;1201814;1385472;;;;;;
580209,149;153007;11013;157696;1188583;1189055;1228288;1341590;1200068;1385984;;;;;;
580246,999;150772;13185;157184;1189055;1189247;1228288;1339827;1202432;1385472;;;;;;
580718,306;152884;10973;158208;1189248;1189679;1228288;1342132;1200652;1386496;;;;;;
581391,110;151773;10179;157696;1189679;1189975;1228288;1341452;1200154;1385984;;;;;;
581414,187;150979;10915;158720;1189975;1190247;1228288;1340954;1201162;1387008;;;;;;
581473,792;128385;7839;158720;1190247;1190695;1228288;1318632;1198534;1387008;;;;;;
581473,813;7839;0;158720;1190695;1179704;1228288;1198534;1179704;1387008;187132;186159;786432;1385666;1365863;2173440
581818,919;142336;6430;157696;1179704;1179704;1228288;1322040;1186134;1385984;;;;;;
581842,600;147742;3344;144896;1179704;1179705;1228288;1327446;1183049;1373184;;;;;;
581863,441;144656;5267;157696;1179705;1179704;1228288;1324361;1184971;1385984;;;;;;
581869,277;145555;5075;157696;1179704;1179705;1228288;1325259;1184780;1385984;;;;;;
581895,307;145363;6900;158208;1179705;1179704;1228288;1325068;1186604;1386496;;;;;;
581906,351;147700;5013;157696;1179704;1179704;1228288;1327404;1184717;1385984;;;;;;
581937,842;145705;6996;158720;1179704;1179705;1228288;1325409;1186701;1387008;;;;;;
581986,227;148820;7700;158208;1179705;1179704;1228288;1328525;1187404;1386496;;;;;;
582008,026;149524;6126;159744;1179704;1179705;1228288;1329228;1185831;1388032;;;;;;
582059,509;150510;10508;159744;1179705;1179705;1228288;1330215;1190213;1388032;;;;;;
582179,879;154892;10896;158720;1179705;1179704;1228288;1334597;1190600;1387008;;;;;;
582417,147;154256;8158;159232;1179704;1179704;1228288;1333960;1187862;1387520;;;;;;
583134,194;151518;9256;160256;1179704;1179704;1228288;1331222;1188960;1388544;;;;;;
583163,480;154664;11957;157696;1179704;1179704;1228288;1334368;1191661;1385984;;;;;;
583181,478;157365;11877;158720;1179704;1179704;1228288;1337069;1191581;1387008;;;;;;
583206,014;155237;10145;159232;1179704;1180199;1228288;1334941;1190344;1387520;;;;;;
583250,274;153505;13043;157696;1180199;1180231;1228288;1333704;1193274;1385984;;;;;;
583267,630;155379;12464;155136;1180231;1180631;1228288;1335610;1193095;1383424;;;;;;
583282,146;154800;10136;158720;1180631;1180855;1228288;1335431;1190991;1387008;;;;;;
583293,484;151960;12059;158208;1180855;1181520;1228288;1332815;1193579;1386496;;;;;;
583313,138;153883;9745;159232;1181520;1182623;1228288;1335403;1192368;1387520;;;;;;
583317,704;152593;8225;158720;1182623;1183472;1228288;1335216;1191697;1387008;;;;;;
583325,147;151073;6639;158720;1183472;1184839;1228288;1334545;1191478;1387008;;;;;;
583338,233;149999;5599;159232;1184839;1185743;1228288;1334838;1191342;1387520;;;;;;
583439,238;148870;9906;159744;1185743;1186687;1228288;1334613;1196593;1388032;;;;;;
583486,971;153620;10590;159232;1186686;1187663;1228288;1340306;1198253;1387520;;;;;;
583509,353;154462;7293;160256;1187663;1188462;1228288;1342125;1195755;1388544;;;;;;
583642,408;152189;8347;159744;1188462;1188790;1228288;1340651;1197137;1388032;;;;;;
583656,243;153243;8830;160768;1188790;1188790;1228288;1342033;1197620;1389056;;;;;;
583680,575;154750;8036;160256;1188790;1188790;1228288;1343540;1196826;1388544;;;;;;
583691,858;153811;7651;161280;1188790;1188790;1228288;1342601;1196441;1389568;;;;;;
583710,308;155107;12462;160256;1188790;1188886;1228288;1343897;1201348;1388544;;;;;;
583752,060;159918;8978;161280;1188886;1189046;1228288;1348804;1198024;1389568;;;;;;
583785,783;155922;8699;160768;1189046;1189046;1228288;1344968;1197745;1389056;;;;;;
583827,028;155643;13244;159232;1189046;1189047;1228288;1344689;1202291;1387520;;;;;;
583862,262;158652;9337;160256;1189047;1189046;1228288;1347699;1198383;1388544;;;;;;
583901,823;154745;10207;160768;1189046;1189046;1228288;1343791;1199253;1389056;;;;;;
583939,103;156639;9981;160768;1189046;1189047;1228288;1345685;1199028;1389056;;;;;;
583976,025;156413;10263;161280;1189047;1189270;1228288;1345460;1199533;1389568;;;;;;
583986,017;157719;11045;161280;1189270;1190173;1228288;1346989;1201218;1389568;;;;;;
583994,305;158501;8987;161792;1190173;1190669;1228288;1348674;1199656;1390080;;;;;;
584002,471;156955;7937;161280;1190669;1191933;1228288;1347624;1199870;1389568;;;;;;
584014,884;155905;8883;161792;1191933;1193005;1228288;1347838;1201888;1390080;;;;;;
584026,270;157363;7539;161792;1193005;1193973;1228288;1350368;1201512;1390080;;;;;;
584037,010;156019;8404;162304;1193973;1194837;1228288;1349992;1203241;1390592;;;;;;
584057,459;157396;5887;161792;1194837;1195540;1228288;1352233;1201427;1390080;;;;;;
584078,983;154879;5375;161792;1195540;1196236;1228288;1350419;1201611;1390080;;;;;;
584110,531;153855;4672;153600;1196236;1197139;1228288;1350091;1201811;1381888;;;;;;
584130,317;153152;5474;161792;1197139;1197444;1228288;1350291;1202918;1390080;;;;;;
584172,960;153442;6900;161280;1197444;1197700;1228288;1350886;1204600;1389568;;;;;;
584192,704;154868;5842;162304;1197700;1197699;1228288;1352568;1203541;1390592;;;;;;
584201,374;154834;9242;161792;1197699;1197699;1228288;1352533;1206941;1390080;;;;;;
584217,519;158234;7039;162304;1197699;1198084;1228288;1355933;1205123;1390592;;;;;;
584243,121;156031;6291;161792;1198084;1198396;1228288;1354115;1204687;1390080;;;;;;
584271,342;155283;8370;162816;1198396;1199003;1228288;1353679;1207373;1391104;;;;;;
584283,596;158898;11596;162304;1199003;1199004;1228288;1357901;1210600;1390592;;;;;;
584345,836;162124;6767;162304;1199004;1199491;1228288;1361128;1206258;1390592;;;;;;
584369,461;156271;11637;161280;1199491;1199491;1228288;1355762;1211128;1389568;;;;;;
584476,537;161141;8381;161792;1199491;1199700;1228288;1360632;1208081;1390080;;;;;;
584600,562;156349;7723;161280;1199700;1199699;1228288;1356049;1207422;1389568;;;;;;
584730,852;155691;10871;161280;1199699;1199699;1228288;1355390;1210570;1389568;;;;;;
584743,799;159351;8504;161792;1199699;1199699;1228288;1359050;1208203;1390080;;;;;;
584888,551;156984;10519;161792;1199699;1199860;1228288;1356683;1210379;1390080;;;;;;
584955,995;158999;10223;161792;1199860;1200148;1228288;1358859;1210371;1390080;;;;;;
584994,325;158703;7805;161792;1200148;1200516;1228288;1358851;1208321;1390080;;;;;;
585077,083;84334;9074;161792;1200515;1200659;1228288;1284849;1209733;1390080;;;;;;
585077,109;9074;0;161792;1200659;1193900;1228288;1209733;1193900;1390080;186521;186309;786432;1396254;1380209;2176512
585382,639;148480;6423;162304;1193900;1193901;1228288;1342380;1200324;1390592;;;;;;
585435,043;155927;2959;152576;1193901;1193901;1228288;1349828;1196860;1380864;;;;;;
585461,511;152463;5923;161792;1193901;1193900;1228288;1346364;1199823;1390080;;;;;;
585525,002;154403;4446;161792;1193900;1193901;1228288;1348303;1198347;1390080;;;;;;
585601,219;152926;4849;161792;1193901;1193901;1228288;1346827;1198750;1390080;;;;;;
585665,531;153329;8474;161792;1193901;1193901;1228288;1347230;1202375;1390080;;;;;;
585757,998;156954;6526;162304;1193901;1193901;1228288;1350855;1200427;1390592;;;;;;
585779,150;155518;9210;161792;1193901;1193901;1228288;1349419;1203111;1390080;;;;;;
585822,947;158202;9809;161280;1193901;1193900;1228288;1352103;1203709;1389568;;;;;;
585977,286;158289;9296;161792;1193900;1193901;1228288;1352189;1203197;1390080;;;;;;
586269,119;157776;7798;162304;1193901;1193901;1228288;1351677;1201699;1390592;;;;;;
586319,099;156654;11196;160256;1193901;1193901;1228288;1350555;1205097;1388544;;;;;;
586385,078;160188;11171;160256;1193901;1193901;1228288;1354089;1205072;1388544;;;;;;
586402,040;157603;11125;157696;1193901;1193901;1228288;1351504;1205026;1385984;;;;;;
586434,688;157557;9311;160768;1193901;1193900;1228288;1351458;1203211;1389056;;;;;;
586493,710;155231;13187;159232;1193900;1194389;1228288;1349131;1207576;1387520;;;;;;
586563,005;159107;14136;157696;1194389;1194581;1228288;1353496;1208717;1385984;;;;;;
586574,593;156472;9616;158720;1194581;1195235;1228288;1351053;1204851;1387008;;;;;;
586593,993;151952;10783;159232;1195235;1195474;1228288;1347187;1206257;1387520;;;;;;
586607,109;154143;10945;159232;1195474;1195498;1228288;1349617;1206443;1387520;;;;;;
586622,881;154305;9169;159744;1195498;1196226;1228288;1349803;1205395;1388032;;;;;;
586653,575;153553;9912;159744;1196226;1196570;1228288;1349779;1206482;1388032;;;;;;
586667,554;154296;8287;160768;1196570;1196858;1228288;1350866;1205145;1389056;;;;;;
586709,746;154207;7553;160256;1196858;1197682;1228288;1351065;1205235;1388544;;;;;;
586742,914;153473;7105;160768;1197682;1198242;1228288;1351155;1205347;1389056;;;;;;
586922,523;153537;11423;158208;1198242;1198450;1228288;1351779;1209873;1386496;;;;;;
586938,977;157855;7510;160768;1198450;1199066;1228288;1356305;1206576;1389056;;;;;;
587028,384;153430;9968;160256;1199066;1199721;1228288;1352496;1209689;1388544;;;;;;
587475,807;155888;8641;161280;1199721;1200265;1228288;1355609;1208906;1389568;;;;;;
587504,814;155585;10858;160768;1200265;1200425;1228288;1355850;1211283;1389056;;;;;;
587695,127;157802;9189;161280;1200425;1201292;1228288;1358227;1210481;1389568;;;;;;
587871,510;156645;8637;161280;1201292;1201692;1228288;1357937;1210329;1389568;;;;;;
587900,278;156093;10044;161792;1201692;1201828;1228288;1357785;1211872;1390080;;;;;;
587915,818;158524;7872;161792;1201828;1202037;1228288;1360352;1209909;1390080;;;;;;
587933,302;156352;8011;162304;1202037;1202149;1228288;1358389;1210160;1390592;;;;;;
588069,848;157003;10469;161792;1202149;1202165;1228288;1359152;1212634;1390080;;;;;;
588521,454;159358;10159;161792;1202975;1203103;1228288;1362333;1213262;1390080;;;;;;
588670,807;158639;12411;161280;1203107;1203275;1228288;1361746;1215686;1389568;;;;;;
588680,782;70935;7822;161280;1203275;1203603;1228288;1274210;1211425;1389568;;;;;;
588680,805;7822;0;161280;1203603;1190514;1228288;1211425;1190514;1389568;187344;186237;786432;1398769;1376751;2176000
588895,074;147456;1262;148992;1190514;1190515;1228288;1337970;1191777;1377280;;;;;;
589090,125;148718;1294;159232;1190515;1190515;1228288;1339233;1191809;1387520;;;;;;
589147,921;145629;8468;159744;1190515;1190515;1228288;1336144;1198983;1388032;;;;;;
589172,969;152852;7339;160768;1190515;1190515;1228288;1343367;1197854;1389056;;;;;;
589184,494;152937;5747;160256;1190515;1190515;1228288;1343452;1196262;1388544;;;;;;
589247,148;151667;5488;161280;1190515;1190515;1228288;1342182;1196003;1389568;;;;;;
589421,400;152432;4639;160768;1190515;1190515;1228288;1342947;1195154;1389056;;;;;;
589658,903;151583;7965;161792;1190515;1190515;1228288;1342098;1198480;1390080;;;;;;
589711,905;155933;6294;161280;1190515;1190515;1228288;1346448;1196809;1389568;;;;;;
589748,308;154262;5638;162304;1190515;1190515;1228288;1344777;1196153;1390592;;;;;;
589915,717;155142;6134;162304;1190515;1190515;1228288;1345657;1196649;1390592;;;;;;
589956,868;155638;8235;162816;1190515;1190515;1228288;1346153;1198750;1391104;;;;;;
590082,498;158763;11634;162304;1190515;1190515;1228288;1349278;1202149;1390592;;;;;;
590210,472;162162;8480;161280;1190515;1190515;1228288;1352677;1198995;1389568;;;;;;
590314,985;156960;8830;161792;1190515;1190515;1228288;1347475;1199345;1390080;;;;;;
590372,678;157310;10892;160768;1190515;1190603;1228288;1347825;1201495;1389056;;;;;;
590474,144;158348;7293;161280;1190603;1191011;1228288;1348951;1198304;1389568;;;;;;
590503,744;154749;8942;161792;1191011;1191443;1228288;1345760;1200385;1390080;;;;;;
590507,507;157422;13310;156672;1191443;1197651;1228288;1348865;1210961;1384960;;;;;;
590607,704;156670;12500;153600;1197651;1197706;1228288;1354321;1210206;1381888;;;;;;
590690,212;152788;9563;157696;1197706;1198186;1228288;1350494;1207749;1385984;;;;;;
590711,532;149851;10882;158720;1198186;1198490;1228288;1348037;1209372;1387008;;;;;;
590725,904;152706;9438;158208;1198490;1198730;1228288;1351196;1208168;1386496;;;;;;
590755,799;151262;10431;159744;1198730;1199250;1228288;1349992;1209681;1388032;;;;;;
590790,402;154303;7663;159232;1199250;1200226;1228288;1353553;1207889;1387520;;;;;;
590850,313;151535;10776;159744;1200226;1200226;1228288;1351761;1211002;1388032;;;;;;
590871,242;155160;8384;159744;1200226;1200226;1228288;1355386;1208610;1388032;;;;;;
590898,759;152768;9116;160768;1200226;1200226;1228288;1352994;1209342;1389056;;;;;;
591022,558;155036;10272;160256;1200226;1200641;1228288;1355262;1210913;1388544;;;;;;
591111,652;156192;12142;159744;1200641;1200738;1228288;1356833;1212880;1388032;;;;;;
591156,326;157550;14199;159744;1200738;1201161;1228288;1358288;1215360;1388032;;;;;;
591157,721;159607;15351;156160;1201161;1203209;1228288;1360768;1218560;1384448;;;;;;
591183,460;156151;15331;156160;1203209;1205114;1228288;1359360;1220445;1384448;;;;;;
591184,807;48276;18928;154112;1205114;1205617;1228288;1253390;1224545;1382400;;;;;;
591184,859;18928;0;154112;1205617;1201277;1228288;1224545;1201277;1382400;186338;186331;786432;1410883;1387608;2168832
591336,341;135168;3986;139264;1201277;1201278;1228288;1336445;1205264;1367552;;;;;;
591373,851;139154;4626;152576;1201278;1201278;1228288;1340432;1205904;1380864;;;;;;
591488,748;135698;5657;153088;1201278;1201278;1228288;1336976;1206935;1381376;;;;;;
591514,615;136729;7165;154112;1201278;1201278;1228288;1338007;1208443;1382400;;;;;;
591523,188;139773;7426;153600;1201278;1201278;1228288;1341051;1208704;1381888;;;;;;
591576,168;140034;5856;155136;1201278;1201278;1228288;1341312;1207134;1383424;;;;;;
591732,814;140512;5679;154624;1201278;1201940;1228288;1341790;1207619;1382912;;;;;;
592333,390;140335;6818;156160;1201940;1201940;1228288;1342275;1208758;1384448;;;;;;
592678,515;143522;7438;155648;1201940;1201940;1228288;1345462;1209378;1383936;;;;;;
592709,584;144142;8333;157696;1201940;1201940;1228288;1346082;1210273;1385984;;;;;;
592729,268;148109;6304;157184;1201940;1201940;1228288;1350049;1208244;1385472;;;;;;
592841,392;146080;7479;159232;1201940;1201940;1228288;1348020;1209419;1387520;;;;;;
592913,852;149815;6507;158208;1201940;1201940;1228288;1351755;1208447;1386496;;;;;;
593050,500;148843;8765;159744;1201940;1201940;1228288;1350783;1210705;1388032;;;;;;
593243,300;152637;10447;159232;1201940;1201940;1228288;1354577;1212387;1387520;;;;;;
593275,907;154319;7681;160256;1201940;1201940;1228288;1356259;1209621;1388544;;;;;;
593478,931;152577;9287;159744;1201940;1202508;1228288;1354517;1211795;1388032;;;;;;
593814,191;154183;9872;160768;1202508;1202868;1228288;1356691;1212740;1389056;;;;;;
593976,858;156304;10820;157696;1202868;1203211;1228288;1359172;1214031;1385984;;;;;;
594276,595;157252;10878;160256;1203211;1203395;1228288;1360463;1214273;1388544;;;;;;
594289,194;156286;12963;158720;1203395;1203443;1228288;1359681;1216406;1387008;;;;;;
594348,684;158371;8836;159744;1203443;1203531;1228288;1361814;1212367;1388032;;;;;;
594390,384;152708;9232;159232;1203531;1203748;1228288;1356239;1212980;1387520;;;;;;
594424,799;153104;11495;160256;1203748;1204067;1228288;1356852;1215562;1388544;;;;;;
594465,134;156903;10097;160256;1204067;1204332;1228288;1360970;1214429;1388544;;;;;;
594500,606;155505;11680;160256;1204332;1204356;1228288;1359837;1216036;1388544;;;;;;
594508,249;157088;8878;160256;1204356;1204587;1228288;1361444;1213465;1388544;;;;;;
594523,928;154286;10896;160256;1204587;1204755;1228288;1358873;1215651;1388544;;;;;;
594558,629;156304;10152;160256;1204755;1205019;1228288;1361059;1215171;1388544;;;;;;
594591,886;155560;8783;161280;1205019;1205339;1228288;1360579;1214122;1389568;;;;;;
594635,594;155727;12105;160768;1205339;1205379;1228288;1361066;1217484;1389056;;;;;;
594653,340;159049;10082;160768;1205379;1205612;1228288;1364428;1215694;1389056;;;;;;
594677,482;156514;9791;160768;1205612;1206259;1228288;1362126;1216050;1389056;;;;;;
594689,690;156223;9393;161792;1206259;1206963;1228288;1362482;1216356;1390080;;;;;;
594704,046;157361;8175;161280;1206963;1207619;1228288;1364324;1215794;1389568;;;;;;
594721,052;156143;7791;161792;1207619;1208171;1228288;1363762;1215962;1390080;;;;;;
594744,511;156271;7663;161792;1208171;1208459;1228288;1364442;1216122;1390080;;;;;;
594761,202;156143;8336;161792;1208459;1208891;1228288;1364602;1217227;1390080;;;;;;
594772,515;156816;7281;161792;1208891;1209371;1228288;1365707;1216652;1390080;;;;;;
594787,543;14482;6495;161792;1209371;1209859;1228288;1223853;1216354;1390080;;;;;;
594787,566;6495;0;161792;1209859;1199339;1228288;1216354;1199339;1390080;186335;186335;786432;1402689;1385674;2176512
594887,773;148480;5832;161792;1199339;1199339;1228288;1347819;1205171;1390080;;;;;;
594911,088;154312;5426;161792;1199339;1199339;1228288;1353651;1204765;1390080;;;;;;
594917,561;153906;3890;152576;1199339;1199340;1228288;1353245;1203230;1380864;;;;;;
594975,553;152370;7426;161792;1199340;1199339;1228288;1351710;1206765;1390080;;;;;;
595023,728;155394;6563;161280;1199339;1199340;1228288;1354733;1205903;1389568;;;;;;
595079,075;154531;4985;162304;1199340;1199340;1228288;1353871;1204325;1390592;;;;;;
595112,881;154489;4767;162304;1199340;1199339;1228288;1353829;1204106;1390592;;;;;;
595197,611;154271;9313;162304;1199339;1199339;1228288;1353610;1208652;1390592;;;;;;
595356,000;158817;7296;162304;1199339;1199340;1228288;1358156;1206636;1390592;;;;;;
595503,282;156800;9317;161792;1199340;1199339;1228288;1356140;1208656;1390080;;;;;;
595656,967;158821;9263;162304;1199339;1199339;1228288;1358160;1208602;1390592;;;;;;
595728,408;158767;8558;162304;1199339;1199339;1228288;1358106;1207897;1390592;;;;;;
595785,358;158062;10544;160256;1199339;1199340;1228288;1357401;1209884;1388544;;;;;;
595791,419;160048;13291;158720;1199340;1199974;1228288;1359388;1213265;1387008;;;;;;
595807,239;158531;10609;160256;1199974;1200533;1228288;1358505;1211142;1388544;;;;;;
595855,605;156017;9379;160256;1200533;1201101;1228288;1356550;1210480;1388544;;;;;;
595916,689;154787;7711;160256;1201101;1201846;1228288;1355888;1209557;1388544;;;;;;
595935,407;153119;8243;161280;1201846;1202182;1228288;1354965;1210425;1389568;;;;;;
595950,376;155187;8175;160768;1202182;1202437;1228288;1357369;1210612;1389056;;;;;;
596018,276;155119;7308;161792;1202437;1202845;1228288;1357556;1210153;1390080;;;;;;
596136,454;155788;9629;161792;1202845;1202846;1228288;1358633;1212475;1390080;;;;;;
596291,777;158109;9827;161792;1202846;1202845;1228288;1360955;1212672;1390080;;;;;;
596373,620;158307;8340;161792;1202845;1203452;1228288;1361152;1211792;1390080;;;;;;
596396,689;156820;10282;162304;1203452;1203652;1228288;1360272;1213934;1390592;;;;;;
596426,164;159786;8506;162304;1203652;1204036;1228288;1363438;1212542;1390592;;;;;;
596606,765;158010;12796;159232;1204036;1205230;1228288;1362046;1218026;1387520;;;;;;
596644,059;159228;10089;160768;1205230;1205742;1228288;1364458;1215831;1389056;;;;;;
596703,490;156521;10165;161280;1205742;1205742;1228288;1362263;1215907;1389568;;;;;;
596722,901;157621;7537;161280;1205742;1206845;1228288;1363363;1214382;1389568;;;;;;
596737,980;154993;8193;161280;1206845;1207046;1228288;1361838;1215239;1389568;;;;;;
596778,550;155649;10001;161280;1207046;1207133;1228288;1362695;1217134;1389568;;;;;;
596922,943;157457;7870;161792;1207133;1207398;1228288;1364590;1215268;1390080;;;;;;
596927,224;156350;8782;161792;1207398;1207669;1228288;1363748;1216451;1390080;;;;;;
596981,082;156934;10978;161280;1207669;1208230;1228288;1364603;1219208;1389568;;;;;;
596988,693;159458;13043;161792;1208230;1209213;1228288;1367688;1222256;1390080;;;;;;
597033,794;161523;9457;160768;1209213;1209982;1228288;1370736;1219439;1389056;;;;;;
597051,922;156913;8915;161280;1209982;1211019;1228288;1366895;1219934;1389568;;;;;;
597063,522;156371;7946;161792;1211019;1212186;1228288;1367390;1220132;1390080;;;;;;
597100,491;155914;6047;161280;1212186;1212371;1228288;1368100;1218418;1389568;;;;;;
597220,191;154015;7883;161792;1212371;1212897;1228288;1366386;1220780;1390080;;;;;;
597238,485;155851;5807;161280;1212897;1213089;1228288;1368748;1218896;1389568;;;;;;
597287,470;153775;5760;161280;1213089;1213632;1228288;1366864;1219392;1389568;;;;;;
597690,340;153216;7042;161280;1213632;1213632;1228288;1366848;1220674;1389568;;;;;;
597874,005;154498;6075;161792;1213632;1213633;1228288;1368130;1219708;1390080;;;;;;
598085,498;154555;5710;161792;1213633;1213632;1228288;1368188;1219342;1390080;;;;;;
598189,904;154190;6830;162304;1213632;1213632;1228288;1367822;1220462;1390592;;;;;;
598390,705;149686;7891;161792;1213632;1213632;1228288;1363318;1221523;1390080;;;;;;
598390,730;7891;0;161792;1213632;1201876;1228288;1221523;1201876;1390080;188178;186249;786432;1409701;1388125;2176512
599011,817;148992;1772;161792;1201876;1201877;1228288;1350868;1203649;1390080;;;;;;
599074,351;151276;7584;162304;1201877;1201876;1228288;1353153;1209460;1390592;;;;;;
599102,421;157088;8963;161792;1201876;1201876;1228288;1358964;1210839;1390080;;;;;;
599120,539;158458;7218;162304;1201876;1201877;1228288;1360334;1209095;1390592;;;;;;
599134,393;156722;7811;163328;1201877;1201876;1228288;1358599;1209687;1391616;;;;;;
599162,467;158851;7394;162816;1201876;1201877;1228288;1360727;1209271;1391104;;;;;;
599188,610;158434;6942;163840;1201877;1201877;1228288;1360311;1208819;1392128;;;;;;
599226,831;159518;11246;163840;1201877;1202757;1228288;1361395;1214003;1392128;;;;;;
599293,622;163822;9384;160768;1202757;1202757;1228288;1366579;1212141;1389056;;;;;;
599304,556;158888;12396;162304;1202757;1202757;1228288;1361645;1215153;1390592;;;;;;
599319,051;161900;11044;159232;1202757;1202758;1228288;1364657;1213802;1387520;;;;;;
599362,263;157476;10146;160768;1202758;1202757;1228288;1360234;1212903;1389056;;;;;;
599501,579;156578;11520;159744;1202757;1202757;1228288;1359335;1214277;1388032;;;;;;
599517,595;156928;10926;160256;1202757;1202758;1228288;1359685;1213684;1388544;;;;;;
599561,527;156334;12529;158208;1202758;1202757;1228288;1359092;1215286;1386496;;;;;;
599591,965;155889;11124;159232;1202757;1203309;1228288;1358646;1214433;1387520;;;;;;
599628,090;154484;8974;159744;1203309;1203869;1228288;1357793;1212843;1388032;;;;;;
599810,638;153358;8560;159744;1203869;1204645;1228288;1357227;1213205;1388032;;;;;;
599857,785;152944;7787;160256;1204645;1205269;1228288;1357589;1213056;1388544;;;;;;
599900,462;153195;8430;160256;1205269;1206093;1228288;1358464;1214523;1388544;;;;;;
599930,920;153838;8417;161280;1206093;1206373;1228288;1359931;1214790;1389568;;;;;;
599938,028;155361;7134;160768;1206373;1206853;1228288;1361734;1213987;1389056;;;;;;
599969,051;154078;6319;161280;1206853;1207905;1228288;1360931;1214224;1389568;;;;;;
600004,387;153775;6043;161280;1207905;1208519;1228288;1361680;1214562;1389568;;;;;;
600053,336;153499;5278;161280;1208519;1209184;1228288;1362018;1214462;1389568;;;;;;
600085,832;152734;4734;161280;1209184;1209528;1228288;1361918;1214262;1389568;;;;;;
600120,205;152190;4830;161280;1209528;1209839;1228288;1361718;1214669;1389568;;;;;;
600150,785;152286;4510;161280;1209839;1210215;1228288;1362125;1214725;1389568;;;;;;
600189,510;151966;4798;161792;1210215;1210303;1228288;1362181;1215101;1390080;;;;;;
600194,787;152766;5662;161280;1210303;1210367;1228288;1363069;1216029;1389568;;;;;;
600219,282;153630;5023;162304;1210367;1210455;1228288;1363997;1215478;1390592;;;;;;
600245,751;154015;6042;161792;1210455;1210695;1228288;1364470;1216737;1390080;;;;;;
600267,498;155034;5455;163328;1210695;1210798;1228288;1365729;1216253;1391616;;;;;;
600288,299;156495;5007;162816;1210798;1210838;1228288;1367293;1215845;1391104;;;;;;
600307,815;155930;5896;163840;1210839;1211030;1228288;1366769;1216926;1392128;;;;;;
600317,964;157960;7694;163328;1211030;1211415;1228288;1368990;1219109;1391616;;;;;;
600330,608;159758;6415;164352;1211415;1211502;1228288;1371173;1217917;1392640;;;;;;
600349,907;159503;8280;163840;1211502;1211782;1228288;1371005;1220062;1392128;;;;;;
600383,268;161368;7119;164352;1211782;1212046;1228288;1373150;1219165;1392640;;;;;;
600401,966;160207;8244;163840;1212046;1212143;1228288;1372253;1220387;1392128;;;;;;
600424,906;161332;7449;164352;1212143;1212230;1228288;1373475;1219679;1392640;;;;;;
600458,558;160537;9190;163840;1212230;1212519;1228288;1372767;1221709;1392128;;;;;;
600474,275;162278;9079;162816;1212519;1212607;1228288;1374797;1221686;1391104;;;;;;
600498,705;160631;7471;163328;1212607;1212694;1228288;1373238;1220165;1391616;;;;;;
600513,788;159023;9635;162816;1212694;1212775;1228288;1371717;1222410;1391104;;;;;;
600544,655;161187;8527;163328;1212775;1212879;1228288;1373962;1221406;1391616;;;;;;
600608,280;160079;8820;163328;1212879;1213063;1228288;1372958;1221883;1391616;;;;;;
600627,013;160372;10176;161792;1213063;1213446;1228288;1373435;1223622;1390080;;;;;;
600656,283;161728;12287;158720;1213446;1216745;1228288;1375174;1229032;1387008;;;;;;
600677,207;158719;9392;156160;1216745;1217641;1228288;1375464;1227033;1384448;;;;;;
600742,384;155824;10243;160768;1217641;1218073;1228288;1373465;1228316;1389056;;;;;;
600856,493;156675;10168;160768;1218073;1218072;1228288;1374748;1228240;1389056;;;;;;
600972,928;156600;11885;159744;1218072;1218817;1228288;1374672;1230702;1388032;;;;;;
601465,566;157183;10911;160256;1219011;1219387;1228288;1376194;1230298;1388544;;;;;;
601542,941;156319;10467;160256;1219486;1220030;1228288;1375805;1230497;1388544;;;;;;
601544,762;155875;14830;155648;1220030;1223095;1228288;1375905;1237925;1383936;;;;;;
601717,589;155630;9778;156160;1223095;1223982;1228288;1378725;1233760;1384448;;;;;;
601993,468;53825;8719;158208;1223982;1224510;1228288;1277807;1233229;1386496;;;;;;
601993,502;8719;0;158208;1224510;1206131;1228288;1233229;1206131;1386496;186675;186254;786432;1419904;1392385;2172928
602615,623;141312;1103;156672;1206131;1206131;1228288;1347443;1207234;1384960;;;;;;
603223,593;141391;2556;142848;1206131;1206131;1228288;1347522;1208687;1371136;;;;;;
603228,110;142844;8175;158208;1206131;1206132;1228288;1348975;1214307;1386496;;;;;;
603230,234;148463;14830;155136;1206132;1206132;1228288;1354595;1220962;1383424;;;;;;
603254,132;155118;4655;156672;1206132;1206132;1228288;1361250;1210787;1384960;;;;;;
603268,430;142895;4946;156672;1206132;1206131;1228288;1349027;1211077;1384960;;;;;;
603347,822;143186;6275;157696;1206131;1206459;1228288;1349317;1212734;1385984;;;;;;
603574,591;146051;4035;157184;1206459;1207498;1228288;1352510;1211533;1385472;;;;;;
603594,657;143811;3104;158208;1207498;1207762;1228288;1351309;1210866;1386496;;;;;;
603683,927;143904;1852;157696;1207762;1209834;1228288;1351666;1211686;1385984;;;;;;
603836,062;142652;6016;158720;1209834;1210330;1228288;1352486;1216346;1387008;;;;;;
604415,434;147840;7523;158208;1210330;1210329;1228288;1358170;1217852;1386496;;;;;;
604433,699;149347;12128;156672;1210329;1210330;1228288;1359676;1222458;1384960;;;;;;
604681,378;153440;5768;158208;1210330;1210330;1228288;1363770;1216098;1386496;;;;;;
605156,762;147080;8258;159744;1210330;1210330;1228288;1357410;1218588;1388032;;;;;;
605473,900;152130;8146;159232;1210330;1210330;1228288;1362460;1218476;1387520;;;;;;
605475,684;152018;14190;156672;1210330;1210330;1228288;1362348;1224520;1384960;;;;;;
605559,865;155502;5502;158208;1210330;1211258;1228288;1365832;1216760;1386496;;;;;;
605596,977;22569;4222;158720;1211258;1212210;1228288;1233827;1216432;1387008;;;;;;
605597,002;4222;0;158720;1212210;1203533;1228288;1216432;1203533;1387008;186330;186255;786432;1402762;1389788;2173440
605743,790;142336;6184;158720;1203533;1203534;1228288;1345869;1209718;1387008;;;;;;
605762,014;148520;3093;159744;1203534;1203534;1228288;1352054;1206627;1388032;;;;;;
605790,410;147477;6574;159744;1203534;1203534;1228288;1351011;1210108;1388032;;;;;;
605816,771;150958;4596;160768;1203534;1204445;1228288;1354492;1209041;1389056;;;;;;
606350,732;150516;3327;160256;1204445;1205373;1228288;1354961;1208700;1388544;;;;;;
606553,898;149247;4809;161280;1205373;1206047;1228288;1354620;1210856;1389568;;;;;;
606641,083;151753;6099;160768;1206047;1206842;1228288;1357800;1212941;1389056;;;;;;
606768,499;153043;3039;162304;1206842;1206842;1228288;1359885;1209881;1390592;;;;;;
606991,128;152543;3167;162304;1206842;1206842;1228288;1359385;1210009;1390592;;;;;;
607289,301;152671;3119;162816;1206842;1206842;1228288;1359513;1209961;1391104;;;;;;
607323,262;153135;6344;162304;1206842;1206842;1228288;1359977;1213186;1390592;;;;;;
607368,588;156360;4098;163328;1206842;1206842;1228288;1363202;1210940;1391616;;;;;;
607377,052;105947;9233;161280;1206842;1206842;1228288;1312789;1216075;1389568;;;;;;
607377,074;9233;0;161280;1206842;1209818;1228288;1216075;1209818;1389568;186632;186297;786432;1402707;1396115;2176000
607598,746;151552;4061;162816;1209818;1209819;1228288;1361370;1213880;1391104;;;;;;
607737,277;154586;5897;162816;1209819;1209819;1228288;1364405;1215716;1391104;;;;;;
607799,161;156425;6765;163840;1209819;1209819;1228288;1366244;1216584;1392128;;;;;;
608040,774;158829;6898;163328;1209819;1209819;1228288;1368648;1216717;1391616;;;;;;
608075,081;158962;5980;164352;1209819;1209819;1228288;1368781;1215799;1392640;;;;;;
608110,886;159068;5503;163840;1209819;1209819;1228288;1368887;1215322;1392128;;;;;;
608119,020;158591;5817;164864;1209819;1209819;1228288;1368410;1215636;1393152;;;;;;
608121,812;160441;7017;164864;1209819;1209819;1228288;1370260;1216836;1393152;;;;;;
608122,470;161641;9049;164352;1209819;1209819;1228288;1371460;1218868;1392640;;;;;;
608124,665;106035;10012;164864;1209819;1214939;1228288;1315854;1224951;1393152;;;;;;
608124,700;10012;0;164864;1214939;1216157;1228288;1224951;1216157;1393152;186489;186416;786432;1411440;1402573;2179584
608310,365;154112;4504;192000;1216157;1216158;1228288;1370269;1220662;1420288;;;;;;
608344,138;186264;4360;179712;1216158;1216157;1228288;1402422;1220517;1408000;;;;;;
608378,375;179464;3799;173568;1216157;1216157;1228288;1395621;1219956;1401856;;;;;;
608400,835;172759;3735;167424;1216157;1216157;1228288;1388916;1219892;1395712;;;;;;
608422,624;167063;7523;165376;1216157;1216157;1228288;1383220;1223680;1393664;;;;;;
608431,178;165219;4160;165888;1216157;1217080;1228288;1381376;1221240;1394176;;;;;;
608715,877;165440;4206;165888;1217080;1217825;1228288;1382520;1222031;1394176;;;;;;
608784,377;159342;4206;159744;1217825;1219936;1228288;1377167;1224142;1388032;;;;;;
608785,092;159342;4736;164864;1219936;1221814;1228288;1379278;1226550;1393152;;;;;;
608785,430;158848;2007;164352;1221814;1226519;1228288;1380662;1228526;1392640;;;;;;
608785,462;2007;0;164352;1226519;1215941;1285632;1228526;1215941;1449984;186555;186526;786432;1415081;1402467;2236416
608788,519;82632;7264;194048;1215942;1215942;1285632;1298574;1223206;1479680;;;;;;
608788,563;7264;0;194048;1215942;1215787;1285632;1223206;1215787;1479680;186534;186418;786432;1409740;1402205;2266112
609241,458;183726;1332;194560;1215787;1215787;1285632;1399513;1217119;1480192;;;;;;
609406,364;185140;5284;226304;1215787;1216642;1285632;1400927;1221926;1511936;;;;;;
609444,816;222372;992;227328;1216642;1218993;1285632;1439014;1219985;1512960;;;;;;
609562,594;218080;4772;260608;1218993;1219578;1285632;1437073;1224350;1546240;;;;;;
610219,780;257700;7269;250880;1219578;1220402;1285632;1477278;1227671;1536512;;;;;;
611640,706;250469;4608;239104;1220402;1221957;1285632;1470871;1226565;1524736;;;;;;
611736,666;238592;7350;232960;1221957;1222571;1285632;1460549;1229921;1518592;;;;;;
611840,671;232630;6936;223744;1222571;1223957;1285632;1455201;1230893;1509376;;;;;;
611895,211;223512;6325;215040;1223957;1225136;1285632;1447469;1231461;1500672;;;;;;
611950,476;214709;5475;206336;1225136;1225854;1285632;1439845;1231329;1491968;;;;;;
611975,784;206179;4391;198144;1225854;1226845;1285632;1432033;1231236;1483776;;;;;;
612031,943;197927;8629;195072;1226845;1226845;1285632;1424772;1235474;1480704;;;;;;
612050,409;194997;7331;187392;1226845;1226845;1285632;1421842;1234176;1473024;;;;;;
612074,442;187043;5616;179200;1226845;1228732;1285632;1413888;1234348;1464832;;;;;;
612093,739;179184;4018;171520;1228732;1230758;1285632;1407916;1234776;1457152;;;;;;
612114,994;171442;4818;166912;1230758;1230759;1285632;1402200;1235577;1452544;;;;;;
612126,431;166610;7732;164352;1230759;1230759;1285632;1397369;1238491;1449984;;;;;;
612169,836;163892;8700;206336;1230759;1232257;1285632;1394651;1240957;1491968;;;;;;
612211,432;206332;6629;197120;1232257;1233045;1285632;1438589;1239674;1482752;;;;;;
612261,726;197093;7963;192000;1233045;1233045;1285632;1430138;1241008;1477632;;;;;;
612304,531;191771;6686;184320;1233045;1233045;1285632;1424816;1239731;1469952;;;;;;
612336,510;183838;7056;178176;1233045;1233046;1285632;1416883;1240102;1463808;;;;;;
612376,688;178064;8624;173568;1233046;1233045;1285632;1411110;1241669;1459200;;;;;;
612393,662;151651;6113;171008;1233045;1234084;1285632;1384696;1240197;1456640;;;;;;
612393,685;6113;0;171008;1234084;1215058;1285632;1240197;1215058;1456640;188166;186416;786432;1428363;1401474;2243072
612419,659;164864;6148;165888;1215058;1215058;1285632;1379922;1221206;1451520;;;;;;
612475,042;165380;3312;166400;1215058;1215058;1285632;1380438;1218370;1452032;;;;;;
612511,304;166128;3617;161280;1215058;1215058;1285632;1381186;1218675;1446912;;;;;;
612641,742;160801;8437;165376;1215058;1215058;1285632;1375859;1223495;1451008;;;;;;
612660,887;155166;10171;162304;1215058;1215058;1285632;1370224;1225229;1447936;;;;;;
612660,906;10171;0;162304;1215058;1219780;1285632;1225229;1219780;1447936;186762;186427;786432;1411991;1406207;2234368
613231,014;152064;5860;159744;1219780;1219780;1285632;1371844;1225640;1445376;;;;;;
613312,899;157412;5128;163328;1219780;1219780;1285632;1377192;1224908;1448960;;;;;;
613572,208;156680;5987;163840;1219780;1219780;1285632;1376460;1225767;1449472;;;;;;
613634,925;158051;6304;163328;1219780;1219780;1285632;1377831;1226084;1448960;;;;;;
613760,986;158368;7168;164352;1219780;1219780;1285632;1378148;1226948;1449984;;;;;;
613801,715;160768;8160;164352;1219780;1219780;1285632;1380548;1227940;1449984;;;;;;
613812,626;161760;6283;164352;1219780;1219780;1285632;1381540;1226063;1449984;;;;;;
613880,492;159883;6283;164352;1219780;1219780;1285632;1379663;1226063;1449984;;;;;;
613891,823;159876;7051;164864;1219780;1219781;1285632;1379656;1226832;1450496;;;;;;
613922,881;161675;10224;164864;1219781;1221462;1285632;1381456;1231686;1450496;;;;;;
613957,621;164848;10162;160768;1221462;1221462;1285632;1386310;1231624;1446400;;;;;;
613971,936;160499;10190;160768;1221462;1221463;1285632;1381961;1231653;1446400;;;;;;
613980,928;160718;11967;160256;1221463;1221462;1285632;1382181;1233429;1445888;;;;;;
614001,378;159423;11051;158720;1221462;1221463;1285632;1380885;1232514;1444352;;;;;;
614006,529;158507;14328;157184;1221463;1223184;1285632;1379970;1237512;1442816;;;;;;
614018,901;157176;12254;155136;1223184;1224204;1285632;1380360;1236458;1440768;;;;;;
614025,937;155102;14022;156672;1224204;1225524;1285632;1379306;1239546;1442304;;;;;;
614027,091;153286;9055;157184;1225524;1226683;1285632;1378810;1235738;1442816;;;;;;
614035,760;148319;9428;165376;1226683;1227155;1285632;1375002;1236583;1451008;;;;;;
614049,911;165076;7854;158720;1227155;1228829;1285632;1392231;1236683;1444352;;;;;;
614054,719;158382;6686;156672;1228829;1229605;1285632;1387211;1236291;1442304;;;;;;
614066,407;152094;5615;151040;1229605;1230902;1285632;1381699;1236517;1436672;;;;;;
614079,203;151023;4096;158720;1230902;1232604;1285632;1381925;1236700;1444352;;;;;;
614088,135;146432;6128;158720;1232604;1232868;1285632;1379036;1238996;1444352;;;;;;
614110,135;148464;5652;159232;1232868;1233581;1285632;1381332;1239233;1444864;;;;;;
614179,231;149012;5876;159232;1233581;1234005;1285632;1382593;1239881;1444864;;;;;;
614190,441;149236;5860;160256;1234005;1234341;1285632;1383241;1240201;1445888;;;;;;
614240,685;150756;4363;159744;1234341;1235193;1285632;1385097;1239556;1445376;;;;;;
614340,492;149259;9272;160256;1235193;1235193;1285632;1384452;1244465;1445888;;;;;;
614374,125;154680;6484;160256;1235193;1235193;1285632;1389873;1241677;1445888;;;;;;
614412,309;151892;8053;161280;1235193;1235193;1285632;1387085;1243246;1446912;;;;;;
614482,422;154997;10371;160768;1235193;1235193;1285632;1390190;1245564;1446400;;;;;;
614521,742;157315;7171;161280;1235193;1235192;1285632;1392508;1242363;1446912;;;;;;
614603,981;154115;8802;160768;1235192;1235193;1285632;1389307;1243995;1446400;;;;;;
614617,615;155746;7423;161792;1235193;1235193;1285632;1390939;1242616;1447424;;;;;;
614631,821;155391;9795;161280;1235193;1235193;1285632;1390584;1244988;1446912;;;;;;
614671,225;157763;7823;162304;1235193;1235193;1285632;1392956;1243016;1447936;;;;;;
614822,148;156815;10238;161792;1235193;1235192;1285632;1392008;1245430;1447424;;;;;;
614855,766;159230;8673;162304;1235192;1235193;1285632;1394422;1243866;1447936;;;;;;
614883,496;157665;8111;161792;1235193;1235633;1285632;1392858;1243744;1447424;;;;;;
615151,154;157103;10216;161792;1235633;1236184;1285632;1392736;1246400;1447424;;;;;;
615188,013;159720;11453;161280;1236184;1236801;1285632;1395904;1248254;1446912;;;;;;
615216,422;160957;9439;161792;1236801;1236985;1285632;1397758;1246424;1447424;;;;;;
615222,126;157919;9300;161792;1236985;1237664;1285632;1394904;1246964;1447424;;;;;;
615247,691;157780;8463;162304;1237664;1238109;1285632;1395444;1246572;1447936;;;;;;
615255,739;157455;9667;161792;1238109;1238782;1285632;1395564;1248449;1447424;;;;;;
615268,506;158659;8619;162816;1238782;1239341;1285632;1397441;1247960;1448448;;;;;;
615279,700;158635;9844;162304;1239341;1239462;1285632;1397976;1249306;1447936;;;;;;
615390,429;159860;8783;162816;1239461;1239894;1285632;1399321;1248677;1448448;;;;;;
615474,502;159261;12287;162816;1239893;1241047;1285632;1399154;1253334;1448448;;;;;;
615818,377;162767;10548;159744;1241047;1241655;1285632;1403814;1252203;1445376;;;;;;
616241,310;158004;12758;160256;1241655;1241655;1285632;1399659;1254413;1445888;;;;;;
616263,333;29103;10074;161280;1241655;1241655;1285632;1270758;1251729;1446912;;;;;;
616263,360;10074;0;161280;1241655;1219582;1285632;1251729;1219582;1446912;188522;186401;786432;1440251;1405983;2233344
616294,978;146944;4868;160768;1219582;1219583;1285632;1366526;1224451;1446400;;;;;;
616350,865;151812;4144;159744;1219583;1219583;1285632;1371395;1223727;1445376;;;;;;
616672,868;149552;9744;160256;1219583;1219583;1285632;1369135;1229327;1445888;;;;;;
616691,128;155152;7416;160768;1219583;1219583;1285632;1374735;1226999;1446400;;;;;;
616748,989;153336;7685;160256;1219583;1219583;1285632;1372919;1227268;1445888;;;;;;
616775,232;153605;8499;161792;1219583;1219583;1285632;1373188;1228082;1447424;;;;;;
616822,881;156467;7952;161280;1219583;1219583;1285632;1376050;1227535;1446912;;;;;;
616877,109;155920;9395;161792;1219583;1219583;1285632;1375503;1228978;1447424;;;;;;
616938,150;157875;10915;161792;1219583;1219583;1285632;1377458;1230498;1447424;;;;;;
616984,793;159395;9118;161792;1219583;1219583;1285632;1378978;1228701;1447424;;;;;;
617073,938;157598;11875;160768;1219583;1219583;1285632;1377181;1231458;1446400;;;;;;
617213,783;160355;13815;157184;1219583;1221094;1285632;1379938;1234909;1442816;;;;;;
617308,206;157175;10640;159232;1221094;1221094;1285632;1378269;1231734;1444864;;;;;;
617318,678;154000;10878;159744;1221094;1221094;1285632;1375094;1231972;1445376;;;;;;
617429,085;155262;12632;157184;1221094;1221094;1285632;1376356;1233726;1442816;;;;;;
617457,395;157016;10236;159744;1221094;1222342;1285632;1378110;1232578;1445376;;;;;;
617536,757;154108;13980;159232;1222342;1222943;1285632;1376450;1236923;1444864;;;;;;
617543,923;157852;12446;158208;1222943;1223623;1285632;1380795;1236069;1443840;;;;;;
617554,142;154782;9682;158720;1223623;1224127;1285632;1378405;1233809;1444352;;;;;;
617557,746;152018;8047;159232;1224127;1225760;1285632;1376145;1233807;1444864;;;;;;
617592,012;151407;8116;159232;1225760;1226662;1285632;1377167;1234778;1444864;;;;;;
617599,091;151476;9254;159744;1226662;1227621;1285632;1378138;1236875;1445376;;;;;;
617602,680;153126;6172;159232;1227621;1228754;1285632;1380747;1234926;1444864;;;;;;
617609,726;150044;6783;159744;1228754;1229042;1285632;1378798;1235825;1445376;;;;;;
617612,600;151167;7151;159744;1229042;1229573;1285632;1380209;1236724;1445376;;;;;;
617629,651;151535;6611;159744;1229573;1230797;1285632;1381108;1237408;1445376;;;;;;
617639,272;150995;5935;159744;1230797;1231189;1285632;1381792;1237124;1445376;;;;;;
617654,760;150319;5199;160256;1231189;1231725;1285632;1381508;1236924;1445888;;;;;;
617666,547;150607;5199;160256;1231725;1232662;1285632;1382332;1237861;1445888;;;;;;
617679,580;150607;4912;160256;1232662;1233776;1285632;1383269;1238688;1445888;;;;;;
617699,999;150320;4592;160256;1233776;1234679;1285632;1384096;1239271;1445888;;;;;;
617718,964;150000;5540;160768;1234679;1235122;1285632;1384679;1240662;1446400;;;;;;
617759,366;151460;4000;160256;1235122;1235121;1285632;1386582;1239121;1445888;;;;;;
617789,789;149918;6993;161792;1235122;1235121;1285632;1385040;1242114;1447424;;;;;;
617810,775;154449;8008;160768;1235121;1235121;1285632;1389570;1243129;1446400;;;;;;
617842,813;155464;6496;162304;1235121;1235121;1285632;1390585;1241617;1447936;;;;;;
617886,437;155488;7476;161792;1235121;1235121;1285632;1390609;1242597;1447424;;;;;;
617900,750;156468;7313;163328;1235121;1235121;1285632;1391589;1242434;1448960;;;;;;
617921,156;158353;6496;162816;1235121;1235121;1285632;1393474;1241617;1448448;;;;;;
617946,796;157536;7168;163840;1235121;1235121;1285632;1392657;1242289;1449472;;;;;;
617977,003;159232;10372;162816;1235121;1235121;1285632;1394353;1245493;1448448;;;;;;
618001,610;162436;8896;162816;1235121;1235121;1285632;1397557;1244017;1448448;;;;;;
618097,964;159424;8160;162816;1235121;1235121;1285632;1394545;1243281;1448448;;;;;;
618127,894;158688;9437;162304;1235121;1235121;1285632;1393809;1244558;1447936;;;;;;
618169,522;159965;12280;162816;1235121;1235626;1285632;1395086;1247906;1448448;;;;;;
618190,767;162808;12259;157696;1235626;1236538;1285632;1398434;1248797;1443328;;;;;;
618200,329;157667;9771;160256;1236538;1237483;1285632;1394205;1247254;1445888;;;;;;
618219,160;155179;10979;160256;1237483;1237484;1285632;1392662;1248463;1445888;;;;;;
618229,526;156387;9855;160256;1237484;1237483;1285632;1393871;1247338;1445888;;;;;;
618242,436;155263;10240;160256;1237483;1237967;1285632;1392746;1248207;1445888;;;;;;
618250,202;155648;9506;160256;1237967;1238567;1285632;1393615;1248073;1445888;;;;;;
618264,467;154914;10431;160768;1238567;1238887;1285632;1393481;1249318;1446400;;;;;;
618280,342;156863;10675;160768;1238887;1239271;1285632;1395750;1249946;1446400;;;;;;
618297,995;157107;12244;159744;1239271;1239567;1285632;1396378;1251811;1445376;;;;;;
618311,751;157652;11443;160256;1239567;1239863;1285632;1397219;1251306;1445888;;;;;;
618320,162;156851;11559;160256;1239863;1240718;1285632;1396714;1252277;1445888;;;;;;
618332,200;156920;10799;160256;1240717;1240942;1285632;1397637;1251741;1445888;;;;;;
618346,699;156207;9823;160768;1240942;1241214;1285632;1397149;1251037;1446400;;;;;;
618369,440;155743;9871;160256;1241214;1241588;1285632;1396957;1251459;1445888;;;;;;
618375,657;155791;10152;161280;1241588;1242484;1285632;1397379;1252636;1446912;;;;;;
618399,463;157608;12453;160256;1242484;1243059;1285632;1400092;1255512;1445888;;;;;;
618412,084;159909;9696;161280;1243059;1243606;1285632;1402968;1253302;1446912;;;;;;
618425,077;156640;12117;160768;1243606;1244070;1285632;1400246;1256187;1446400;;;;;;
618434,086;158977;8816;160768;1244070;1244582;1285632;1403047;1253398;1446400;;;;;;
618451,571;155248;11444;160768;1244582;1244758;1285632;1399830;1256202;1446400;;;;;;
618463,962;157876;9936;161280;1244758;1244918;1285632;1402634;1254854;1446912;;;;;;
618482,252;156880;12350;160768;1244918;1245334;1285632;1401798;1257684;1446400;;;;;;
618506,551;159294;9312;160768;1245334;1245630;1285632;1404628;1254942;1446400;;;;;;
618513,439;155744;8736;160768;1245630;1246478;1285632;1401374;1255214;1446400;;;;;;
618518,292;155109;9494;161280;1246478;1246887;1285632;1401587;1256381;1446912;;;;;;
618543,471;156438;11326;160768;1246887;1247831;1285632;1403325;1259157;1446400;;;;;;
618553,775;158270;11380;160256;1247831;1248230;1285632;1406101;1259610;1445888;;;;;;
618569,019;157812;11352;160768;1248230;1249062;1285632;1406042;1260414;1446400;;;;;;
618580,282;157784;10835;161280;1249062;1250007;1285632;1406846;1260842;1446912;;;;;;
618616,532;157779;9507;160768;1250007;1250892;1285632;1407786;1260399;1446400;;;;;;
618652,602;156451;7295;161280;1250892;1251916;1285632;1407343;1259211;1446912;;;;;;
618686,925;154751;10897;161280;1251916;1252124;1285632;1406667;1263021;1446912;;;;;;
618735,763;158353;11158;161280;1252124;1252124;1285632;1410477;1263282;1446912;;;;;;
618771,347;158614;9455;161280;1252124;1252124;1285632;1410738;1261579;1446912;;;;;;
618778,416;156911;8911;161280;1252124;1252124;1285632;1409035;1261035;1446912;;;;;;
618787,348;156367;10160;161280;1252124;1252356;1285632;1408491;1262516;1446912;;;;;;
618796,318;157616;8513;161792;1252356;1253788;1285632;1409972;1262301;1447424;;;;;;
618807,065;156993;10056;161792;1253788;1255011;1285632;1410781;1265067;1447424;;;;;;
618828,986;158536;7377;161280;1255011;1256444;1285632;1413547;1263821;1446912;;;;;;
618846,124;155857;7923;161792;1256444;1256748;1285632;1412301;1264671;1447424;;;;;;
618853,230;156403;6287;161792;1256748;1257164;1285632;1413151;1263451;1447424;;;;;;
618859,697;154767;5695;161792;1257164;1257756;1285632;1411931;1263451;1447424;;;;;;
618878,029;154175;6927;161792;1257756;1258596;1285632;1411931;1265523;1447424;;;;;;
618925,973;155407;5340;161792;1258596;1258964;1285632;1414003;1264304;1447424;;;;;;
618937,235;153820;8440;161792;1258964;1259243;1285632;1412784;1267683;1447424;;;;;;
618944,035;156920;7452;161792;1259243;1259989;1285632;1416163;1267441;1447424;;;;;;
618953,626;155874;6453;162304;1259989;1260628;1285632;1415863;1267081;1447936;;;;;;
618967,281;155957;5644;162304;1260628;1261290;1285632;1416585;1266934;1447936;;;;;;
618971,907;155148;3739;162304;1261290;1262130;1285632;1416438;1265869;1447936;;;;;;
618986,895;153243;6111;162304;1262130;1262775;1285632;1415373;1268886;1447936;;;;;;
618999,744;155615;8251;162816;1262775;1263527;1285632;1418390;1271778;1448448;;;;;;
619002,420;158267;6723;162304;1263527;1265191;1285632;1421794;1271914;1447936;;;;;;
619006,764;156739;4678;162816;1265191;1267158;1285632;1421930;1271836;1448448;;;;;;
619018,624;155206;2803;162816;1267158;1269662;1285632;1422364;1272465;1448448;;;;;;
619023,376;153331;4482;162816;1269662;1270596;1285632;1422993;1275078;1448448;;;;;;
619034,847;155010;1728;162816;1270596;1273036;1285632;1425606;1274764;1448448;;;;;;
619041,472;152256;5077;163328;1273036;1273748;1285632;1425292;1278825;1448960;;;;;;
619046,857;156117;2464;162816;1273748;1276004;1285632;1429865;1278468;1448448;;;;;;
619051,409;153504;5180;163840;1276004;1277041;1285632;1429508;1282221;1449472;;;;;;
619053,600;157244;5680;163328;1277041;1277746;1285632;1434285;1283426;1448960;;;;;;
619058,963;157744;6092;164352;1277746;1278300;1285632;1435490;1284392;1449984;;;;;;
619065,825;159692;3980;164352;1278300;1279396;1285632;1437992;1283376;1449984;;;;;;
619072,808;157580;1056;163840;1279396;1281372;1285632;1436976;1282428;1449472;;;;;;
619081,506;154656;3808;164352;1281372;1281820;1285632;1436028;1285628;1449984;;;;;;
619085,751;157408;1589;164864;1281820;1284196;1285632;1439228;1285785;1450496;;;;;;
619085,786;1589;0;164864;1284196;1240378;1308672;1285785;1240378;1473536;193197;186498;786432;1478982;1426876;2259968
619092,263;154624;1922;164864;1240378;1240378;1308672;1395002;1242300;1473536;;;;;;
619097,841;156546;1348;164864;1240378;1241331;1308672;1396924;1242679;1473536;;;;;;
619101,840;155972;6611;161280;1241331;1241820;1308672;1397303;1248431;1469952;;;;;;
619113,158;161235;5286;164864;1241820;1243690;1308672;1403055;1248976;1473536;;;;;;
619122,310;159398;4164;164352;1243690;1244942;1308672;1403088;1249106;1473024;;;;;;
619135,611;158276;7043;164352;1244942;1245673;1308672;1403218;1252716;1473024;;;;;;
619139,815;161667;6885;161792;1245673;1246626;1308672;1407340;1253511;1470464;;;;;;
619146,676;161509;4083;164864;1246626;1247962;1308672;1408135;1252045;1473536;;;;;;
619157,538;158195;3985;164352;1247962;1248858;1308672;1406157;1252843;1473024;;;;;;
619177,623;158097;864;165376;1248858;1251402;1308672;1406955;1252266;1474048;;;;;;
619185,505;156512;3524;165376;1251402;1251610;1308672;1407914;1255134;1474048;;;;;;
619220,662;159172;3168;165888;1251610;1252066;1308672;1410782;1255234;1474560;;;;;;
619225,421;159328;960;165376;1252066;1254114;1308672;1411394;1255074;1474048;;;;;;
619241,177;157120;4484;165888;1254114;1254458;1308672;1411234;1258942;1474560;;;;;;
619249,333;161156;4172;165888;1254458;1254971;1308672;1415614;1259143;1474560;;;;;;
619264,114;160844;2311;166912;1254971;1257284;1308672;1415815;1259595;1475584;;;;;;
619281,223;160519;4221;166400;1257284;1257644;1308672;1417803;1261865;1475072;;;;;;
619287,045;162429;4308;166912;1257644;1258260;1308672;1420073;1262568;1475584;;;;;;
619304,469;163028;3460;166912;1258260;1258940;1308672;1421288;1262400;1475584;;;;;;
619310,768;162180;4445;167424;1258940;1259300;1308672;1421120;1263745;1476096;;;;;;
619324,766;164189;5716;167424;1259300;1260317;1308672;1423489;1266033;1476096;;;;;;
619340,565;165460;5667;166400;1260317;1261298;1308672;1425777;1266965;1475072;;;;;;
619356,985;164387;5378;166912;1261298;1262145;1308672;1425685;1267523;1475584;;;;;;
619373,804;164098;1216;166912;1262145;1264273;1308672;1426243;1265489;1475584;;;;;;
619380,405;159936;993;166912;1264273;1264585;1308672;1424209;1265578;1475584;;;;;;
619389,150;159713;2848;166912;1264585;1264865;1308672;1424298;1267713;1475584;;;;;;
619400,663;161568;5390;166912;1264865;1265805;1308672;1426433;1271195;1475584;;;;;;
619413,232;164110;7243;164864;1265805;1267019;1308672;1429915;1274262;1473536;;;;;;
619421,574;163915;6068;165888;1267019;1268187;1308672;1430934;1274255;1474560;;;;;;
619437,433;162740;5203;165888;1268187;1269399;1308672;1430927;1274602;1474560;;;;;;
619449,672;161875;5112;165888;1269399;1269822;1308672;1431274;1274934;1474560;;;;;;
619465,512;161784;5760;165888;1269822;1271070;1308672;1431606;1276830;1474560;;;;;;
619472,889;162432;4947;165888;1271070;1272238;1308672;1433502;1277185;1474560;;;;;;
619481,160;80556;6688;165376;1272237;1274670;1308672;1352793;1281358;1474048;;;;;;
619481,185;6688;0;165376;1274670;1251403;1308672;1281358;1251403;1474048;188193;186918;786432;1469551;1438321;2260480
619520,768;156672;1680;165888;1251403;1251403;1308672;1408075;1253083;1474560;;;;;;
619541,782;158352;1469;165888;1251403;1251700;1308672;1409755;1253169;1474560;;;;;;
619571,680;158141;4240;165888;1251700;1251700;1308672;1409841;1255940;1474560;;;;;;
619586,116;160912;6458;165376;1251700;1251701;1308672;1412612;1258159;1474048;;;;;;
619601,598;163130;6660;163840;1251701;1251700;1308672;1414831;1258360;1472512;;;;;;
619622,829;163332;5504;165888;1251700;1251700;1308672;1415032;1257204;1474560;;;;;;
619635,436;84810;5131;165376;1251701;1256821;1308672;1336511;1261952;1474048;;;;;;
619635,456;5131;0;165376;1256821;1248123;1308672;1261952;1248123;1474048;187253;186519;786432;1449205;1434642;2260480
619669,053;156160;5987;165888;1248123;1248123;1308672;1404283;1254110;1474560;;;;;;
619678,087;162659;6583;165888;1248123;1248124;1308672;1410782;1254707;1474560;;;;;;
619687,655;163194;5443;165888;1248124;1248123;1308672;1411318;1253566;1474560;;;;;;
619720,276;162115;5823;165888;1248123;1248123;1308672;1410238;1253946;1474560;;;;;;
619747,581;162495;5103;166400;1248123;1248123;1308672;1410618;1253226;1475072;;;;;;
619760,697;162287;5999;165888;1248123;1248123;1308672;1410410;1254122;1474560;;;;;;
619948,297;163183;8422;164352;1248123;1248124;1308672;1411306;1256546;1473024;;;;;;
619968,598;164070;9722;165376;1248124;1248484;1308672;1412194;1258206;1474048;;;;;;
619987,067;33013;6778;163328;1248484;1253604;1308672;1281497;1260382;1472000;;;;;;
619987,098;6778;0;163328;1253604;1249680;1308672;1260382;1249680;1472000;186854;186516;786432;1447236;1436196;2258432
620156,866;89943;6768;164352;1249680;1249680;1308672;1339623;1256448;1473024;;;;;;
620156,888;6768;0;164352;1249680;1250200;1308672;1256448;1250200;1473024;186516;186516;786432;1442964;1436716;2259456
620231,719;153600;960;163840;1250200;1250200;1308672;1403800;1251160;1472512;;;;;;
620345,227;154560;5972;164352;1250200;1250201;1308672;1404760;1256173;1473024;;;;;;
620398,978;159572;5759;164864;1250201;1250201;1308672;1409773;1255960;1473536;;;;;;
620587,627;159871;5801;164352;1250201;1250201;1308672;1410072;1256002;1473024;;;;;;
620646,245;159913;5391;165888;1250201;1250201;1308672;1410114;1255592;1474560;;;;;;
620790,812;161551;6646;165376;1250201;1250201;1308672;1411752;1256847;1474048;;;;;;
620823,599;162806;7657;164864;1250201;1250200;1308672;1413007;1257857;1473536;;;;;;
620843,423;163305;8118;163840;1250200;1250201;1308672;1413505;1258319;1472512;;;;;;
620849,504;163766;8660;163840;1250201;1250201;1308672;1413967;1258861;1472512;;;;;;
620857,996;162260;10525;164352;1250201;1250201;1308672;1412461;1260726;1473024;;;;;;
620879,776;164125;9935;160256;1250201;1250201;1308672;1414326;1260136;1468928;;;;;;
620902,970;159439;12039;161792;1250201;1250201;1308672;1409640;1262240;1470464;;;;;;
620922,604;161543;8014;161792;1250201;1250546;1308672;1411744;1258560;1470464;;;;;;
620971,391;156494;8668;161792;1250546;1251627;1308672;1407040;1260295;1470464;;;;;;
621007,606;157148;12218;159744;1251627;1251627;1308672;1408775;1263845;1468416;;;;;;
621029,930;158650;8080;160768;1251627;1251628;1308672;1410277;1259708;1469440;;;;;;
621056,637;154487;10947;160256;1251658;1251659;1308672;1406145;1262606;1468928;;;;;;
621068,454;157379;13012;159744;1251660;1252124;1308672;1409039;1265136;1468416;;;;;;
621078,974;159444;9791;160256;1252124;1252309;1308672;1411568;1262100;1468928;;;;;;
621094,820;154687;9080;159744;1252309;1252718;1308672;1406996;1261798;1468416;;;;;;
621127,978;153976;10897;159744;1252718;1252853;1308672;1406694;1263750;1468416;;;;;;
621142,903;156305;11225;160256;1252853;1253302;1308672;1409158;1264527;1468928;;;;;;
621158,684;156633;9567;160768;1253302;1253797;1308672;1409935;1263364;1469440;;;;;;
621256,826;155487;8558;160256;1253797;1254486;1308672;1409284;1263044;1468928;;;;;;
621278,184;154478;11107;160768;1254486;1254805;1308672;1408964;1265912;1469440;;;;;;
621338,209;157539;9071;160768;1254805;1255716;1308672;1412344;1264787;1469440;;;;;;
621354,648;155503;8094;161280;1255716;1256012;1308672;1411219;1264106;1469952;;;;;;
621399,635;155550;11732;159232;1256012;1256100;1308672;1411562;1267832;1467904;;;;;;
621419,507;159188;10291;161280;1256100;1256404;1308672;1415288;1266695;1469952;;;;;;
621470,079;157235;8126;160768;1256404;1257100;1308672;1413639;1265226;1469440;;;;;;
621500,048;155070;11332;160256;1257100;1257124;1308672;1412170;1268456;1468928;;;;;;
621514,002;157764;8542;160768;1257124;1257237;1308672;1414888;1265779;1469440;;;;;;
621523,081;154974;7935;161280;1257237;1257876;1308672;1412211;1265811;1469952;;;;;;
621542,243;155391;11751;159232;1257876;1257908;1308672;1413267;1269659;1467904;;;;;;
621552,958;159207;10754;160768;1257908;1257988;1308672;1417115;1268742;1469440;;;;;;
621559,096;157186;9730;160768;1257988;1258507;1308672;1415174;1268237;1469440;;;;;;
621583,918;156162;13805;158208;1258507;1259837;1308672;1414669;1273642;1466880;;;;;;
621596,446;158189;11140;159744;1259837;1260317;1308672;1418026;1271457;1468416;;;;;;
621605,692;155524;12324;159744;1260317;1261021;1308672;1415841;1273345;1468416;;;;;;
621608,568;156708;11532;159744;1261021;1262269;1308672;1417729;1273801;1468416;;;;;;
621628,699;155916;10277;160256;1262269;1263164;1308672;1418185;1273441;1468928;;;;;;
621634,979;155173;8177;159744;1263164;1263652;1308672;1418337;1271829;1468416;;;;;;
621641,871;153073;10331;160768;1263652;1265005;1308672;1416725;1275336;1469440;;;;;;
621645,726;141436;14304;160256;1265005;1267130;1308672;1406441;1281434;1468928;;;;;;
621645,759;14304;0;160256;1267130;1250014;1308672;1281434;1250014;1468928;189043;186647;786432;1470477;1436661;2255360
621648,987;145920;4152;156160;1250014;1250015;1308672;1395934;1254167;1464832;;;;;;
621649,161;145464;7773;158208;1250015;1250015;1308672;1395479;1257788;1466880;;;;;;
621654,983;149085;5575;184320;1250015;1250015;1308672;1399100;1255590;1492992;;;;;;
621668,067;173511;3502;184832;1250015;1250196;1308672;1423526;1253698;1493504;;;;;;
621680,082;171438;3712;215040;1250196;1251090;1308672;1421634;1254802;1523712;;;;;;
621702,581;201856;1792;215552;1251090;1253867;1308672;1452946;1255659;1524224;;;;;;
621723,108;199936;1120;248832;1253867;1254676;1308672;1453803;1255796;1557504;;;;;;
621740,356;232544;3376;226304;1254676;1254955;1308672;1487220;1258331;1534976;;;;;;
621752,953;226096;4437;222720;1254955;1255628;1308672;1481051;1260065;1531392;;;;;;
621784,788;218965;1312;207872;1255628;1257707;1308672;1474593;1259019;1516544;;;;;;
621819,335;207648;928;206336;1257707;1258251;1308672;1465355;1259179;1515008;;;;;;
621846,450;199584;4784;196608;1258251;1258723;1308672;1457835;1263507;1505280;;;;;;
621891,727;196272;7324;192512;1258723;1259753;1308672;1454995;1267077;1501184;;;;;;
621923,886;192155;1959;180224;1259753;1262145;1308672;1451908;1264104;1488896;;;;;;
621937,938;180135;3680;178176;1262145;1262529;1308672;1442280;1266209;1486848;;;;;;
621964,308;175712;1124;167424;1262529;1264968;1308672;1438241;1266092;1476096;;;;;;
621987,131;167012;4685;165888;1264968;1264968;1308672;1431980;1269653;1474560;;;;;;
622011,909;164941;4717;159744;1264968;1264968;1308672;1429909;1269685;1468416;;;;;;
622024,772;159341;8842;158720;1264968;1264968;1308672;1424309;1273810;1467392;;;;;;
622044,862;158346;7187;159744;1264968;1264968;1308672;1423314;1272155;1468416;;;;;;
622057,333;159251;7408;161792;1264968;1264968;1308672;1424219;1272376;1470464;;;;;;
622065,458;155888;6451;161792;1264968;1264968;1308672;1420856;1271419;1470464;;;;;;
622074,866;154931;7003;162304;1264968;1265920;1308672;1419899;1272923;1470976;;;;;;
622086,752;156507;6483;162304;1265920;1266704;1308672;1422427;1273187;1470976;;;;;;
622095,583;155987;5521;163328;1266704;1268338;1308672;1422691;1273859;1472000;;;;;;
622112,556;156561;5964;162816;1268338;1269219;1308672;1424899;1275183;1471488;;;;;;
622121,441;157004;5872;164352;1269219;1269618;1308672;1426223;1275490;1473024;;;;;;
622137,640;158960;3519;163840;1269618;1270748;1308672;1428578;1274267;1472512;;;;;;
622148,923;156607;1688;164352;1270748;1272675;1308672;1427355;1274363;1473024;;;;;;
622166,395;155288;4643;164352;1272675;1273116;1308672;1427963;1277759;1473024;;;;;;
622170,396;158243;4496;165376;1273116;1273116;1308672;1431359;1277612;1474048;;;;;;
622188,441;53295;7008;164864;1273116;1275635;1308672;1326411;1282643;1473536;;;;;;
622188,471;7008;0;164864;1275635;1254755;1308672;1282643;1254755;1473536;187667;186662;786432;1470310;1441417;2259968
622207,174;155136;5972;164864;1254755;1254755;1308672;1409891;1260727;1473536;;;;;;
622306,968;160596;3120;164864;1254755;1255538;1308672;1415351;1258658;1473536;;;;;;
622331,515;157744;5805;165376;1255538;1255538;1308672;1413282;1261343;1474048;;;;;;
622349,531;161453;3986;165376;1255538;1255539;1308672;1416991;1259525;1474048;;;;;;
622371,515;159634;4559;165888;1255539;1255538;1308672;1415173;1260097;1474560;;;;;;
622457,449;160719;8410;164864;1255538;1255538;1308672;1416257;1263948;1473536;;;;;;
622475,002;164570;7731;164864;1255538;1255539;1308672;1420108;1263270;1473536;;;;;;
622506,737;162355;7151;161792;1255539;1255538;1308672;1417894;1262689;1470464;;;;;;
622519,713;161775;9809;162304;1255538;1255538;1308672;1417313;1265347;1470976;;;;;;
622527,059;161361;8399;163328;1255538;1255538;1308672;1416899;1263937;1472000;;;;;;
622548,086;159951;11434;160256;1255538;1255539;1308672;1415489;1266973;1468928;;;;;;
622582,524;159914;13267;161792;1255539;1255914;1308672;1415453;1269181;1470464;;;;;;
622593,269;161747;10671;157696;1255914;1255914;1308672;1417661;1266585;1466368;;;;;;
622609,361;155055;9519;159744;1255914;1256386;1308672;1410969;1265905;1468416;;;;;;
622652,155;153903;9327;159744;1256386;1256979;1308672;1410289;1266306;1468416;;;;;;
622669,611;153711;9601;159744;1256979;1256979;1308672;1410690;1266580;1468416;;;;;;
622678,278;153985;9777;160256;1256979;1256979;1308672;1410964;1266756;1468928;;;;;;
622742,128;133718;14843;160256;1256980;1257919;1308672;1390698;1272762;1468928;;;;;;
622742,161;14843;0;160256;1257919;1261240;1308672;1272762;1261240;1468928;187350;186672;786432;1460112;1447912;2255360
622798,911;145408;3008;155648;1261240;1261240;1308672;1406648;1264248;1464320;;;;;;
622815,441;143808;5792;158208;1261240;1261240;1308672;1405048;1267032;1466880;;;;;;
622815,611;146592;9232;158720;1261240;1261240;1308672;1407832;1270472;1467392;;;;;;
622815,787;151056;12640;158208;1261240;1261240;1308672;1412296;1273880;1466880;;;;;;
622815,942;154464;15792;185856;1261240;1261240;1308672;1415704;1277032;1494528;;;;;;
622816,162;184210;3337;187392;1261240;1261240;1308672;1445450;1264577;1496064;;;;;;
622816,465;81608;11256;220672;1261241;1261241;1308672;1342849;1272497;1529344;;;;;;
622816,506;11256;0;220672;1261241;1263926;1308672;1272497;1263926;1529344;186791;186675;786432;1459288;1450601;2315776
622884,798;201728;7096;220672;1263926;1263926;1308672;1465654;1271022;1529344;;;;;;
623007,147;208824;8041;257536;1263926;1263927;1308672;1472750;1271968;1566208;;;;;;
623094,695;249193;8333;258560;1263927;1263927;1308672;1513120;1272260;1567232;;;;;;
623164,571;249485;8939;301568;1263927;1263927;1308672;1513412;1272866;1610240;;;;;;
623194,947;296171;9537;303104;1263927;1263926;1308672;1560098;1273463;1611776;;;;;;
623212,977;296769;6063;352768;1263926;1265942;1308672;1560695;1272005;1661440;;;;;;
623250,508;345519;5680;354816;1265942;1267589;1308672;1611461;1273269;1663488;;;;;;
623293,516;345136;5382;410624;1267589;1268784;1308672;1612725;1274166;1719296;;;;;;
623317,504;402694;9007;412672;1268784;1270295;1308672;1671478;1279302;1721344;;;;;;
623359,996;406319;6261;387072;1270295;1271993;1308672;1676614;1278254;1695744;;;;;;
623397,801;386677;1472;366080;1271993;1274862;1308672;1658670;1276334;1674752;;;;;;
623424,719;366016;6084;355328;1274862;1275302;1308672;1640878;1281386;1664000;;;;;;
623476,177;355268;6312;341504;1275302;1276254;1308672;1630570;1282566;1650176;;;;;;
623851,316;341160;9022;330240;1276254;1277410;1308672;1617414;1286432;1638912;;;;;;
623931,678;330046;4867;312832;1277410;1279125;1308672;1607456;1283992;1621504;;;;;;
623971,537;312579;4726;300544;1279125;1280379;1308672;1591704;1285105;1609216;;;;;;
624042,217;300150;6149;290304;1280379;1280380;1308672;1580529;1286529;1598976;;;;;;
624206,980;289797;11424;284160;1280380;1280380;1308672;1570177;1291804;1592832;;;;;;
624267,838;167045;12479;285184;1280380;1280380;1308672;1447425;1292859;1593856;;;;;;
624267,863;12479;0;285184;1280380;1260773;1308672;1292859;1260773;1593856;187850;186616;786432;1480709;1447389;2380288
624302,210;272384;1552;263680;1260773;1260774;1308672;1533157;1262326;1572352;;;;;;
624336,265;263184;8153;259584;1260774;1260774;1308672;1523958;1268927;1568256;;;;;;
624367,639;259545;5521;247296;1260774;1260774;1308672;1520319;1266295;1555968;;;;;;
624413,508;219402;13616;255488;1260774;1260774;1308672;1480176;1274390;1564160;;;;;;
624413,533;13616;0;255488;1260774;1263103;1308672;1274390;1263103;1564160;186951;186732;786432;1461341;1449835;2350592
624595,756;241664;5588;238080;1263103;1263103;1308672;1504767;1268691;1546752;;;;;;
624811,240;238036;6691;230912;1263103;1263104;1308672;1501139;1269795;1539584;;;;;;
624897,260;230435;6334;222208;1263104;1263103;1308672;1493539;1269437;1530880;;;;;;
624970,088;221886;9179;216576;1263103;1263104;1308672;1484989;1272283;1525248;;;;;;
625011,964;216539;6836;206848;1263104;1263103;1308672;1479643;1269939;1515520;;;;;;
625039,006;206516;9162;201728;1263103;1263104;1308672;1469619;1272266;1510400;;;;;;
625079,693;201674;11697;197120;1263104;1263104;1308672;1464778;1274801;1505792;;;;;;
625123,603;197041;9426;188416;1263104;1263104;1308672;1460145;1272530;1497088;;;;;;
625141,273;188114;8672;181248;1263104;1264672;1308672;1451218;1273344;1489920;;;;;;
625188,525;181216;7824;174592;1264672;1264672;1308672;1445888;1272496;1483264;;;;;;
625296,490;174224;9651;170496;1264672;1264671;1308672;1438896;1274322;1479168;;;;;;
625536,710;170419;10721;165888;1264671;1264672;1308672;1435090;1275393;1474560;;;;;;
625599,483;165857;8675;158720;1264672;1268074;1308672;1430529;1276749;1467392;;;;;;
625636,672;103139;15350;165376;1268073;1268872;1308672;1371212;1284222;1474048;;;;;;
625636,703;15350;0;165376;1268872;1257505;1308672;1284222;1257505;1474048;187737;186616;786432;1471959;1444121;2260480
625665,834;150016;5422;150528;1257505;1257505;1308672;1407521;1262927;1459200;;;;;;
625786,244;150318;6603;295936;1257505;1257506;1308672;1407823;1264109;1604608;;;;;;
625859,822;295883;9323;287232;1257506;1257506;1308672;1553389;1266829;1595904;;;;;;
625943,209;52192;10693;288256;1257506;1257505;1308672;1309698;1268198;1596928;;;;;;
625943,242;10693;0;288256;1257505;1254728;1308672;1268198;1254728;1596928;186784;186596;786432;1454982;1441324;2383360
626022,240;277504;6512;273408;1254728;1254729;1308672;1532232;1261241;1582080;;;;;;
626176,386;273264;5956;262656;1254729;1254729;1308672;1527993;1260685;1571328;;;;;;
626362,079;262468;4559;251392;1254729;1254728;1308672;1517197;1259287;1560064;;;;;;
626481,390;251343;6516;243712;1254728;1254728;1308672;1506071;1261244;1552384;;;;;;
626598,343;243572;6161;234496;1254728;1254729;1308672;1498300;1260890;1543168;;;;;;
626637,807;234001;10761;230400;1254729;1254729;1308672;1488730;1265490;1539072;;;;;;
626776,037;229897;8821;220160;1254729;1254728;1308672;1484626;1263549;1528832;;;;;;
626862,587;219765;9161;212480;1254728;1254729;1308672;1474493;1263890;1521152;;;;;;
626924,063;212425;9668;205312;1254729;1254728;1308672;1467154;1264396;1513984;;;;;;
626939,015;205252;9662;198144;1254728;1254728;1308672;1459980;1264390;1506816;;;;;;
627001,128;198078;9710;191488;1254728;1261631;1308672;1452806;1271341;1500160;;;;;;
627022,217;191470;10082;185344;1261631;1261631;1308672;1453101;1271713;1494016;;;;;;
627051,094;185186;10082;179200;1261631;1261631;1308672;1446817;1271713;1487872;;;;;;
627085,443;179042;15110;178688;1261631;1261631;1308672;1440673;1276741;1487360;;;;;;
627403,314;178438;6642;164352;1261631;1267342;1308672;1440069;1273984;1473024;;;;;;
627432,317;164338;10990;163840;1267342;1267998;1308672;1431680;1278988;1472512;;;;;;
627460,331;163566;7939;155648;1267998;1267998;1308672;1431564;1275937;1464320;;;;;;
627489,515;155395;7713;151040;1267998;1268014;1308672;1423393;1275727;1459712;;;;;;
627553,638;150561;8433;163840;1268014;1268355;1308672;1418575;1276788;1472512;;;;;;
627705,106;163569;12446;162816;1268355;1268665;1308672;1431924;1281111;1471488;;;;;;
627778,804;162462;11173;156160;1268665;1269287;1308672;1431127;1280460;1464832;;;;;;
627794,334;156069;10117;156672;1269287;1269823;1308672;1425356;1279940;1465344;;;;;;
627805,596;156549;8737;159744;1269823;1269879;1308672;1426372;1278616;1468416;;;;;;
627827,151;152609;9456;159232;1269879;1270047;1308672;1422488;1279503;1467904;;;;;;
627848,534;153328;9024;160256;1270047;1270385;1308672;1423375;1279409;1468928;;;;;;
627873,573;154432;11938;160256;1270385;1270964;1308672;1424817;1282902;1468928;;;;;;
627913,149;157346;10946;160256;1270964;1270980;1308672;1428310;1281926;1468928;;;;;;
627945,395;156354;11490;160256;1270980;1270996;1308672;1427334;1282486;1468928;;;;;;
627952,123;156898;10670;160256;1270996;1271556;1308672;1427894;1282226;1468928;;;;;;
627997,666;156078;11796;160256;1271556;1271905;1308672;1427634;1283701;1468928;;;;;;
628020,888;157204;11763;160256;1271905;1272824;1308672;1429109;1284587;1468928;;;;;;
628036,386;157171;14497;160256;1272824;1273168;1308672;1429995;1287665;1468928;;;;;;
628047,628;159420;14763;156160;1273168;1273399;1308672;1432588;1288162;1464832;;;;;;
628078,075;156064;12222;158208;1273400;1273744;1308672;1429464;1285966;1466880;;;;;;
628094,476;153534;10781;158720;1273744;1274808;1308672;1427278;1285589;1467392;;;;;;
628101,192;153117;13105;158720;1274808;1275503;1308672;1427925;1288608;1467392;;;;;;
628164,978;155441;11484;159232;1275503;1276303;1308672;1430944;1287787;1467904;;;;;;
628216,666;154332;9303;158720;1276303;1276424;1308672;1430635;1285727;1467392;;;;;;
628228,333;152151;11962;159232;1276424;1276423;1308672;1428575;1288385;1467904;;;;;;
628254,438;155322;12897;159232;1276423;1276952;1308672;1431745;1289849;1467904;;;;;;
628329,664;155978;9540;159232;1276952;1278161;1308672;1432930;1287701;1467904;;;;;;
628356,082;152900;12601;159232;1278161;1278161;1308672;1431061;1290762;1467904;;;;;;
628390,863;155961;10281;159232;1278161;1278385;1308672;1434122;1288666;1467904;;;;;;
628431,508;153641;9384;159232;1278385;1278888;1308672;1432026;1288272;1467904;;;;;;
628588,521;152744;11008;159744;1278888;1279537;1308672;1431632;1290545;1468416;;;;;;
628662,171;155392;9848;159744;1279537;1279962;1308672;1434929;1289810;1468416;;;;;;
628910,455;154232;10860;160256;1279962;1280977;1308672;1434194;1291837;1468928;;;;;;
628931,168;156268;10124;160256;1280977;1281345;1308672;1437245;1291469;1468928;;;;;;
628954,878;155532;9980;160768;1281345;1282023;1308672;1436877;1292003;1469440;;;;;;
628969,275;156412;11545;160768;1282023;1282223;1308672;1438435;1293768;1469440;;;;;;
628981,377;157977;10831;161280;1282223;1282423;1308672;1440200;1293254;1469952;;;;;;
628991,039;157775;8545;160768;1282423;1283071;1308672;1440198;1291616;1469440;;;;;;
629000,457;155489;10819;161280;1283071;1283232;1308672;1438560;1294051;1469952;;;;;;
629017,450;158275;10123;161280;1283232;1283583;1308672;1441507;1293706;1469952;;;;;;
629055,440;157579;13799;159232;1283583;1283970;1308672;1441162;1297769;1467904;;;;;;
629084,115;159207;12419;160256;1283970;1284778;1308672;1443177;1297197;1468928;;;;;;
629117,545;157827;11328;160768;1284778;1284777;1308672;1442605;1296105;1469440;;;;;;
629131,139;157248;14332;160256;1284777;1285525;1308672;1442025;1299857;1468928;;;;;;
629143,903;160252;10856;159232;1285525;1286134;1308672;1445777;1296990;1467904;;;;;;
629164,645;155240;9175;159744;1286134;1287399;1308672;1441374;1296574;1468416;;;;;;
629178,178;153559;8184;159744;1287399;1287958;1308672;1440958;1296142;1468416;;;;;;
629191,916;152568;7927;152576;1287958;1288415;1308672;1440526;1296342;1461248;;;;;;
629272,856;152311;8652;159744;1288415;1288993;1308672;1440726;1297645;1468416;;;;;;
629292,908;152524;10316;159232;1288993;1288993;1308672;1441517;1299309;1467904;;;;;;
629345,056;154188;11577;160256;1288993;1288993;1308672;1443181;1300570;1468928;;;;;;
629388,309;156985;9959;160256;1288993;1289417;1308672;1445978;1299376;1468928;;;;;;
629469,873;155367;9055;160768;1289417;1289705;1308672;1444784;1298760;1469440;;;;;;
629485,733;154975;8515;160256;1289705;1290009;1308672;1444680;1298524;1468928;;;;;;
629545,627;119251;8815;160768;1290009;1290345;1308672;1409260;1299160;1469440;;;;;;
629545,655;8815;0;160768;1290345;1268417;1308672;1299160;1268417;1469440;191305;187509;786432;1490465;1455926;2255872
630019,551;146432;4419;151040;1268417;1268418;1308672;1414849;1272837;1459712;;;;;;
630047,006;150851;7604;160256;1268418;1268418;1308672;1419269;1276022;1468928;;;;;;
630061,827;153012;4747;160256;1268418;1268418;1308672;1421430;1273165;1468928;;;;;;
630068,779;150155;6227;160256;1268418;1268418;1308672;1418573;1274645;1468928;;;;;;
630076,955;151635;5884;160256;1268418;1268417;1308672;1420053;1274301;1468928;;;;;;
630085,264;151292;7151;160768;1268417;1268417;1308672;1419709;1275568;1469440;;;;;;
630106,808;153071;8495;160256;1268417;1268417;1308672;1421488;1276912;1468928;;;;;;
630155,952;154415;9156;161280;1268417;1268418;1308672;1422832;1277574;1469952;;;;;;
630190,983;156528;9536;161280;1268417;1268417;1308672;1424945;1277953;1469952;;;;;;
630216,183;156992;7807;161792;1268417;1268417;1308672;1425409;1276224;1470464;;;;;;
630263,393;156287;8943;161792;1268417;1268417;1308672;1424704;1277360;1470464;;;;;;
630335,422;157423;11845;160256;1268417;1268417;1308672;1425840;1280262;1468928;;;;;;
630384,272;159301;13800;161280;1268417;1268476;1308672;1427718;1282276;1469952;;;;;;
630396,036;161256;12433;157184;1268476;1268476;1308672;1429732;1280909;1465856;;;;;;
630408,160;155793;11662;159232;1268476;1268476;1308672;1424269;1280138;1467904;;;;;;
630427,216;155022;11071;159232;1268476;1268996;1308672;1423498;1280067;1467904;;;;;;
630441,584;154431;9975;159232;1268996;1269748;1308672;1423427;1279723;1467904;;;;;;
630446,479;153335;9727;160256;1269748;1270164;1308672;1423083;1279891;1468928;;;;;;
630470,913;154623;11299;159744;1270164;1270668;1308672;1424787;1281967;1468416;;;;;;
630503,975;156195;10463;160768;1270668;1271940;1308672;1426863;1282403;1469440;;;;;;
630519,645;156383;9440;160256;1271940;1272396;1308672;1428323;1281836;1468928;;;;;;
630549,001;155360;8239;160768;1272396;1272756;1308672;1427756;1280995;1469440;;;;;;
630554,895;154671;9247;160768;1272756;1272756;1308672;1427427;1282003;1469440;;;;;;
630575,602;155679;8559;161280;1272756;1273740;1308672;1428435;1282299;1469952;;;;;;
630603,624;156015;12268;159744;1273740;1274715;1308672;1429755;1286983;1468416;;;;;;
630646,641;159724;9717;161280;1274715;1275219;1308672;1434439;1284936;1469952;;;;;;
630660,399;156661;10265;160768;1275219;1275218;1308672;1431880;1285483;1469440;;;;;;
630672,566;157209;12749;160256;1275218;1275218;1308672;1432427;1287967;1468928;;;;;;
630691,619;159181;8929;160768;1275218;1275587;1308672;1434399;1284516;1469440;;;;;;
630703,026;155361;9350;161280;1275587;1276067;1308672;1430948;1285417;1469952;;;;;;
630715,325;156294;8750;160768;1276067;1276298;1308672;1432361;1285048;1469440;;;;;;
630723,461;155694;8193;161280;1276298;1276659;1308672;1431992;1284852;1469952;;;;;;
630735,968;155649;7744;161280;1276659;1277434;1308672;1432308;1285178;1469952;;;;;;
630744,832;155200;9171;161792;1277434;1278076;1308672;1432634;1287247;1470464;;;;;;
630753,195;157139;9776;161280;1278076;1278745;1308672;1435215;1288521;1469952;;;;;;
630799,370;157744;12869;160768;1278745;1279737;1308672;1436489;1292606;1469440;;;;;;
630836,767;160325;7907;161280;1279737;1280887;1308672;1440062;1288794;1469952;;;;;;
630848,018;155106;8707;161280;1280887;1281190;1308672;1435993;1289897;1469952;;;;;;
630864,340;156163;7783;161280;1281190;1281599;1308672;1437353;1289382;1469952;;;;;;
630892,645;155239;10872;161280;1281599;1281734;1308672;1436838;1292606;1469952;;;;;;
630904,871;158328;9319;161280;1281734;1281918;1308672;1440062;1291237;1469952;;;;;;
630922,340;156775;7618;161792;1281918;1282118;1308672;1438693;1289736;1470464;;;;;;
630939,196;156098;8917;161792;1282118;1282119;1308672;1438216;1291036;1470464;;;;;;
631021,465;157397;10974;161280;1282119;1282118;1308672;1439516;1293092;1469952;;;;;;
631054,338;159454;11780;160768;1282118;1282118;1308672;1441572;1293898;1469440;;;;;;
631066,605;160260;9639;161792;1282118;1282118;1308672;1442378;1291757;1470464;;;;;;
631087,626;157607;12257;161280;1282118;1282118;1308672;1439725;1294375;1469952;;;;;;
631101,328;160225;10043;161280;1282118;1282119;1308672;1442343;1292162;1469952;;;;;;
631109,902;157499;11826;161280;1282119;1282630;1308672;1439618;1294456;1469952;;;;;;
631136,878;159282;11795;160256;1282630;1283888;1308672;1441912;1295683;1468928;;;;;;
631144,217;158227;11807;160768;1283888;1284177;1308672;1442115;1295984;1469440;;;;;;
631155,040;158239;8934;160768;1284177;1285120;1308672;1442416;1294054;1469440;;;;;;
631161,778;155366;8015;160768;1285120;1286373;1308672;1440486;1294388;1469440;;;;;;
631173,484;154447;8688;160768;1286373;1286838;1308672;1440820;1295526;1469440;;;;;;
631187,233;155120;8254;160768;1286838;1287790;1308672;1441958;1296044;1469440;;;;;;
631193,704;154568;8681;161280;1288114;1289399;1308672;1442682;1298080;1469952;;;;;;
631207,628;155625;9779;160768;1289403;1290019;1308672;1445028;1299798;1469440;;;;;;
631220,300;156723;5632;160768;1290019;1291488;1308672;1446742;1297120;1469440;;;;;;
631375,458;153088;6352;161280;1291488;1292160;1308672;1444576;1298512;1469952;;;;;;
631436,188;153808;9752;161280;1292160;1292848;1308672;1445968;1302600;1469952;;;;;;
631463,132;157208;7529;161280;1292848;1294661;1308672;1450056;1302190;1469952;;;;;;
631475,454;154985;5854;160768;1294661;1294806;1308672;1449646;1300660;1469440;;;;;;
631484,604;153310;5749;161280;1294806;1295395;1308672;1448116;1301144;1469952;;;;;;
631494,744;153020;3704;161280;1295395;1296861;1308672;1448415;1300565;1469952;;;;;;
631500,978;151160;4277;161280;1296861;1297824;1308672;1448021;1302101;1469952;;;;;;
631533,531;151733;6717;161792;1297824;1299260;1308672;1449557;1305977;1470464;;;;;;
631551,769;154685;3552;161280;1299260;1300231;1308672;1453945;1303783;1469952;;;;;;
631584,385;151520;608;160768;1300231;1302195;1308672;1451751;1302803;1469440;;;;;;
631600,868;148064;1207;148992;1302195;1302195;1308672;1450259;1303402;1457664;;;;;;
631632,946;148663;7889;160768;1302195;1302195;1308672;1450858;1310084;1469440;;;;;;
631778,915;154321;9892;156672;1302195;1302195;1308672;1456516;1312087;1465344;;;;;;
631828,186;156324;8953;160256;1302195;1302195;1308672;1458519;1311148;1468928;;;;;;
631903,893;154361;7669;160256;1302195;1302196;1308672;1456556;1309865;1468928;;;;;;
631950,289;153077;6624;161280;1302196;1302195;1308672;1455273;1308819;1469952;;;;;;
631991,488;153568;8002;160768;1302195;1302195;1308672;1455763;1310197;1469440;;;;;;
632022,577;154946;6911;162304;1302195;1302195;1308672;1457141;1309106;1470976;;;;;;
632039,262;155903;9603;161792;1302195;1302195;1308672;1458098;1311798;1470464;;;;;;
632062,635;158595;9836;160768;1302195;1302195;1308672;1460790;1312031;1469440;;;;;;
632068,205;157292;9433;161280;1302195;1302195;1308672;1459487;1311628;1469952;;;;;;
632078,300;156889;10485;160256;1302195;1302388;1308672;1459084;1312873;1468928;;;;;;
632096,662;156917;7329;160768;1302388;1303667;1308672;1459305;1310996;1469440;;;;;;
632124,047;153761;9875;161280;1303667;1304596;1308672;1457428;1314471;1469952;;;;;;
632147,491;157331;6991;161280;1304596;1305172;1308672;1461927;1312163;1469952;;;;;;
632161,264;154447;7120;161792;1305172;1305172;1308672;1459619;1312292;1470464;;;;;;
632169,936;155088;9250;161280;1305172;1305547;1308672;1460260;1314797;1469952;;;;;;
632179,606;157218;11017;160768;1305547;1306068;1308672;1462765;1317085;1469440;;;;;;
632185,193;158473;11343;159232;1306068;1306715;1308672;1464541;1318058;1467904;;;;;;
632189,464;158799;8685;161280;1306715;1307770;1308672;1465514;1316455;1469952;;;;;;
632189,494;8685;0;161280;1307770;1274888;1341440;1316455;1274888;1502720;192703;186778;786432;1509158;1461666;2289152
632196,156;146944;4145;160768;1274888;1274888;1341440;1421832;1279033;1502208;;;;;;
632208,053;151089;6114;161280;1274888;1274888;1341440;1425977;1281002;1502720;;;;;;
632219,246;153058;6972;160768;1274888;1274888;1341440;1427946;1281860;1502208;;;;;;
632224,320;153916;9330;161792;1274888;1274888;1341440;1428804;1284218;1503232;;;;;;
632228,543;157810;6443;161792;1274888;1276191;1341440;1432698;1282634;1503232;;;;;;
632234,568;154923;7808;162304;1276191;1277627;1341440;1431114;1285435;1503744;;;;;;
632242,287;156800;5463;161792;1277627;1279174;1341440;1434427;1284637;1503232;;;;;;
632248,078;154455;6197;162816;1279174;1280774;1341440;1433629;1286971;1504256;;;;;;
632253,557;156213;5817;162304;1280774;1281478;1341440;1436987;1287295;1503744;;;;;;
632261,223;155833;3058;162816;1281478;1284077;1341440;1437311;1287135;1504256;;;;;;
632271,996;153586;5955;162816;1284077;1284599;1341440;1437663;1290554;1504256;;;;;;
632330,261;156340;5493;163328;1284762;1286048;1341440;1441102;1291541;1504768;;;;;;
632346,729;156533;6992;162816;1286052;1287229;1341440;1442585;1294221;1504256;;;;;;
632353,648;158032;4140;163840;1287229;1288720;1341440;1445261;1292860;1505280;;;;;;
632364,701;156716;3520;163840;1288720;1289799;1341440;1445436;1293319;1505280;;;;;;
632382,300;156096;3828;163840;1289799;1290332;1341440;1445895;1294160;1505280;;;;;;
632394,500;156404;4740;163840;1290332;1290580;1341440;1446736;1295320;1505280;;;;;;
632416,545;157316;5363;164352;1290580;1291253;1341440;1447896;1296616;1505792;;;;;;
632441,617;158451;6822;163840;1291253;1292379;1341440;1449704;1299201;1505280;;;;;;
632458,144;159910;6521;164864;1292379;1292380;1341440;1452289;1298901;1506304;;;;;;
632470,565;160633;8437;164352;1292380;1292380;1341440;1453013;1300817;1505792;;;;;;
632482,943;162549;6129;164864;1292380;1293010;1341440;1454929;1299139;1506304;;;;;;
632484,396;160241;5681;164352;1293010;1293898;1341440;1453251;1299579;1505792;;;;;;
632486,372;159793;10224;159744;1293898;1297845;1341440;1453691;1308069;1501184;;;;;;
632491,612;159728;3392;162304;1297845;1307513;1341440;1457573;1310905;1503744;;;;;;
632496,556;152896;1744;162304;1307513;1310410;1341440;1460409;1312154;1503744;;;;;;
632504,312;151248;864;150528;1310410;1310730;1341440;1461658;1311594;1491968;;;;;;
632509,516;150368;1152;161792;1310730;1311082;1341440;1461098;1312234;1503232;;;;;;
632513,653;149632;3824;161792;1311082;1311410;1341440;1460714;1315234;1503232;;;;;;
632553,257;152304;6280;162816;1311410;1312234;1341440;1463714;1318514;1504256;;;;;;
632610,164;156296;1313;162304;1312234;1315177;1341440;1468530;1316490;1503744;;;;;;
632629,720;151329;1067;162816;1315177;1315570;1341440;1466506;1316637;1504256;;;;;;
632642,529;151595;995;162816;1315570;1315929;1341440;1467165;1316924;1504256;;;;;;
632663,392;151523;3810;163840;1315929;1316161;1341440;1467452;1319971;1505280;;;;;;
632675,511;155362;6268;162816;1316161;1316824;1341440;1471523;1323092;1504256;;;;;;
632687,565;157820;3648;164352;1316824;1317754;1341440;1474644;1321402;1505792;;;;;;
632691,704;156736;704;163840;1317754;1319963;1341440;1474490;1320667;1505280;;;;;;
632710,861;153792;848;164352;1319963;1320123;1341440;1473755;1320971;1505792;;;;;;
632724,387;154448;4240;164352;1320123;1320218;1341440;1474571;1324458;1505792;;;;;;
632747,261;157840;4276;165376;1320218;1321663;1341440;1478058;1325939;1506816;;;;;;
632772,566;159412;576;164864;1321663;1324090;1341440;1481075;1324666;1506304;;;;;;
632896,456;155712;5747;164352;1324090;1324091;1341440;1479802;1329838;1505792;;;;;;
632935,875;160371;3583;164864;1324091;1324090;1341440;1484462;1327673;1506304;;;;;;
632990,413;158207;3951;165888;1324090;1324090;1341440;1482297;1328041;1507328;;;;;;
633041,354;160623;6451;163328;1324090;1324090;1341440;1484713;1330541;1504768;;;;;;
633076,296;163123;9143;163328;1324090;1324091;1341440;1487213;1333234;1504768;;;;;;
633091,977;162743;9283;163328;1324091;1324090;1341440;1486834;1333373;1504768;;;;;;
633108,663;162883;9050;161280;1324090;1324090;1341440;1486973;1333140;1502720;;;;;;
633143,527;158554;8224;158208;1324090;1324091;1341440;1482644;1332315;1499648;;;;;;
633229,943;157728;7566;161792;1324091;1324091;1341440;1481819;1331657;1503232;;;;;;
633297,960;156046;9651;158208;1324091;1324090;1341440;1480137;1333741;1499648;;;;;;
633332,558;158131;10643;159232;1324090;1324091;1341440;1482221;1334734;1500672;;;;;;
633359,112;156051;10947;156672;1324091;1324091;1341440;1480142;1335038;1498112;;;;;;
633391,125;156355;9454;159232;1324091;1324091;1341440;1480446;1333545;1500672;;;;;;
633439,620;152814;10558;159232;1324091;1324091;1341440;1476905;1334649;1500672;;;;;;
633460,676;153918;14908;155136;1324091;1324259;1341440;1478009;1339167;1496576;;;;;;
633478,815;153870;10136;157184;1324259;1325162;1341440;1478129;1335298;1498624;;;;;;
633487,550;149400;11379;157184;1325162;1325402;1341440;1474562;1336781;1498624;;;;;;
633502,758;150643;10289;157184;1325402;1325594;1341440;1476045;1335883;1498624;;;;;;
633543,804;149553;12192;156672;1325594;1326290;1341440;1475147;1338482;1498112;;;;;;
633563,897;151456;10373;157184;1326290;1327219;1341440;1477746;1337592;1498624;;;;;;
633578,812;149637;9120;158208;1327219;1327546;1341440;1476856;1336666;1499648;;;;;;
633596,353;149920;8369;157696;1327546;1328282;1341440;1477466;1336651;1499136;;;;;;
633613,420;149169;10513;159232;1328282;1328842;1341440;1477451;1339355;1500672;;;;;;
633636,435;153361;8495;158720;1328842;1329042;1341440;1482203;1337537;1500160;;;;;;
633657,820;151343;10701;159744;1329042;1329635;1341440;1480385;1340336;1501184;;;;;;
633692,362;155085;11382;159744;1329635;1330043;1341440;1484720;1341425;1501184;;;;;;
633717,737;155766;8161;159744;1330043;1330738;1341440;1485809;1338899;1501184;;;;;;
633729,866;152545;10497;159744;1330738;1330930;1341440;1483283;1341427;1501184;;;;;;
633736,565;154881;12387;159232;1330930;1331455;1341440;1485811;1343842;1500672;;;;;;
633748,716;156771;10225;159744;1331455;1332455;1341440;1488226;1342680;1501184;;;;;;
633773,384;154609;8878;160256;1332455;1332991;1341440;1487064;1341869;1501696;;;;;;
633784,398;153774;7119;159744;1332991;1333974;1341440;1486765;1341093;1501184;;;;;;
633819,046;152015;8158;160768;1333974;1334526;1341440;1485989;1342684;1502208;;;;;;
633859,219;154078;10606;160256;1334526;1335127;1341440;1488604;1345733;1501696;;;;;;
633990,927;156526;7598;160768;1335127;1335678;1341440;1491653;1343276;1502208;;;;;;
634000,626;153852;7477;160768;1335678;1335678;1341440;1489530;1343155;1502208;;;;;;
634043,194;153909;12434;159744;1335678;1336205;1341440;1489587;1348639;1501184;;;;;;
634064,693;157842;7968;160256;1336205;1336206;1341440;1494047;1344174;1501696;;;;;;
634071,335;153376;8364;160768;1336206;1336205;1341440;1489582;1344569;1502208;;;;;;
634109,230;154284;7502;160256;1336205;1336822;1341440;1490489;1344324;1501696;;;;;;
634145,771;153422;10032;161280;1336822;1337493;1341440;1490244;1347525;1502720;;;;;;
634165,190;156976;12663;159744;1337493;1337494;1341440;1494469;1350157;1501184;;;;;;
634181,796;159607;9405;160768;1337494;1337494;1341440;1497101;1346899;1502208;;;;;;
634197,689;155325;8806;160256;1337494;1337494;1341440;1492819;1346300;1501696;;;;;;
634211,449;154726;8382;161280;1337494;1338014;1341440;1492220;1346396;1502720;;;;;;
634224,534;155838;8302;161280;1338014;1338374;1341440;1493852;1346676;1502720;;;;;;
634280,022;155758;9278;161792;1338374;1338526;1341440;1494132;1347804;1503232;;;;;;
634294,330;157758;12313;161280;1338526;1339194;1341440;1496284;1351507;1502720;;;;;;
634307,213;160793;8095;161280;1339194;1339779;1341440;1499987;1347874;1502720;;;;;;
634319,513;155551;8003;161280;1339779;1340490;1341440;1495330;1348493;1502720;;;;;;
634319,537;8003;0;161280;1340490;1282150;1347584;1348493;1282150;1508864;191802;186723;786432;1540295;1468873;2295296
634329,198;147456;3713;159744;1282150;1282150;1347584;1429606;1285863;1507328;;;;;;
634350,384;150145;3937;160768;1282150;1282150;1347584;1432295;1286087;1508352;;;;;;
634397,185;150369;7413;161280;1282150;1282150;1347584;1432519;1289563;1508864;;;;;;
634423,808;154357;7042;160768;1282150;1282150;1347584;1436507;1289192;1508352;;;;;;
634437,670;153986;11338;160256;1282150;1282151;1347584;1436136;1293489;1507840;;;;;;
634457,038;157770;6450;160768;1282151;1282150;1347584;1439921;1288600;1508352;;;;;;
634481,904;152882;9299;161280;1282150;1282150;1347584;1435032;1291449;1508864;;;;;;
634488,144;156755;11460;159232;1282150;1282150;1347584;1438905;1293610;1506816;;;;;;
634500,318;158916;10428;159744;1282150;1282150;1347584;1441066;1292578;1507328;;;;;;
634519,282;155836;9635;160256;1282150;1282150;1347584;1437986;1291785;1507840;;;;;;
634537,382;155043;7656;161280;1282150;1283679;1347584;1437193;1291335;1508864;;;;;;
634602,396;154600;7456;160768;1283679;1284263;1347584;1438279;1291719;1508352;;;;;;
634609,112;154400;7344;161792;1284263;1284263;1347584;1438663;1291607;1509376;;;;;;
634636,471;155312;10993;161280;1284263;1285518;1347584;1439575;1296511;1508864;;;;;;
634647,728;158961;6753;161280;1285518;1285886;1347584;1444479;1292639;1508864;;;;;;
634689,006;154209;6846;161280;1285886;1287398;1347584;1440095;1294244;1508864;;;;;;
634705,598;154302;10437;161280;1287398;1287966;1347584;1441700;1298403;1508864;;;;;;
634714,516;157893;5473;161280;1287966;1288398;1347584;1445859;1293871;1508864;;;;;;
634734,336;152929;7196;161792;1288398;1288486;1347584;1441327;1295682;1509376;;;;;;
634747,058;155164;6368;161280;1288486;1288687;1347584;1443650;1295055;1508864;;;;;;
634749,865;154336;6767;162304;1288687;1288919;1347584;1443023;1295686;1509888;;;;;;
634773,436;155759;6924;161792;1288919;1289964;1347584;1444678;1296888;1509376;;;;;;
634787,571;155916;7916;162816;1289964;1291267;1347584;1445880;1299183;1510400;;;;;;
634795,680;157932;4819;162304;1291267;1292111;1347584;1449199;1296930;1509888;;;;;;
634805,041;154835;3951;162816;1292111;1292911;1347584;1446946;1296862;1510400;;;;;;
634810,137;154479;4177;162816;1292911;1294100;1347584;1447390;1298277;1510400;;;;;;
634819,742;154705;5645;162816;1294100;1294652;1347584;1448805;1300297;1510400;;;;;;
634850,492;156173;7520;162816;1294652;1295903;1347584;1450825;1303423;1510400;;;;;;
634857,071;158048;3664;163328;1295903;1297092;1347584;1453951;1300756;1510912;;;;;;
634912,442;155216;800;152576;1297092;1299276;1347584;1452308;1300076;1500160;;;;;;
634958,878;152352;4351;162816;1299276;1299517;1347584;1451628;1303868;1510400;;;;;;
634976,836;154879;5613;162816;1299517;1300370;1347584;1454396;1305983;1510400;;;;;;
634988,048;156141;3010;163840;1300370;1300371;1347584;1456511;1303381;1511424;;;;;;
635026,664;155586;1296;154112;1300371;1302450;1347584;1455957;1303746;1501696;;;;;;
635036,886;153872;6497;163840;1302450;1302450;1347584;1456322;1308947;1511424;;;;;;
635049,603;158561;8888;161280;1302450;1302858;1347584;1461011;1311746;1508864;;;;;;
635055,554;160952;4353;163328;1302858;1303082;1347584;1463810;1307435;1510912;;;;;;
635057,975;155393;4932;162816;1303082;1304648;1347584;1458475;1309580;1510400;;;;;;
635060,882;155972;1419;163840;1304648;1307236;1347584;1460620;1308655;1511424;;;;;;
635066,622;153995;4160;163840;1307236;1307508;1347584;1461231;1311668;1511424;;;;;;
635072,824;156736;4918;164864;1307508;1308172;1347584;1464244;1313090;1512448;;;;;;
635086,866;159030;4627;164352;1308172;1308699;1347584;1467202;1313326;1511936;;;;;;
635101,549;158739;1361;164352;1308699;1311085;1347584;1467438;1312446;1511936;;;;;;
635117,919;155985;1600;164864;1311085;1311443;1347584;1467070;1313043;1512448;;;;;;
635120,928;156224;4004;165888;1311443;1312139;1347584;1467667;1316143;1513472;;;;;;
635126,097;160164;4172;165376;1312139;1312844;1347584;1472303;1317016;1512960;;;;;;
635135,692;160332;3559;166400;1312844;1315106;1347584;1473176;1318665;1513984;;;;;;
635142,319;160743;3840;165888;1315106;1315730;1347584;1475849;1319570;1513472;;;;;;
635155,863;161024;3444;166912;1315730;1316346;1347584;1476754;1319790;1514496;;;;;;
635173,430;162164;6085;166912;1316346;1316941;1347584;1478510;1323026;1514496;;;;;;
635186,678;164805;5016;166912;1316941;1317805;1347584;1481746;1322821;1514496;;;;;;
635198,025;163736;4448;166912;1317805;1318412;1347584;1481541;1322860;1514496;;;;;;
635204,015;163168;1744;166912;1318412;1320500;1347584;1481580;1322244;1514496;;;;;;
635211,821;160464;1377;166912;1320500;1320980;1347584;1480964;1322357;1514496;;;;;;
635216,959;160097;4356;167424;1320980;1321533;1347584;1481077;1325889;1515008;;;;;;
635222,155;163588;3908;166912;1321533;1321741;1347584;1485121;1325649;1514496;;;;;;
635235,572;163140;3936;167936;1321741;1322036;1347584;1484881;1325972;1515520;;;;;;
635241,653;164192;4548;167424;1322036;1322789;1347584;1486228;1327337;1515008;;;;;;
635251,712;164804;3900;168448;1322789;1323485;1347584;1487593;1327385;1516032;;;;;;
635262,455;165180;4308;167936;1323485;1324566;1347584;1488665;1328874;1515520;;;;;;
635269,341;165588;3904;168448;1324566;1325158;1347584;1490154;1329062;1516032;;;;;;
635278,023;165696;1733;168448;1325158;1327620;1347584;1490854;1329353;1516032;;;;;;
635284,968;163525;3776;168448;1327620;1328099;1347584;1491145;1331875;1516032;;;;;;
635293,189;165568;3776;168448;1328099;1328579;1347584;1493667;1332355;1516032;;;;;;
635303,756;165568;5165;167936;1328579;1329281;1347584;1494147;1334446;1515520;;;;;;
635346,729;166957;6511;168448;1329281;1330076;1347584;1496238;1336587;1516032;;;;;;
635489,541;168303;6649;165376;1330076;1330928;1347584;1498379;1337577;1512960;;;;;;
635508,988;165369;5029;166912;1330928;1331803;1347584;1496297;1336832;1514496;;;;;;
635526,556;163749;5770;166912;1331803;1332422;1347584;1495552;1338192;1514496;;;;;;
635537,424;164490;4596;166912;1332422;1333176;1347584;1496912;1337772;1514496;;;;;;
635544,751;162879;1713;166400;1333176;1335497;1347584;1496055;1337210;1513984;;;;;;
635552,257;160433;4404;166912;1335497;1336193;1347584;1495930;1340597;1514496;;;;;;
635557,460;163124;1648;167424;1336193;1338201;1347584;1499317;1339849;1515008;;;;;;
635566,405;161392;5325;165376;1338201;1339209;1347584;1499593;1344534;1512960;;;;;;
635573,637;165069;6581;165888;1339209;1339946;1347584;1504278;1346527;1513472;;;;;;
635582,181;164277;1248;166400;1339946;1342329;1347584;1504223;1343577;1513984;;;;;;
635593,731;158944;2896;166400;1342329;1342906;1347584;1501273;1345802;1513984;;;;;;
635604,145;160592;1727;166400;1342906;1345069;1347584;1503498;1346796;1513984;;;;;;
635604,164;1727;0;166400;1345069;1297399;1363968;1346796;1297399;1530368;189402;186723;786432;1536198;1484122;2316800
635609,000;157696;5996;165888;1297399;1297399;1363968;1455095;1303395;1529856;;;;;;
635620,439;163692;4979;166400;1297399;1299029;1363968;1461091;1304008;1530368;;;;;;
635626,820;162675;4960;166400;1299029;1299788;1363968;1461704;1304748;1530368;;;;;;
635635,792;162656;1733;166400;1299788;1302012;1363968;1462444;1303745;1530368;;;;;;
635645,178;159429;7452;165376;1302012;1302572;1363968;1461441;1310024;1529344;;;;;;
635653,606;164124;5557;165888;1302572;1303660;1363968;1466696;1309217;1529856;;;;;;
635665,430;162229;1024;164864;1303660;1305805;1363968;1465889;1306829;1528832;;;;;;
635669,830;156672;3488;165376;1305805;1306174;1363968;1462477;1309662;1529344;;;;;;
635672,541;159136;672;165888;1306174;1308519;1363968;1465310;1309191;1529856;;;;;;
635681,857;157344;5590;165888;1308519;1308776;1363968;1465863;1314366;1529856;;;;;;
635694,738;162262;5342;165888;1308776;1309432;1363968;1471038;1314774;1529856;;;;;;
635725,802;162014;6417;163328;1309432;1310065;1363968;1471446;1316482;1527296;;;;;;
635757,578;163089;1632;165376;1310065;1312818;1363968;1473154;1314450;1529344;;;;;;
635773,473;157280;6173;165376;1312818;1314262;1363968;1470098;1320435;1529344;;;;;;
635779,069;161821;1859;165376;1314262;1316616;1363968;1476083;1318475;1529344;;;;;;
635824,721;157487;4730;165376;1316616;1316921;1363968;1474103;1321651;1529344;;;;;;
635843,085;160378;4867;165888;1316921;1317677;1363968;1477299;1322544;1529856;;;;;;
635853,686;161027;2159;165376;1317677;1320172;1363968;1478704;1322331;1529344;;;;;;
635896,798;158319;4829;165888;1320172;1320276;1363968;1478491;1325105;1529856;;;;;;
635908,630;161501;5562;165888;1320276;1321033;1363968;1481777;1326595;1529856;;;;;;
635926,201;162234;9214;160768;1321033;1327893;1363968;1483267;1337107;1524736;;;;;;
635948,004;160766;4944;156672;1327893;1329603;1363968;1488659;1334547;1520640;;;;;;
635961,120;156496;3952;163328;1329603;1330234;1363968;1486099;1334186;1527296;;;;;;
635979,396;154992;3104;162816;1330234;1330899;1363968;1485226;1334003;1526784;;;;;;
635986,510;154144;3168;163840;1330899;1330898;1363968;1485043;1334066;1527808;;;;;;
636004,468;155232;1616;163328;1330898;1333307;1363968;1486130;1334923;1527296;;;;;;
636018,631;153680;672;163840;1333307;1334239;1363968;1486987;1334911;1527808;;;;;;
636052,044;153248;4112;163840;1334239;1334511;1363968;1487487;1338623;1527808;;;;;;
636085,274;156688;768;164864;1334511;1336961;1363968;1491199;1337729;1528832;;;;;;
636097,243;154880;3040;164352;1336961;1336961;1363968;1491841;1340001;1528320;;;;;;
636115,175;157152;6268;164352;1336961;1336961;1363968;1494113;1343229;1528320;;;;;;
636164,299;160892;4610;164864;1336961;1336961;1363968;1497853;1341571;1528832;;;;;;
636175,027;159234;6468;164352;1336961;1336961;1363968;1496195;1343429;1528320;;;;;;
636203,986;161092;5869;164864;1336961;1336961;1363968;1498053;1342830;1528832;;;;;;
636208,684;160493;5792;164864;1336961;1336961;1363968;1497454;1342753;1528832;;;;;;
636245,965;160416;8823;163840;1336961;1337794;1363968;1497377;1346617;1527808;;;;;;
636266,768;163447;4880;164352;1337794;1338194;1363968;1501241;1343074;1528320;;;;;;
636289,723;157968;8903;162304;1338194;1338195;1363968;1496162;1347098;1526272;;;;;;
636325,076;161991;5744;163840;1338195;1338723;1363968;1500186;1344467;1527808;;;;;;
636354,800;157808;9968;162304;1338723;1338723;1363968;1496531;1348691;1526272;;;;;;
636373,788;162032;6161;163328;1338723;1338723;1363968;1500755;1344884;1527296;;;;;;
636386,125;157201;9328;162816;1338723;1338723;1363968;1495924;1348051;1526784;;;;;;
636402,225;160368;11202;159744;1338723;1339243;1363968;1499091;1350445;1523712;;;;;;
636449,221;158658;10505;158208;1339243;1339587;1363968;1497901;1350092;1522176;;;;;;
636471,324;157961;9792;159744;1339587;1339587;1363968;1497548;1349379;1523712;;;;;;
636497,070;155200;9509;160256;1339587;1339587;1363968;1494787;1349096;1524224;;;;;;
636517,511;154917;10336;159232;1339587;1339587;1363968;1494504;1349923;1523200;;;;;;
636535,217;154720;10464;159744;1339587;1339587;1363968;1494307;1350051;1523712;;;;;;
636547,839;154848;9922;159744;1339587;1339587;1363968;1494435;1349509;1523712;;;;;;
636580,210;154306;14002;158720;1339587;1340034;1363968;1493893;1354036;1522688;;;;;;
636700,058;158386;13033;156672;1340034;1340499;1363968;1498420;1353532;1520640;;;;;;
636731,913;153321;12000;152576;1340499;1340811;1363968;1493820;1352811;1516544;;;;;;
636762,848;152288;13647;156160;1340811;1341467;1363968;1493099;1355114;1520128;;;;;;
636802,880;151887;10275;156672;1341467;1341698;1363968;1493354;1351973;1520640;;;;;;
636823,033;148515;11936;157184;1341698;1342250;1363968;1490213;1354186;1521152;;;;;;
636830,218;151200;10367;157184;1342250;1342594;1363968;1493450;1352961;1521152;;;;;;
636834,739;149631;12480;157184;1342594;1343042;1363968;1492225;1355522;1521152;;;;;;
636851,406;152768;11301;157696;1343042;1344482;1363968;1495810;1355783;1521664;;;;;;
636868,187;151587;9465;158720;1344482;1345498;1363968;1496069;1354963;1522688;;;;;;
636896,696;151289;12469;158208;1345498;1346546;1363968;1496787;1359015;1522176;;;;;;
636907,659;154293;10679;159232;1346546;1347399;1363968;1500839;1358078;1523200;;;;;;
636914,368;153015;7566;158208;1347399;1349086;1363968;1500414;1356652;1522176;;;;;;
636941,454;149902;6673;158208;1349086;1349751;1363968;1498988;1356424;1522176;;;;;;
636949,368;149009;6321;158720;1349751;1350503;1363968;1498760;1356824;1522688;;;;;;
636962,256;148657;6537;159232;1350503;1351278;1363968;1499160;1357815;1523200;;;;;;
636970,588;149385;7920;158720;1351278;1352748;1363968;1500663;1360668;1522688;;;;;;
636982,250;150768;7886;159744;1352748;1353644;1363968;1503516;1361530;1523712;;;;;;
636993,950;151758;7070;159232;1353644;1354036;1363968;1505402;1361106;1523200;;;;;;
637012,227;150942;4399;159232;1354036;1354868;1363968;1504978;1359267;1523200;;;;;;
637038,927;148783;896;145408;1354868;1358042;1363968;1503651;1358938;1509376;;;;;;
637053,558;145280;1136;159232;1358042;1358258;1363968;1503322;1359394;1523200;;;;;;
637058,433;144496;5725;159232;1358258;1358482;1363968;1502754;1364207;1523200;;;;;;
637073,500;149085;2752;159744;1358482;1359112;1363968;1507567;1361864;1523712;;;;;;
637100,134;147136;4852;159744;1359112;1359793;1363968;1506248;1364645;1523712;;;;;;
637123,705;149236;3634;160768;1359793;1361061;1363968;1509029;1364695;1524736;;;;;;
637154,879;149554;6989;160256;1361061;1361061;1363968;1510615;1368050;1524224;;;;;;
637177,540;152909;6293;161792;1361061;1361061;1363968;1513970;1367354;1525760;;;;;;
637182,594;154261;7505;161280;1361061;1361061;1363968;1515322;1368566;1525248;;;;;;
637192,992;155473;7740;162304;1361061;1362083;1363968;1516534;1369823;1526272;;;;;;
637193,019;7740;0;162304;1362083;1308571;1374208;1369823;1308571;1536512;190413;186947;786432;1560236;1495518;2322944
637198,386;149504;5620;162304;1308571;1308572;1374208;1458075;1314192;1536512;;;;;;
637206,399;155124;2352;162816;1308572;1312380;1374208;1463696;1314732;1537024;;;;;;
637219,856;152880;992;151552;1312380;1313028;1374208;1465260;1314020;1525760;;;;;;
637225,001;151520;1248;162304;1313028;1313364;1374208;1464548;1314612;1536512;;;;;;
637230,991;150752;5884;162304;1313364;1313629;1374208;1464116;1319513;1536512;;;;;;
637240,439;155388;5292;163328;1313629;1314284;1374208;1469017;1319576;1537536;;;;;;
637256,955;156332;5249;162816;1314284;1315081;1374208;1470616;1320330;1537024;;;;;;
637276,603;156289;9917;161792;1315081;1315369;1374208;1471370;1325286;1536000;;;;;;
637286,430;160445;1600;162816;1315369;1318765;1374208;1475814;1320365;1537024;;;;;;
637293,045;152128;1936;162816;1318765;1319922;1374208;1470893;1321858;1537024;;;;;;
637297,377;152464;4771;162816;1319922;1321246;1374208;1472386;1326017;1537024;;;;;;
637300,956;155299;4572;164352;1321246;1322222;1374208;1476545;1326794;1538560;;;;;;
637337,837;157148;3531;163328;1322222;1324479;1374208;1479370;1328010;1537536;;;;;;
637353,207;156107;2176;164864;1324479;1325111;1374208;1480586;1327287;1539072;;;;;;
637368,826;156288;4653;164352;1325111;1326503;1374208;1481399;1331156;1538560;;;;;;
637375,290;158765;3900;165376;1326503;1327568;1374208;1485268;1331468;1539584;;;;;;
637379,544;159356;3041;165376;1327567;1329893;1374208;1486923;1332934;1539584;;;;;;
637387,295;158689;3600;189952;1329893;1331045;1374208;1488582;1334645;1564160;;;;;;
637429,328;185872;1105;177152;1331045;1333325;1374208;1516917;1334430;1551360;;;;;;
637452,519;176721;896;172544;1333325;1333772;1374208;1510046;1334668;1546752;;;;;;
637463,652;170368;2249;165888;1333772;1333940;1374208;1504140;1336189;1540096;;;;;;
637474,884;165577;8542;166400;1333940;1334617;1374208;1499517;1343159;1540608;;;;;;
637490,663;166238;4341;169472;1334617;1336143;1374208;1500855;1340484;1543680;;;;;;
637512,592;169205;1282;166912;1336143;1338407;1374208;1505348;1339689;1541120;;;;;;
637566,905;160458;4339;163840;1338407;1338751;1374208;1498865;1343090;1538048;;;;;;
637588,773;163571;6312;164864;1338751;1339214;1374208;1502322;1345526;1539072;;;;;;
637605,208;161960;3771;165376;1339214;1339903;1374208;1501174;1343674;1539584;;;;;;
637618,005;159419;6932;164864;1339903;1340742;1374208;1499322;1347674;1539072;;;;;;
637630,975;162580;736;165376;1340742;1343701;1374208;1503322;1344437;1539584;;;;;;
637643,471;156384;4780;165376;1343701;1344158;1374208;1500085;1348938;1539584;;;;;;
637673,359;160428;4592;165376;1344158;1344486;1374208;1504586;1349078;1539584;;;;;;
637691,240;160240;6292;164864;1344486;1344487;1374208;1504726;1350779;1539072;;;;;;
637702,130;161940;5088;165376;1344487;1344487;1374208;1506427;1349575;1539584;;;;;;
637721,756;160736;7361;163840;1344487;1344486;1374208;1505223;1351847;1538048;;;;;;
637739,143;161985;7072;164864;1344486;1344487;1374208;1506471;1351559;1539072;;;;;;
637748,540;161696;7362;163840;1344487;1344487;1374208;1506183;1351849;1538048;;;;;;
637758,354;160962;6240;164352;1344487;1344486;1374208;1505449;1350726;1538560;;;;;;
637773,375;159840;4720;164864;1344486;1346314;1374208;1504326;1351034;1539072;;;;;;
637781,948;158832;4929;164352;1346314;1346531;1374208;1505146;1351460;1538560;;;;;;
637810,302;159041;7025;164352;1346531;1346931;1374208;1505572;1353956;1538560;;;;;;
637823,113;161649;6917;164864;1346931;1347522;1374208;1508580;1354439;1539072;;;;;;
637828,106;161541;6771;164864;1347522;1347779;1374208;1509063;1354550;1539072;;;;;;
637850,840;161395;7773;162816;1347779;1348699;1374208;1509174;1356472;1537024;;;;;;
637876,685;162397;5186;164864;1348699;1348931;1374208;1511096;1354117;1539072;;;;;;
637893,475;159298;8643;164352;1348931;1349532;1374208;1508229;1358175;1538560;;;;;;
637948,328;162755;6824;164352;1349532;1350484;1374208;1512287;1357308;1538560;;;;;;
637967,003;160424;5778;164352;1350484;1350924;1374208;1510908;1356702;1538560;;;;;;
637977,775;159242;8156;163840;1350925;1351332;1374208;1510167;1359488;1538048;;;;;;
637991,177;161756;7335;164352;1351332;1352189;1374208;1513088;1359524;1538560;;;;;;
638022,397;160935;4079;164352;1352189;1353076;1374208;1513124;1357155;1538560;;;;;;
638036,144;157679;4111;164352;1353076;1353527;1374208;1510755;1357638;1538560;;;;;;
638052,243;157711;3375;164352;1353527;1354591;1374208;1511238;1357966;1538560;;;;;;
638062,839;156975;5622;164352;1354591;1354966;1374208;1511566;1360588;1538560;;;;;;
638073,311;159222;3866;164864;1354966;1355662;1374208;1514188;1359528;1539072;;;;;;
638086,422;158490;4337;164864;1355662;1356086;1374208;1514152;1360423;1539072;;;;;;
638096,235;158961;8196;164352;1356086;1356255;1374208;1515047;1364451;1538560;;;;;;
638110,167;162820;4124;164864;1356255;1356838;1374208;1519075;1360962;1539072;;;;;;
638114,437;158748;3552;164864;1356838;1358126;1374208;1515586;1361678;1539072;;;;;;
638118,020;158176;4029;164864;1358126;1361106;1374208;1516302;1365135;1539072;;;;;;
638142,152;158653;4836;165376;1361106;1363011;1374208;1519759;1367847;1539584;;;;;;
638146,041;160484;4584;165376;1363011;1363563;1374208;1523495;1368147;1539584;;;;;;
638150,717;160232;6065;165888;1363563;1364250;1374208;1523795;1370315;1540096;;;;;;
638153,745;162737;5591;165888;1364250;1365112;1374208;1526987;1370703;1540096;;;;;;
638158,806;162263;8038;164352;1365112;1365752;1374208;1527375;1373790;1538560;;;;;;
638181,169;163651;7387;165376;1365752;1367007;1374208;1529403;1374394;1539584;;;;;;
638188,223;163035;7960;164352;1367007;1368536;1374208;1530042;1376496;1538560;;;;;;
638212,904;162584;1152;156160;1368536;1372100;1374208;1531120;1373252;1530368;;;;;;
638212,950;1152;0;156160;1372100;1316373;1382400;1373252;1316373;1538560;191148;186794;786432;1564400;1503167;2324992
638241,369;154624;2464;164352;1316373;1316373;1382400;1470997;1318837;1546752;;;;;;
638259,927;156064;1235;164352;1316373;1317013;1382400;1472437;1318248;1546752;;;;;;
638282,135;154835;4821;164864;1317013;1317444;1382400;1471848;1322265;1547264;;;;;;
638320,047;158933;1071;164352;1317444;1319468;1382400;1476377;1320539;1546752;;;;;;
638336,711;155183;1247;164864;1319468;1319468;1382400;1474651;1320715;1547264;;;;;;
638382,725;155871;8230;163328;1319468;1319468;1382400;1475339;1327698;1545728;;;;;;
638392,837;162854;9321;161792;1319468;1319469;1382400;1482322;1328790;1544192;;;;;;
638434,160;159849;5297;162816;1319469;1319469;1382400;1479318;1324766;1545216;;;;;;
638448,796;155825;6207;163328;1319469;1319468;1382400;1475294;1325675;1545728;;;;;;
638464,640;157759;5601;163328;1319468;1319469;1382400;1477227;1325070;1545728;;;;;;
638474,042;157153;7795;162816;1319469;1319469;1382400;1476622;1327264;1545216;;;;;;
638545,822;159347;9456;161280;1319469;1319469;1382400;1478816;1328925;1543680;;;;;;
638555,591;161008;7864;161792;1319469;1319468;1382400;1480477;1327332;1544192;;;;;;
638567,779;157368;10183;159744;1319468;1319469;1382400;1476836;1329652;1542144;;;;;;
638580,346;159687;10406;159744;1319469;1319468;1382400;1479156;1329874;1542144;;;;;;
638597,591;156838;9503;160768;1319468;1319468;1382400;1476306;1328971;1543168;;;;;;
638656,708;155935;9393;159744;1319468;1319468;1382400;1475403;1328861;1542144;;;;;;
638664,457;154801;9138;160256;1319468;1319469;1382400;1474269;1328607;1542656;;;;;;
638773,205;154546;14715;157184;1319469;1319804;1382400;1474015;1334519;1539584;;;;;;
638808,778;157051;11189;153600;1319804;1320036;1382400;1476855;1331225;1536000;;;;;;
638836,947;153525;12250;157184;1320036;1320445;1382400;1473561;1332695;1539584;;;;;;
638843,431;152538;10480;157696;1320445;1321068;1382400;1472983;1331548;1540096;;;;;;
638869,300;150768;8217;158720;1321068;1321918;1382400;1471836;1330135;1541120;;;;;;
638887,624;149072;11747;157696;1321918;1322183;1382400;1470990;1333930;1540096;;;;;;
638906,231;153059;9995;158720;1322183;1322487;1382400;1475242;1332482;1541120;;;;;;
638926,187;151819;8150;158208;1322487;1323159;1382400;1474306;1331309;1540608;;;;;;
638954,867;149974;10961;159232;1323159;1323823;1382400;1473133;1334784;1541632;;;;;;
638965,858;154321;7601;159232;1323823;1324087;1382400;1478144;1331688;1541632;;;;;;
638970,733;150961;9822;159744;1324087;1324415;1382400;1475048;1334237;1542144;;;;;;
638976,483;154206;10110;159744;1324415;1325583;1382400;1478621;1335693;1542144;;;;;;
638980,143;154494;7651;160256;1325583;1326047;1382400;1480077;1333698;1542656;;;;;;
638983,971;153059;8887;160256;1326047;1326695;1382400;1479106;1335582;1542656;;;;;;
638997,708;154295;8496;161280;1326695;1327319;1382400;1480990;1335815;1543680;;;;;;
639005,492;155440;7678;160768;1327319;1327798;1382400;1482759;1335476;1543168;;;;;;
639011,851;154622;6492;161280;1327798;1328078;1382400;1482420;1334570;1543680;;;;;;
639023,416;153948;6288;161280;1328078;1328807;1382400;1482026;1335095;1543680;;;;;;
639037,211;153744;5824;161792;1328807;1330005;1382400;1482551;1335829;1544192;;;;;;
639049,399;154304;6111;161792;1330005;1330626;1382400;1484309;1336737;1544192;;;;;;
639072,143;154591;3983;161792;1330626;1331571;1382400;1485217;1335554;1544192;;;;;;
639073,155;152463;3954;152576;1331571;1331755;1382400;1484034;1335709;1534976;;;;;;
639084,782;152434;1184;161280;1331755;1334490;1382400;1484189;1335674;1543680;;;;;;
639089,169;148640;6612;161280;1334490;1334794;1382400;1483130;1341406;1543680;;;;;;
639105,544;154068;2556;161792;1334794;1337642;1382400;1488862;1340198;1544192;;;;;;
639121,269;151036;3184;161792;1337642;1338617;1382400;1488678;1341801;1544192;;;;;;
639138,396;151664;1056;161792;1338617;1339998;1382400;1490281;1341054;1544192;;;;;;
639145,312;149536;3008;161792;1339998;1340293;1382400;1489534;1343301;1544192;;;;;;
639156,610;151488;6818;162304;1340293;1340978;1382400;1491781;1347796;1544704;;;;;;
639161,111;156322;5336;162304;1340978;1343897;1382400;1497300;1349233;1544704;;;;;;
639167,287;154840;7888;162816;1343897;1344473;1382400;1498737;1352361;1545216;;;;;;
639205,814;158416;1338;162816;1344473;1347553;1382400;1502889;1348891;1545216;;;;;;
639316,307;151866;5646;163328;1347553;1347873;1382400;1499419;1353519;1545728;;;;;;
639333,485;156686;1741;162816;1347873;1350577;1382400;1504559;1352318;1545216;;;;;;
639341,188;152781;1283;163328;1350577;1350888;1382400;1503358;1352171;1545728;;;;;;
639362,812;152835;6581;163328;1350888;1351209;1382400;1503723;1357790;1545728;;;;;;
639369,419;158133;1698;163328;1351209;1353841;1382400;1509342;1355539;1545728;;;;;;
639373,180;153250;896;163328;1353841;1354185;1382400;1507091;1355081;1545728;;;;;;
639375,341;152448;992;163840;1354185;1354569;1382400;1506633;1355561;1546240;;;;;;
639380,042;153056;3280;163328;1354569;1354841;1382400;1507625;1358121;1545728;;;;;;
639395,401;155344;4844;164864;1354841;1356147;1382400;1510185;1360991;1547264;;;;;;
639415,148;158956;1296;164352;1356147;1358305;1382400;1515103;1359601;1546752;;;;;;
639421,781;155408;4328;165376;1358305;1358689;1382400;1513713;1363017;1547776;;;;;;
639457,477;159464;7894;163328;1358689;1359217;1382400;1518153;1367111;1545728;;;;;;
639495,359;163030;2549;164864;1359217;1361568;1382400;1522247;1364117;1547264;;;;;;
639505,870;156575;4240;164352;1361568;1362624;1382400;1518143;1366864;1546752;;;;;;
639506,047;9993;5292;165376;1362623;1365336;1382400;1372616;1370628;1547776;;;;;;
639506,063;5292;0;165376;1365336;1316253;1382400;1370628;1316253;1547776;189485;186748;786432;1560113;1503001;2334208
639520,623;155648;2031;165376;1316253;1316254;1382400;1471901;1318285;1547776;;;;;;
639533,291;157679;7664;163328;1316254;1316254;1382400;1473933;1323918;1545728;;;;;;
639560,237;161264;9574;163328;1316254;1316254;1382400;1477518;1325828;1545728;;;;;;
639574,247;163174;4945;163840;1316254;1316254;1382400;1479428;1321199;1546240;;;;;;
639581,332;157009;8479;163328;1316254;1316254;1382400;1473263;1324733;1545728;;;;;;
639606,090;160543;6530;163328;1316254;1317633;1382400;1476797;1324163;1545728;;;;;;
639618,458;158082;6168;163328;1317633;1317633;1382400;1475715;1323801;1545728;;;;;;
639642,943;157720;6494;163840;1317633;1317633;1382400;1475353;1324127;1546240;;;;;;
639651,819;158558;7112;163328;1317633;1317633;1382400;1476191;1324745;1545728;;;;;;
639655,074;159176;9869;161792;1317633;1317633;1382400;1476809;1327502;1544192;;;;;;
639704,354;160397;7247;162816;1317633;1318481;1382400;1478030;1325728;1545216;;;;;;
639724,358;157775;10383;160768;1318481;1319416;1382400;1476256;1329799;1543168;;;;;;
639742,636;158863;7951;161792;1319416;1320217;1382400;1478279;1328168;1544192;;;;;;
639758,417;156431;6095;162304;1320217;1320417;1382400;1476648;1326512;1544704;;;;;;
639763,469;155599;7842;162304;1320417;1321121;1382400;1476016;1328963;1544704;;;;;;
639768,920;157346;5538;162816;1321121;1322431;1382400;1478467;1327969;1545216;;;;;;
639788,066;156066;4095;162816;1322431;1323727;1382400;1478497;1327822;1545216;;;;;;
639797,479;154623;1568;162304;1323727;1325902;1382400;1478350;1327470;1544704;;;;;;
639805,155;152096;5228;162816;1325902;1326495;1382400;1477998;1331723;1545216;;;;;;
639820,801;155756;1026;162304;1326495;1328967;1382400;1482251;1329993;1544704;;;;;;
639944,949;151554;3520;162816;1328967;1329159;1382400;1480521;1332679;1545216;;;;;;
639972,505;154048;1726;163328;1329159;1331472;1382400;1483207;1333198;1545728;;;;;;
639995,055;153278;2162;163328;1331472;1331472;1382400;1484750;1333634;1545728;;;;;;
640010,154;153714;1552;163840;1331472;1331472;1382400;1485186;1333024;1546240;;;;;;
640018,827;154128;2212;163840;1331472;1331472;1382400;1485600;1333684;1546240;;;;;;
640058,345;154788;5916;163840;1331472;1331472;1382400;1486260;1337388;1546240;;;;;;
640118,278;158492;6064;163840;1331472;1331472;1382400;1489964;1337536;1546240;;;;;;
640179,671;158640;7453;162816;1331472;1331472;1382400;1490112;1338925;1545216;;;;;;
640193,428;159005;7702;163328;1331472;1331472;1382400;1490477;1339174;1545728;;;;;;
640201,628;159254;6547;163328;1331472;1331472;1382400;1490726;1338019;1545728;;;;;;
640218,735;158099;7420;159232;1331472;1331471;1382400;1489571;1338891;1541632;;;;;;
640237,643;158972;6369;163328;1331471;1331472;1382400;1490443;1337841;1545728;;;;;;
640324,314;157409;6415;162816;1331472;1331472;1382400;1488881;1337887;1545216;;;;;;
640357,293;157414;8850;161792;1331472;1331472;1382400;1488886;1340322;1544192;;;;;;
640380,102;159378;10208;160768;1331472;1331472;1382400;1490850;1341680;1543168;;;;;;
640421,083;160736;10051;160768;1331472;1331471;1382400;1492208;1341522;1543168;;;;;;
640442,825;157507;8145;161280;1331471;1331592;1382400;1488978;1339737;1543680;;;;;;
640481,888;155601;9798;160256;1331592;1331824;1382400;1487193;1341622;1542656;;;;;;
640527,801;156230;11051;157696;1331824;1331960;1382400;1488054;1343011;1540096;;;;;;
640545,506;157483;11357;159232;1331960;1332176;1382400;1489443;1343533;1541632;;;;;;
640577,928;155741;9407;159744;1332176;1332720;1382400;1487917;1342127;1542144;;;;;;
640627,178;153791;8543;160256;1332720;1333312;1382400;1486511;1341855;1542656;;;;;;
640847,184;153439;8752;159744;1333312;1333872;1382400;1486751;1342624;1542144;;;;;;
640872,625;153648;11361;159744;1333872;1334584;1382400;1487520;1345945;1542144;;;;;;
640880,713;156769;7939;160256;1334584;1334864;1382400;1491353;1342803;1542656;;;;;;
640932,183;153347;10547;159744;1334864;1335144;1382400;1488211;1345691;1542144;;;;;;
640978,006;155955;10632;160256;1335144;1335368;1382400;1491099;1346000;1542656;;;;;;
641007,809;156040;9023;160768;1335368;1335560;1382400;1491408;1344583;1543168;;;;;;
641026,644;154943;8878;160256;1335560;1335976;1382400;1490503;1344854;1542656;;;;;;
641036,749;154798;8846;161792;1335976;1336292;1382400;1490774;1345138;1544192;;;;;;
641083,284;156814;10747;161280;1336292;1336988;1382400;1493106;1347735;1543680;;;;;;
641120,285;158715;8859;161792;1336988;1337332;1382400;1495703;1346191;1544192;;;;;;
641141,740;156827;9758;161280;1337332;1337756;1382400;1494159;1347514;1543680;;;;;;
641158,494;157726;7841;162304;1337756;1338355;1382400;1495482;1346196;1544704;;;;;;
641164,258;156833;8180;161792;1338355;1338827;1382400;1495188;1347007;1544192;;;;;;
641175,795;157172;9429;162304;1338827;1338988;1382400;1495999;1348417;1544704;;;;;;
641189,560;158933;9054;162304;1338988;1339252;1382400;1497921;1348306;1544704;;;;;;
641210,306;158558;9504;162816;1339252;1339412;1382400;1497810;1348916;1545216;;;;;;
641225,117;160032;10181;162816;1339412;1339891;1382400;1499444;1350072;1545216;;;;;;
641234,538;160709;8344;162816;1339891;1340051;1382400;1500600;1348395;1545216;;;;;;
641241,527;158872;10621;162816;1340051;1340652;1382400;1498923;1351273;1545216;;;;;;
641245,093;161149;6841;162816;1340652;1342023;1382400;1501801;1348864;1545216;;;;;;
641250,127;157369;7375;162816;1342023;1342463;1382400;1499392;1349838;1545216;;;;;;
641256,428;157903;8387;162816;1342463;1343007;1382400;1500366;1351394;1545216;;;;;;
641286,162;158915;8337;162816;1343007;1343423;1382400;1501922;1351760;1545216;;;;;;
641296,710;158865;6575;162304;1343423;1344055;1382400;1502288;1350630;1544704;;;;;;
641319,840;157103;9415;162816;1344055;1344756;1382400;1501158;1354171;1545216;;;;;;
641338,174;159943;5743;162816;1344756;1345580;1382400;1504699;1351323;1545216;;;;;;
641368,455;156271;7733;162816;1345580;1346477;1382400;1501851;1354210;1545216;;;;;;
641379,352;158261;5362;162304;1346477;1347077;1382400;1504738;1352439;1544704;;;;;;
641386,995;155890;4975;162816;1347077;1347285;1382400;1502967;1352260;1545216;;;;;;
641392,491;155503;8424;162816;1347285;1348348;1382400;1502788;1356772;1545216;;;;;;
641407,112;158952;4578;162816;1348348;1348949;1382400;1507300;1353527;1545216;;;;;;
641414,189;155106;3940;162816;1348949;1349660;1382400;1504055;1353600;1545216;;;;;;
641440,087;154468;6532;162816;1349660;1350404;1382400;1504128;1356936;1545216;;;;;;
641457,312;157060;3152;162304;1350404;1351020;1382400;1507464;1354172;1544704;;;;;;
641490,801;153680;7571;162816;1351020;1351604;1382400;1504700;1359175;1545216;;;;;;
641510,742;158099;4031;163328;1351604;1351604;1382400;1509703;1355635;1545728;;;;;;
641528,237;155583;5651;163328;1351604;1351604;1382400;1507187;1357255;1545728;;;;;;
641537,567;157203;6390;163840;1351604;1351604;1382400;1508807;1357994;1546240;;;;;;
641542,880;158454;4416;163328;1351604;1351892;1382400;1510058;1356308;1545728;;;;;;
641566,889;156480;3536;164352;1351892;1353138;1382400;1508372;1356674;1546752;;;;;;
641578,585;157136;5590;164352;1353138;1353401;1382400;1510274;1358991;1546752;;;;;;
641588,146;159190;4359;164864;1353401;1353754;1382400;1512591;1358113;1547264;;;;;;
641599,390;158471;4710;164352;1353754;1354290;1382400;1512225;1359000;1546752;;;;;;
641624,799;158822;5503;165376;1354290;1355265;1382400;1513112;1360768;1547776;;;;;;
641653,320;160639;5215;164864;1355265;1355617;1382400;1515904;1360832;1547264;;;;;;
641667,682;160351;6589;165888;1355617;1355617;1382400;1515968;1362206;1548288;;;;;;
641700,882;163261;4418;165888;1355617;1355617;1382400;1518878;1360035;1548288;;;;;;
641709,207;161090;4628;165888;1355617;1355617;1382400;1516707;1360245;1548288;;;;;;
641732,463;161300;6020;165888;1355617;1355618;1382400;1516917;1361638;1548288;;;;;;
641740,613;162692;4834;166400;1355618;1355617;1382400;1518310;1360451;1548800;;;;;;
641752,510;162530;4560;166400;1355617;1356145;1382400;1518147;1360705;1548800;;;;;;
641764,440;162256;3952;166400;1356145;1356825;1382400;1518401;1360777;1548800;;;;;;
641781,214;161648;8695;166400;1356825;1357593;1382400;1518473;1366288;1548800;;;;;;
641792,023;166391;4608;164352;1357593;1357897;1382400;1523984;1362505;1546752;;;;;;
641799,431;160194;5460;165376;1359679;1359919;1382400;1519873;1365379;1547776;;;;;;
641814,076;161108;9189;162816;1359923;1360827;1382400;1521031;1370016;1545216;;;;;;
641824,900;162789;5200;164352;1360827;1361348;1382400;1523616;1366548;1546752;;;;;;
641856,224;158800;4337;164864;1361348;1362572;1382400;1520148;1366909;1547264;;;;;;
641875,152;158961;6163;164864;1362572;1362996;1382400;1521533;1369159;1547264;;;;;;
641895,979;160787;4551;165376;1362996;1362996;1382400;1523783;1367547;1547776;;;;;;
641918,487;160199;5197;165376;1362996;1362995;1382400;1523195;1368192;1547776;;;;;;
641929,206;160845;5150;165888;1362995;1362996;1382400;1523840;1368146;1548288;;;;;;
641938,738;161822;8706;165888;1362996;1362996;1382400;1524818;1371702;1548288;;;;;;
641947,398;165378;6190;164864;1362996;1363612;1382400;1528374;1369802;1547264;;;;;;
641966,221;161838;7088;165376;1363612;1363740;1382400;1525450;1370828;1547776;;;;;;
641971,043;162736;7168;165376;1363740;1363844;1382400;1526476;1371012;1547776;;;;;;
642003,349;162816;7414;165376;1363844;1364715;1382400;1526660;1372129;1547776;;;;;;
642018,927;163062;5297;165376;1364715;1365578;1382400;1527777;1370875;1547776;;;;;;
642059,124;160927;6506;165376;1365578;1366282;1382400;1526505;1372788;1547776;;;;;;
642078,597;162154;6436;165888;1366282;1366282;1382400;1528436;1372718;1548288;;;;;;
642108,290;162596;6040;165376;1366282;1366281;1382400;1528878;1372321;1547776;;;;;;
642120,907;162200;7775;165888;1366281;1366282;1382400;1528481;1374057;1548288;;;;;;
642140,666;164447;8612;165376;1366282;1366282;1382400;1530729;1374894;1547776;;;;;;
642160,195;165284;9439;163328;1366282;1366282;1382400;1531566;1375721;1545728;;;;;;
642174,383;163039;8913;162816;1366282;1366281;1382400;1529321;1375194;1545216;;;;;;
642214,351;162513;10447;162816;1366281;1366282;1382400;1528794;1376729;1545216;;;;;;
642234,038;161999;10515;162304;1366282;1366282;1382400;1528281;1376797;1544704;;;;;;
642243,348;162067;11598;160256;1366282;1366282;1382400;1528349;1377880;1542656;;;;;;
642256,819;159054;9664;161280;1366282;1366658;1382400;1525336;1376322;1543680;;;;;;
642287,013;157120;9504;161280;1366658;1366954;1382400;1523778;1376458;1543680;;;;;;
642295,460;156960;11046;158720;1366954;1367522;1382400;1523914;1378568;1541120;;;;;;
642315,623;158502;11646;159744;1367522;1368082;1382400;1526024;1379728;1542144;;;;;;
642329,350;157054;11661;157184;1368082;1368218;1382400;1525136;1379879;1539584;;;;;;
642336,989;157069;12069;158720;1368218;1368794;1382400;1525287;1380863;1541120;;;;;;
642345,613;155429;12014;159232;1368794;1369482;1382400;1524223;1381496;1541632;;;;;;
642351,164;155374;9981;159744;1369482;1370442;1382400;1524856;1380423;1542144;;;;;;
642357,314;153853;9736;159232;1370442;1371880;1382400;1524295;1381616;1541632;;;;;;
642365,441;153608;7199;160256;1371880;1373057;1382400;1525488;1380256;1542656;;;;;;
642389,329;152607;9256;160256;1373057;1373880;1382400;1525664;1383136;1542656;;;;;;
642398,459;154664;7791;160768;1373880;1374488;1382400;1528544;1382279;1543168;;;;;;
642452,602;154223;7971;160768;1374488;1375641;1382400;1528711;1383612;1543168;;;;;;
642507,528;154403;7187;161280;1375641;1376929;1382400;1530044;1384116;1543680;;;;;;
642516,325;154643;8305;161280;1376929;1377144;1382400;1531572;1385449;1543680;;;;;;
642523,356;155761;5983;160768;1377144;1377776;1382400;1532905;1383759;1543168;;;;;;
642530,445;153439;4687;161280;1377776;1378688;1382400;1531215;1383375;1543680;;;;;;
642549,225;152143;6334;161280;1378688;1380008;1382400;1530831;1386342;1543680;;;;;;
642579,585;153790;5346;161280;1380008;1380913;1382400;1533798;1386259;1543680;;;;;;
642579,622;5346;0;161280;1380913;1312878;1376768;1386259;1312878;1538048;189428;186748;786432;1575687;1499626;2324480
642591,160;147456;6599;161792;1312878;1312879;1376768;1460334;1319478;1538560;;;;;;
642614,094;155079;2274;161792;1312879;1316405;1376768;1467958;1318679;1538560;;;;;;
642635,037;150754;1872;160768;1316405;1316549;1376768;1467159;1318421;1537536;;;;;;
642638,506;149328;736;148480;1316549;1318105;1376768;1465877;1318841;1525248;;;;;;
642647,042;148192;816;160768;1318105;1318345;1376768;1466297;1319161;1537536;;;;;;
642653,801;147248;923;160768;1318345;1318594;1376768;1465593;1319517;1537536;;;;;;
642682,101;147355;6680;161280;1318594;1318865;1376768;1465949;1325545;1538048;;;;;;
642720,977;153624;672;160768;1318865;1321185;1376768;1472489;1321857;1537536;;;;;;
642728,530;147616;865;161280;1321185;1321473;1376768;1468801;1322338;1538048;;;;;;
642757,677;148321;4591;161280;1321473;1321634;1376768;1469794;1326225;1538048;;;;;;
642781,718;152047;928;162304;1321634;1323841;1376768;1473681;1324769;1539072;;;;;;
642828,391;150432;6720;162304;1323841;1323842;1376768;1474273;1330562;1539072;;;;;;
642845,419;156046;6431;162304;1323842;1323841;1376768;1479888;1330272;1539072;;;;;;
642852,972;155935;5204;162304;1323841;1323842;1376768;1479776;1329046;1539072;;;;;;
642856,608;154708;5251;163328;1323842;1324234;1376768;1478550;1329485;1540096;;;;;;
642860,922;156291;2162;162816;1324234;1327448;1376768;1480525;1329610;1539584;;;;;;
642879,503;153202;2192;163840;1327448;1327920;1376768;1480650;1330112;1540608;;;;;;
642890,793;154768;4868;163840;1327920;1328608;1376768;1482688;1333476;1540608;;;;;;
642905,895;157444;5906;164352;1328608;1329232;1376768;1486052;1335138;1541120;;;;;;
642917,268;159506;993;164352;1329232;1331458;1376768;1488738;1332451;1541120;;;;;;
642943,094;154593;833;164352;1331458;1331793;1376768;1486051;1332626;1541120;;;;;;
642991,870;154433;848;164352;1331793;1331953;1376768;1486226;1332801;1541120;;;;;;
643009,496;154448;1507;164864;1331953;1331954;1376768;1486401;1333461;1541632;;;;;;
643072,946;156131;6036;164864;1331954;1331954;1376768;1488085;1337990;1541632;;;;;;
643086,142;160660;4146;164864;1331954;1331953;1376768;1492614;1336099;1541632;;;;;;
643106,789;158770;7674;162304;1331953;1331954;1376768;1490723;1339628;1539072;;;;;;
643125,461;162298;7340;163328;1331954;1331954;1376768;1494252;1339294;1540096;;;;;;
643139,295;159916;7875;160768;1331954;1331954;1376768;1491870;1339829;1537536;;;;;;
643148,178;160451;7312;162816;1331954;1331954;1376768;1492405;1339266;1539584;;;;;;
643153,223;157840;7090;162816;1331954;1332106;1376768;1489794;1339196;1539584;;;;;;
643162,550;157618;9930;160768;1332106;1332994;1376768;1489724;1342924;1537536;;;;;;
643169,385;158410;5854;161792;1332994;1333970;1376768;1491404;1339824;1538560;;;;;;
643176,414;154334;4671;162816;1333970;1335259;1376768;1488304;1339930;1539584;;;;;;
643182,490;154687;7128;162304;1335259;1335939;1376768;1489946;1343067;1539072;;;;;;
643198,747;157144;4624;163328;1335939;1337018;1376768;1493083;1341642;1540096;;;;;;
643221,737;155664;3232;162816;1337018;1338162;1376768;1492682;1341394;1539584;;;;;;
643249,287;154272;5445;163840;1338162;1339110;1376768;1492434;1344555;1540608;;;;;;
643261,111;157509;4388;163328;1339110;1339807;1376768;1496619;1344195;1540096;;;;;;
643274,818;156452;1909;164352;1339807;1342006;1376768;1496259;1343915;1541120;;;;;;
643283,494;155509;4914;164352;1342006;1342422;1376768;1497515;1347336;1541120;;;;;;
643294,540;158514;992;164864;1342422;1344767;1376768;1500936;1345759;1541632;;;;;;
643313,099;155616;8691;163328;1344767;1345159;1376768;1500383;1353850;1540096;;;;;;
643344,680;163315;4767;164352;1345159;1346143;1376768;1508474;1350910;1541120;;;;;;
643369,182;157855;3592;163840;1346143;1346143;1376768;1503998;1349735;1540608;;;;;;
643399,268;156680;5955;164864;1346143;1346143;1376768;1502823;1352098;1541632;;;;;;
643435,291;160579;4480;164864;1346143;1346143;1376768;1506722;1350623;1541632;;;;;;
643446,730;159104;5839;165376;1346143;1346143;1376768;1505247;1351982;1542144;;;;;;
643459,910;161487;5455;165376;1346143;1346143;1376768;1507630;1351598;1542144;;;;;;
643473,876;161103;5647;165888;1346143;1346143;1376768;1507246;1351790;1542656;;;;;;
643487,641;161807;7779;165376;1346143;1346143;1376768;1507950;1353922;1542144;;;;;;
643502,639;163939;5839;165376;1346143;1346711;1376768;1510082;1352550;1542144;;;;;;
643510,090;161487;5916;165376;1346711;1347063;1376768;1508198;1352979;1542144;;;;;;
643514,165;161564;4736;165888;1347063;1348078;1376768;1508627;1352814;1542656;;;;;;
643535,925;161408;5812;165888;1348078;1349047;1376768;1509486;1354859;1542656;;;;;;
643661,347;162484;3648;165888;1349047;1349870;1376768;1511531;1353518;1542656;;;;;;
643748,490;160320;4272;165888;1349870;1350014;1376768;1510190;1354286;1542656;;;;;;
643767,037;160944;7027;165376;1350014;1350015;1376768;1510958;1357042;1542144;;;;;;
643796,168;163699;8077;164864;1350015;1350015;1376768;1513714;1358092;1541632;;;;;;
643844,996;164749;7841;164352;1350015;1350015;1376768;1514764;1357856;1541120;;;;;;
643859,307;162465;8272;163328;1350015;1350014;1376768;1512480;1358286;1540096;;;;;;
643866,999;162896;7203;164352;1350014;1350014;1376768;1512910;1357217;1541120;;;;;;
643881,922;160803;10733;164352;1350014;1350182;1376768;1510817;1360915;1541120;;;;;;
643910,305;164333;8675;161280;1350182;1350751;1376768;1514515;1359426;1538048;;;;;;
643923,053;159203;8073;162816;1350751;1350750;1376768;1509954;1358823;1539584;;;;;;
643934,520;158601;7184;163328;1350750;1350894;1376768;1509351;1358078;1540096;;;;;;
643944,059;158224;8886;162816;1350894;1351278;1376768;1509118;1360164;1539584;;;;;;
643954,622;159926;5888;163328;1351278;1352701;1376768;1511204;1358589;1540096;;;;;;
643970,699;157440;8017;163328;1352701;1353549;1376768;1510141;1361566;1540096;;;;;;
643988,002;159569;7220;163840;1353549;1353893;1376768;1513118;1361113;1540608;;;;;;
644080,169;159284;9070;163328;1353893;1354630;1376768;1513177;1363700;1540096;;;;;;
644120,767;161134;9502;163328;1354630;1354630;1376768;1515764;1364132;1540096;;;;;;
644132,616;161054;7536;163328;1354630;1354630;1376768;1515684;1362166;1540096;;;;;;
644171,487;159088;9203;163328;1354630;1354630;1376768;1513718;1363833;1540096;;;;;;
644181,055;160755;8078;163328;1354630;1354630;1376768;1515385;1362708;1540096;;;;;;
644198,286;159592;9242;163328;1354630;1354630;1376768;1514222;1363872;1540096;;;;;;
644217,914;160794;11268;163328;1354630;1354630;1376768;1515424;1365898;1540096;;;;;;
644239,366;162820;10515;160256;1354630;1354630;1376768;1517450;1365145;1537024;;;;;;
644259,992;158995;13283;161792;1354630;1356068;1376768;1513625;1369351;1538560;;;;;;
644264,289;161763;10544;158720;1356068;1356540;1376768;1517831;1367084;1535488;;;;;;
644279,002;155952;12813;158720;1356540;1357428;1376768;1512492;1370241;1535488;;;;;;
644303,730;158221;8559;159744;1357428;1358564;1376768;1515649;1367123;1536512;;;;;;
644334,049;152431;7343;159232;1358564;1359836;1376768;1510995;1367179;1536000;;;;;;
644348,609;151215;10573;160256;1359836;1360595;1376768;1511051;1371168;1537024;;;;;;
644353,243;155981;6639;160256;1360595;1361124;1376768;1516576;1367763;1537024;;;;;;
644365,323;152047;6223;160256;1361124;1362265;1376768;1513171;1368488;1537024;;;;;;
644383,341;151631;5222;160256;1362265;1363152;1376768;1513896;1368374;1537024;;;;;;
644430,665;150630;7791;160768;1363152;1364112;1376768;1513782;1371903;1537536;;;;;;
644456,881;153711;7031;160256;1364112;1364376;1376768;1517823;1371407;1537024;;;;;;
644467,899;152951;7779;161280;1364376;1364376;1376768;1517327;1372155;1538048;;;;;;
644511,298;154454;5769;160768;1364376;1365040;1376768;1518830;1370809;1537536;;;;;;
644554,102;152713;8646;161792;1365040;1365040;1376768;1517753;1373686;1538560;;;;;;
644565,520;157126;6016;161792;1365040;1365040;1376768;1522166;1371056;1538560;;;;;;
644612,910;154496;9206;161792;1365040;1365040;1376768;1519536;1374246;1538560;;;;;;
644710,720;157686;7071;161792;1365040;1365040;1376768;1522726;1372111;1538560;;;;;;
644751,944;155551;8755;162304;1365040;1365040;1376768;1520591;1373795;1539072;;;;;;
644772,733;158259;9812;162304;1365040;1365040;1376768;1523299;1374852;1539072;;;;;;
644800,456;159316;12768;159232;1365040;1365619;1376768;1524356;1378387;1536000;;;;;;
644813,050;159200;8502;160768;1365619;1366130;1376768;1524819;1374632;1537536;;;;;;
644848,104;154934;10551;161280;1366130;1366131;1376768;1521064;1376682;1538048;;;;;;
644858,140;158007;9074;161280;1366131;1366131;1376768;1524138;1375205;1538048;;;;;;
644898,284;156530;11315;160256;1366131;1366587;1376768;1522661;1377902;1537024;;;;;;
644966,532;157747;8913;160768;1366587;1367187;1376768;1524334;1376100;1537536;;;;;;
644994,379;155345;11597;160256;1367187;1367650;1376768;1522532;1379247;1537024;;;;;;
645010,173;158029;9572;160768;1367650;1368051;1376768;1525679;1377623;1537536;;;;;;
645028,842;156004;10383;161280;1368051;1368378;1376768;1524055;1378761;1538048;;;;;;
645081,800;157839;9878;161280;1368378;1368778;1376768;1526217;1378656;1538048;;;;;;
645137,765;157213;9998;161792;1368778;1369011;1376768;1525991;1379009;1538560;;;;;;
645164,498;158478;8447;161792;1369011;1369499;1376768;1527489;1377946;1538560;;;;;;
645204,761;156927;10262;161792;1369499;1369938;1376768;1526426;1380200;1538560;;;;;;
645246,630;158742;8591;161792;1369938;1370355;1376768;1528680;1378946;1538560;;;;;;
645269,906;157071;8177;162304;1370355;1371028;1376768;1527426;1379205;1539072;;;;;;
645283,837;157681;9957;162304;1371028;1371337;1376768;1528709;1381294;1539072;;;;;;
645322,455;159461;9669;162816;1371337;1371497;1376768;1530798;1381166;1539584;;;;;;
645341,256;159685;10710;162304;1371497;1372040;1376768;1531182;1382750;1539072;;;;;;
645390,418;160726;10515;162304;1372040;1372201;1376768;1532766;1382716;1539072;;;;;;
645477,251;160019;8911;162304;1372201;1372656;1376768;1532220;1381567;1539072;;;;;;
645500,141;158415;11253;162304;1372656;1372680;1376768;1531071;1383933;1539072;;;;;;
645506,827;160757;12787;162304;1372680;1373146;1376768;1533437;1385933;1539072;;;;;;
645521,812;162291;10515;160256;1373146;1374137;1376768;1535437;1384652;1537024;;;;;;
645539,354;157971;12270;159744;1374137;1374945;1376768;1532108;1387215;1536512;;;;;;
645558,482;159726;10803;161280;1374945;1375401;1376768;1534671;1386204;1538048;;;;;;
645571,164;157747;10494;160768;1375401;1376393;1376768;1533148;1386887;1537536;;;;;;
645571,189;10494;0;160768;1376393;1321162;1383936;1386887;1321162;1544704;188925;186570;786432;1575812;1507732;2331136
645602,535;146944;2360;159232;1321162;1321163;1383936;1468106;1323523;1543168;;;;;;
645611,934;147768;5646;160256;1321163;1321163;1383936;1468931;1326809;1544192;;;;;;
645619,008;151054;5242;160256;1321163;1321163;1383936;1472217;1326405;1544192;;;;;;
645637,557;150650;7370;160256;1321163;1321163;1383936;1471813;1328533;1544192;;;;;;
645657,565;152778;6121;160768;1321163;1321163;1383936;1473941;1327284;1544704;;;;;;
645677,254;152041;10330;160256;1321163;1321163;1383936;1473204;1331493;1544192;;;;;;
645687,303;156250;9358;160768;1321163;1322237;1383936;1477413;1331595;1544704;;;;;;
645703,444;155278;5631;160256;1322237;1322973;1383936;1477515;1328604;1544192;;;;;;
645723,545;151551;5619;160768;1322973;1323957;1383936;1474524;1329576;1544704;;;;;;
645748,120;152051;5452;160768;1323957;1324564;1383936;1476008;1330016;1544704;;;;;;
645772,357;151884;7467;161280;1324564;1324564;1383936;1476448;1332031;1545216;;;;;;
645782,240;154411;5795;160768;1324564;1324564;1383936;1478975;1330359;1544704;;;;;;
645881,849;152739;6980;162304;1324564;1325292;1383936;1477303;1332272;1546240;;;;;;
645917,124;155972;9539;161792;1325292;1325292;1383936;1481264;1334831;1545728;;;;;;
645945,152;158531;9630;161792;1325292;1325293;1383936;1483823;1334923;1545728;;;;;;
645971,736;158110;12245;160768;1325293;1325292;1383936;1483403;1337537;1544704;;;;;;
646013,199;160725;9670;160768;1325292;1325293;1383936;1486017;1334963;1544704;;;;;;
646029,047;156102;8271;160768;1325293;1325292;1383936;1481395;1333563;1544704;;;;;;
646039,518;154703;9231;161280;1325292;1325293;1383936;1479995;1334524;1545216;;;;;;
646061,328;156687;8049;161280;1325293;1325853;1383936;1481980;1333902;1545216;;;;;;
646100,961;155505;9489;161792;1325853;1326349;1383936;1481358;1335838;1545728;;;;;;
646207,365;157848;9555;161792;1326348;1326349;1383936;1484196;1335904;1545728;;;;;;
646251,561;158035;11091;161280;1326349;1326349;1383936;1484384;1337440;1545216;;;;;;
646302,716;159571;10867;159744;1326349;1326349;1383936;1485920;1337216;1543680;;;;;;
646330,779;159347;9519;161792;1326349;1326548;1383936;1485696;1336067;1545728;;;;;;
646355,822;157487;12285;160256;1326548;1327101;1383936;1484035;1339386;1544192;;;;;;
646374,302;160253;11348;160768;1327101;1327444;1383936;1487354;1338792;1544704;;;;;;
646419,608;157780;13799;160256;1327444;1329206;1383936;1485224;1343005;1544192;;;;;;
646422,892;160231;14829;156160;1329206;1330738;1383936;1489437;1345567;1540096;;;;;;
646727,903;156141;15356;156672;1330738;1331658;1383936;1486879;1347014;1540608;;;;;;
646938,569;156668;11359;157184;1331658;1331986;1383936;1488326;1343345;1541120;;;;;;
646977,248;150111;10221;156672;1331986;1332801;1383936;1482097;1343022;1540608;;;;;;
646988,192;148973;12712;157696;1332801;1333945;1383936;1481774;1346657;1541632;;;;;;
647034,349;153000;12794;157696;1333945;1334689;1383936;1486945;1347483;1541632;;;;;;
647063,727;153082;11825;158208;1334689;1335812;1383936;1487771;1347637;1542144;;;;;;
647081,090;152583;13667;157696;1335812;1336953;1383936;1488395;1350620;1541632;;;;;;
647090,126;154467;10673;158208;1336953;1338736;1383936;1491420;1349409;1542144;;;;;;
647109,770;151473;9439;157696;1338736;1339934;1383936;1490209;1349373;1541632;;;;;;
647115,931;150239;11924;158720;1339934;1341478;1383936;1490173;1353402;1542656;;;;;;
647132,898;153748;5974;158208;1341478;1343374;1383936;1495226;1349348;1542144;;;;;;
647149,464;147798;7407;158208;1343374;1344614;1383936;1491172;1352021;1542144;;;;;;
647165,666;148719;7379;158208;1344614;1345614;1383936;1493333;1352993;1542144;;;;;;
647196,250;148691;5569;158208;1345614;1347277;1383936;1494305;1352846;1542144;;;;;;
647201,014;146881;1392;142848;1347277;1350133;1383936;1494158;1351525;1526784;;;;;;
647215,771;142704;5308;157696;1350133;1351326;1383936;1492837;1356634;1541632;;;;;;
647230,255;145084;752;157184;1351326;1353871;1383936;1496410;1354623;1541120;;;;;;
647239,796;140528;711;157184;1353871;1354248;1383936;1494399;1354959;1541120;;;;;;
647258,168;139975;4932;157184;1354248;1354352;1383936;1494223;1359284;1541120;;;;;;
647277,992;144018;1418;157696;1354351;1356672;1383936;1498369;1358090;1541632;;;;;;
647318,356;141676;1407;157696;1356672;1356987;1383936;1498348;1358394;1541632;;;;;;
647335,987;141695;1777;158208;1356987;1356988;1383936;1498682;1358765;1542144;;;;;;
647540,359;143089;2113;158208;1356988;1356988;1383936;1500077;1359101;1542144;;;;;;
647545,428;143425;7692;159232;1356988;1356988;1383936;1500413;1364680;1543168;;;;;;
647548,611;151052;6948;159232;1356988;1357675;1383936;1508040;1364623;1543168;;;;;;
647556,604;150308;4160;160256;1357675;1358851;1383936;1507983;1363011;1544192;;;;;;
647569,850;149056;1255;159744;1358851;1361683;1383936;1507907;1362938;1543680;;;;;;
647601,580;146151;1264;160768;1361683;1362251;1383936;1507834;1363515;1544704;;;;;;
647654,703;147696;4771;160768;1362251;1362467;1383936;1509947;1367238;1544704;;;;;;
647668,499;151203;5389;162304;1362467;1362947;1383936;1513670;1368336;1546240;;;;;;
647682,444;154381;736;161792;1362947;1365529;1383936;1517328;1366265;1545728;;;;;;
647708,085;149728;5213;162816;1365529;1365866;1383936;1515257;1371079;1546752;;;;;;
647761,035;155229;5910;162304;1365866;1366428;1383936;1521095;1372338;1546240;;;;;;
647782,096;155926;5211;163328;1366428;1366428;1383936;1522354;1371639;1547264;;;;;;
647815,419;156251;3649;162816;1366428;1366427;1383936;1522679;1370076;1546752;;;;;;
647875,321;154689;5124;164352;1366427;1366428;1383936;1521116;1371552;1548288;;;;;;
647901,100;158212;4608;163840;1366428;1366427;1383936;1524640;1371035;1547776;;;;;;
647911,112;157696;5663;165376;1366427;1366427;1383936;1524123;1372090;1549312;;;;;;
647931,254;160799;3282;164864;1366427;1367309;1383936;1527226;1370591;1548800;;;;;;
647949,698;158418;7382;164352;1367309;1367429;1383936;1525727;1374811;1548288;;;;;;
647972,980;162006;5903;164864;1367429;1367581;1383936;1529435;1373484;1548800;;;;;;
647998,415;160527;4560;165376;1367581;1367581;1383936;1528108;1372141;1549312;;;;;;
648035,709;159696;4321;164864;1367581;1367581;1383936;1527277;1371902;1548800;;;;;;
648082,825;159457;4400;165888;1367581;1367581;1383936;1527038;1371981;1549824;;;;;;
648101,211;161072;4768;165888;1367581;1367581;1383936;1528653;1372349;1549824;;;;;;
648155,309;161440;5280;166912;1367581;1367581;1383936;1529021;1372861;1550848;;;;;;
648276,276;163488;5119;166400;1367581;1367581;1383936;1531069;1372700;1550336;;;;;;
648291,466;163327;5458;166912;1367581;1367581;1383936;1530908;1373039;1550848;;;;;;
648325,462;164178;5712;166912;1367581;1367581;1383936;1531759;1373293;1550848;;;;;;
648382,267;164432;7539;165888;1367581;1367581;1383936;1532013;1375120;1549824;;;;;;
648411,353;165235;8695;166400;1367581;1368391;1383936;1532816;1377086;1550336;;;;;;
648427,299;166391;8680;162304;1368391;1368747;1383936;1534782;1377427;1546240;;;;;;
648483,230;162280;10020;163840;1368747;1369211;1383936;1531027;1379231;1547776;;;;;;
648501,121;163620;7841;162816;1369211;1369211;1383936;1532831;1377052;1546752;;;;;;
648513,477;159393;8225;163328;1369211;1369211;1383936;1528604;1377436;1547264;;;;;;
648522,509;159777;9939;161280;1369211;1369572;1383936;1528988;1379511;1545216;;;;;;
648556,508;159443;7839;162304;1369572;1370197;1383936;1529015;1378036;1546240;;;;;;
648585,537;157343;8127;162816;1370197;1370277;1383936;1527540;1378404;1546752;;;;;;
648595,833;158655;9988;160768;1370277;1370277;1383936;1528932;1380265;1544704;;;;;;
648609,823;160516;8159;162304;1370277;1370656;1383936;1530793;1378815;1546240;;;;;;
648636,747;157663;8272;162304;1370656;1370919;1383936;1528319;1379191;1546240;;;;;;
648651,516;157776;7751;163328;1370919;1371288;1383936;1528695;1379039;1547264;;;;;;
648687,492;158791;7775;162816;1371288;1371672;1383936;1530079;1379447;1546752;;;;;;
648691,459;158815;8131;163840;1371672;1372208;1383936;1530487;1380339;1547776;;;;;;
648708,417;160195;8127;163328;1372208;1373216;1383936;1532403;1381343;1547264;;;;;;
648733,185;160191;6191;163840;1373216;1374248;1383936;1533407;1380439;1547776;;;;;;
648738,238;158767;5935;163840;1374248;1374960;1383936;1533015;1380895;1547776;;;;;;
648742,590;158511;7709;164352;1374960;1375527;1383936;1533471;1383236;1548288;;;;;;
648762,893;160797;8385;163840;1375527;1376159;1383936;1536324;1384544;1547776;;;;;;
648768,272;161473;5039;163328;1376159;1376456;1383936;1537632;1381495;1547264;;;;;;
648781,805;157615;5169;163840;1376456;1376927;1383936;1534071;1382096;1547776;;;;;;
648797,359;157745;4288;163840;1376927;1377663;1383936;1534672;1381951;1547776;;;;;;
648831,224;156864;3488;163840;1377663;1378286;1383936;1534527;1381774;1547776;;;;;;
648852,601;156064;2033;162816;1378286;1380182;1383936;1534350;1382215;1546752;;;;;;
648862,832;153585;1760;163328;1380182;1380590;1383936;1533767;1382350;1547264;;;;;;
648866,080;153312;3696;163840;1380590;1381166;1383936;1533902;1384862;1547776;;;;;;
648880,801;155760;3296;163328;1381166;1381294;1383936;1536926;1384590;1547264;;;;;;
648888,821;155360;4180;164352;1381294;1382181;1383936;1536654;1386361;1548288;;;;;;
648922,066;157268;3488;163840;1382181;1382613;1383936;1539449;1386101;1547776;;;;;;
648922,113;3488;0;163840;1382613;1331348;1394176;1386101;1331348;1558016;190135;186590;786432;1576236;1517938;2344448
648930,145;153088;2008;164352;1331348;1331348;1394176;1484436;1333356;1558528;;;;;;
648944,379;155608;832;164352;1331348;1332531;1394176;1486956;1333363;1558528;;;;;;
648948,126;154432;832;164352;1332531;1332915;1394176;1486963;1333747;1558528;;;;;;
648989,711;154432;3696;164352;1332915;1332931;1394176;1487347;1336627;1558528;;;;;;
649005,910;157296;944;165376;1332931;1335154;1394176;1490227;1336098;1559552;;;;;;
649026,086;156080;832;164864;1335154;1335394;1394176;1491234;1336226;1559040;;;;;;
649037,364;155968;960;165376;1335394;1335626;1394176;1491362;1336586;1559552;;;;;;
649123,648;156608;6099;161792;1335626;1335858;1394176;1492234;1341957;1555968;;;;;;
649155,019;161747;4863;165376;1335858;1335858;1394176;1497605;1340721;1559552;;;;;;
649165,451;159999;4063;164864;1335858;1335858;1394176;1495857;1339921;1559040;;;;;;
649177,848;159199;3232;165888;1335858;1336905;1394176;1495057;1340137;1560064;;;;;;
649199,526;159392;4783;165376;1336905;1337794;1394176;1496297;1342577;1559552;;;;;;
649212,961;160943;6450;164864;1337794;1338057;1394176;1498737;1344507;1559040;;;;;;
649232,061;162098;5311;165376;1338057;1338666;1394176;1500155;1343977;1559552;;;;;;
649240,663;160959;3360;165888;1338666;1339169;1394176;1499625;1342529;1560064;;;;;;
649247,289;160032;864;165888;1339169;1341697;1394176;1499201;1342561;1560064;;;;;;
649290,428;157535;656;165888;1341697;1342041;1394176;1499232;1342697;1560064;;;;;;
649320,698;157328;1262;165888;1342041;1342441;1394176;1499369;1343703;1560064;;;;;;
649599,796;157934;1375;166400;1342441;1342658;1394176;1500375;1344033;1560576;;;;;;
649615,412;159071;2022;166400;1342658;1343457;1394176;1501729;1345479;1560576;;;;;;
649627,714;159718;4324;166912;1343457;1343849;1394176;1503175;1348173;1561088;;;;;;
649639,266;163044;1484;166912;1343849;1345914;1394176;1506893;1347398;1561088;;;;;;
649659,573;160204;1562;167424;1345914;1346457;1394176;1506118;1348019;1561600;;;;;;
649665,820;160794;928;166912;1346457;1346889;1394176;1507251;1347817;1561088;;;;;;
649686,647;160160;1236;167936;1346889;1347161;1394176;1507049;1348397;1562112;;;;;;
649723,634;161492;4048;167424;1347161;1347425;1394176;1508653;1351473;1561600;;;;;;
649782,248;164304;544;167936;1347425;1349745;1394176;1511729;1350289;1562112;;;;;;
649811,042;160800;2256;167424;1349745;1349745;1394176;1510545;1352001;1561600;;;;;;
649832,393;162512;1649;168448;1349745;1349745;1394176;1512257;1351394;1562624;;;;;;
649875,649;162929;1901;167936;1349745;1349745;1394176;1512674;1351646;1562112;;;;;;
649887,058;163181;1760;168960;1349745;1349745;1394176;1512926;1351505;1563136;;;;;;
649925,778;164576;2080;168960;1349745;1349745;1394176;1514321;1351825;1563136;;;;;;
649957,190;164896;2593;169472;1349745;1349745;1394176;1514641;1352338;1563648;;;;;;
650003,590;166433;3361;169472;1349745;1349745;1394176;1516178;1353106;1563648;;;;;;
650059,006;167201;3585;169472;1349745;1349745;1394176;1516946;1353330;1563648;;;;;;
650086,569;167425;4144;168448;1349745;1349745;1394176;1517170;1353889;1562624;;;;;;
650143,126;167984;3215;168960;1349745;1349745;1394176;1517729;1352960;1563136;;;;;;
650163,776;166031;3567;168960;1349745;1349745;1394176;1515776;1353312;1563136;;;;;;
650177,645;166383;6143;164864;1349745;1352706;1394176;1516128;1358849;1559040;;;;;;
650214,993;164863;7249;166400;1352706;1353034;1394176;1517569;1360283;1560576;;;;;;
650220,390;165969;6655;164352;1353034;1353034;1394176;1519003;1359689;1558528;;;;;;
650230,838;162303;6484;165376;1353034;1353506;1394176;1515337;1359990;1559552;;;;;;
650281,610;162132;5840;165376;1353506;1354218;1394176;1515638;1360058;1559552;;;;;;
650391,788;161488;5343;165376;1354218;1354618;1394176;1515706;1359961;1559552;;;;;;
650403,936;160991;5344;165376;1354618;1354930;1394176;1515609;1360274;1559552;;;;;;
650458,444;160992;6643;165376;1354930;1355402;1394176;1515922;1362045;1559552;;;;;;
650478,708;162291;4533;165888;1355402;1356409;1394176;1517693;1360942;1560064;;;;;;
650523,099;160693;4352;165376;1356409;1356873;1394176;1517102;1361225;1559552;;;;;;
650567,623;160512;5568;166400;1356873;1356873;1394176;1517385;1362441;1560576;;;;;;
650590,435;162752;5265;165888;1356873;1356873;1394176;1519625;1362138;1560064;;;;;;
650663,726;162449;5424;166400;1356873;1356873;1394176;1519322;1362297;1560576;;;;;;
650747,671;163120;5200;166400;1356873;1356873;1394176;1519993;1362073;1560576;;;;;;
650758,419;162896;5698;166912;1356873;1356873;1394176;1519769;1362571;1561088;;;;;;
650831,571;164418;7780;166912;1356873;1356873;1394176;1521291;1364653;1561088;;;;;;
650851,454;166500;7488;164864;1356873;1356873;1394176;1523373;1364361;1559040;;;;;;
650856,331;164160;7002;163840;1356873;1357105;1394176;1521033;1364107;1558016;;;;;;
650862,276;163674;6544;165376;1357105;1357513;1394176;1520779;1364057;1559552;;;;;;
650870,814;162192;6258;165376;1357513;1357833;1394176;1519705;1364091;1559552;;;;;;
650929,606;161906;7827;164864;1357833;1358314;1394176;1519739;1366141;1559040;;;;;;
650946,219;163475;5615;165376;1358314;1359200;1394176;1521789;1364815;1559552;;;;;;
650957,507;161263;5151;165888;1359200;1359768;1394176;1520463;1364919;1560064;;;;;;
650991,534;161311;7043;165376;1359768;1360096;1394176;1521079;1367139;1559552;;;;;;
651024,389;163203;5167;165888;1360096;1360504;1394176;1523299;1365671;1560064;;;;;;
651030,374;161839;5010;165888;1360504;1360984;1394176;1522343;1365994;1560064;;;;;;
651054,634;161682;7475;165888;1360984;1361440;1394176;1522666;1368915;1560064;;;;;;
651077,047;164147;5220;165888;1361440;1362423;1394176;1525587;1367643;1560064;;;;;;
651088,841;161892;4448;165888;1362423;1362911;1394176;1524315;1367359;1560064;;;;;;
651098,035;161120;4112;165888;1362911;1363391;1394176;1524031;1367503;1560064;;;;;;
651110,472;160784;1824;165888;1363391;1365887;1394176;1524175;1367711;1560064;;;;;;
651129,254;158496;4836;165888;1365887;1366560;1394176;1524383;1371396;1560064;;;;;;
651138,470;161508;3879;165888;1366560;1367264;1394176;1528068;1371143;1560064;;;;;;
651148,655;160551;5653;165888;1367264;1367671;1394176;1527815;1373324;1560064;;;;;;
651166,465;162325;1056;165376;1367671;1369894;1394176;1529996;1370950;1559552;;;;;;
651169,013;157728;1088;165888;1369894;1370279;1394176;1527622;1371367;1560064;;;;;;
651178,043;157760;928;164864;1370279;1370582;1394176;1528039;1371510;1559040;;;;;;
651201,274;156576;4532;165376;1370582;1370967;1394176;1527158;1375499;1559552;;;;;;
651213,470;160180;2805;166400;1370967;1372927;1394176;1531147;1375732;1560576;;;;;;
651230,275;159989;832;165888;1372927;1373271;1394176;1532916;1374103;1560064;;;;;;
651277,929;158016;5125;165376;1373271;1373695;1394176;1531287;1378820;1559552;;;;;;
651287,127;161797;4707;165888;1373695;1374063;1394176;1535492;1378770;1560064;;;;;;
651298,267;161379;1894;166400;1374063;1376655;1394176;1535442;1378549;1560576;;;;;;
651312,276;159590;1184;166400;1376655;1377255;1394176;1536245;1378439;1560576;;;;;;
651362,539;158880;4581;166400;1377255;1377574;1394176;1536135;1382155;1560576;;;;;;
651419,675;162277;6482;164352;1377574;1378222;1394176;1539851;1384704;1558528;;;;;;
651437,973;164178;3537;166400;1378222;1378223;1394176;1542400;1381760;1560576;;;;;;
651445,227;160721;3852;165888;1378223;1378223;1394176;1538944;1382075;1560064;;;;;;
651457,149;161036;1756;166912;1378223;1380510;1394176;1539259;1382266;1561088;;;;;;
651496,148;160476;5205;166912;1380510;1380750;1394176;1540986;1385955;1561088;;;;;;
651533,564;163925;4620;166912;1380750;1381206;1394176;1544675;1385826;1561088;;;;;;
651545,317;163340;3968;166912;1381206;1381206;1394176;1544546;1385174;1561088;;;;;;
651574,546;162688;3872;167424;1381206;1381205;1394176;1543894;1385077;1561600;;;;;;
651606,178;163616;5168;167424;1381205;1381205;1394176;1544821;1386373;1561600;;;;;;
651623,629;164912;4288;167936;1381205;1381205;1394176;1546117;1385493;1562112;;;;;;
651633,893;164544;4576;167424;1381205;1381205;1394176;1545749;1385781;1561600;;;;;;
651645,198;164832;4432;167936;1381205;1381509;1394176;1546037;1385941;1562112;;;;;;
651683,164;165200;5728;166912;1381509;1381981;1394176;1546709;1387709;1561088;;;;;;
651726,749;166496;5377;167424;1381981;1381981;1394176;1548477;1387358;1561600;;;;;;
651733,403;165121;4772;167424;1381981;1381982;1394176;1547102;1386754;1561600;;;;;;
651746,625;164516;7435;166400;1381982;1382334;1394176;1546498;1389769;1560576;;;;;;
651763,483;166155;7011;165888;1382334;1382915;1394176;1548489;1389926;1560064;;;;;;
651771,275;165731;7075;165376;1382915;1383147;1394176;1548646;1390222;1559552;;;;;;
651785,655;163747;5169;165888;1383147;1383661;1394176;1546894;1388830;1560064;;;;;;
651796,351;161841;5089;166400;1383661;1383949;1394176;1545502;1389038;1560576;;;;;;
651831,278;162785;4014;166400;1383949;1385474;1394176;1546734;1389488;1560576;;;;;;
651861,528;161710;1742;165888;1385474;1387793;1394176;1547184;1389535;1560064;;;;;;
651890,175;159438;1823;166400;1387793;1388057;1394176;1547231;1389880;1560576;;;;;;
651949,447;159519;1822;166400;1388057;1388057;1394176;1547576;1389879;1560576;;;;;;
651960,482;159518;2185;166400;1388057;1388057;1394176;1547575;1390242;1560576;;;;;;
652009,303;159881;6271;165376;1388057;1388058;1394176;1547938;1394329;1559552;;;;;;
652017,450;162943;4526;165888;1388058;1388057;1394176;1551001;1392583;1560064;;;;;;
652025,672;161198;4352;166912;1388057;1388592;1394176;1549255;1392944;1561088;;;;;;
652063,642;162560;5630;166400;1388592;1389033;1394176;1551152;1394663;1560576;;;;;;
652074,862;163838;7757;165376;1389033;1389216;1394176;1552871;1396973;1559552;;;;;;
652086,989;164429;5924;165888;1389216;1389920;1394176;1553645;1395844;1560064;;;;;;
652099,630;162596;4512;165888;1389920;1390295;1394176;1552516;1394807;1560064;;;;;;
652132,193;161184;3456;165888;1390295;1391511;1394176;1551479;1394967;1560064;;;;;;
652138,889;160128;1600;165376;1391511;1393640;1394176;1551639;1395240;1559552;;;;;;
652138,952;1600;0;165376;1393640;1336709;1397760;1395240;1336709;1563136;187808;186622;786432;1583048;1523331;2349568
652175,946;156672;5330;165888;1336709;1336710;1397760;1493381;1342040;1563648;;;;;;
652188,230;162002;1824;166400;1336710;1339495;1397760;1498712;1341319;1564160;;;;;;
652213,987;159520;4577;166400;1339495;1339943;1397760;1499015;1344520;1564160;;;;;;
652230,809;162192;896;166400;1339943;1342215;1397760;1502135;1343111;1564160;;;;;;
652262,864;158592;4260;166400;1342215;1342759;1397760;1500807;1347019;1564160;;;;;;
652277,741;161956;3984;166912;1342759;1342759;1397760;1504715;1346743;1564672;;;;;;
652284,495;162704;6774;165888;1342759;1342759;1397760;1505463;1349533;1563648;;;;;;
652326,332;165494;5845;166400;1342759;1343455;1397760;1508253;1349300;1564160;;;;;;
652362,665;163541;6164;164352;1343455;1344280;1397760;1506996;1350444;1562112;;;;;;
652369,613;163860;3584;166400;1344280;1344736;1397760;1508140;1348320;1564160;;;;;;
652380,242;160768;2117;165888;1344736;1347768;1397760;1505504;1349885;1563648;;;;;;
652389,824;159301;945;166400;1347768;1348225;1397760;1507069;1349170;1564160;;;;;;
652405,440;158641;5061;166400;1348225;1348624;1397760;1506866;1353685;1564160;;;;;;
652412,513;162757;5633;165376;1348624;1349272;1397760;1511381;1354905;1563136;;;;;;
652426,089;162305;6707;163840;1349272;1350263;1397760;1511577;1356970;1561600;;;;;;
652430,827;163379;3808;165888;1350263;1353660;1397760;1513642;1357468;1563648;;;;;;
652436,890;159968;1703;165376;1353660;1355960;1397760;1513628;1357663;1563136;;;;;;
652446,129;157863;1079;165888;1355960;1356408;1397760;1513823;1357487;1563648;;;;;;
652478,666;157751;5364;165888;1356408;1356816;1397760;1514159;1362180;1563648;;;;;;
652516,834;162036;3268;166400;1356816;1357688;1397760;1518852;1360956;1564160;;;;;;
652524,497;160452;4212;165888;1357688;1358153;1397760;1518140;1362365;1563648;;;;;;
652536,209;161396;1130;166400;1358153;1360384;1397760;1519549;1361514;1564160;;;;;;
652576,805;158826;981;166400;1360384;1360824;1397760;1519210;1361805;1564160;;;;;;
652619,994;158677;4836;166400;1360824;1361064;1397760;1519501;1365900;1564160;;;;;;
652629,336;162532;1414;166400;1361064;1363232;1397760;1523596;1364646;1564160;;;;;;
652633,976;159110;992;166912;1363232;1363808;1397760;1522342;1364800;1564672;;;;;;
652641,123;159200;5011;166400;1363808;1363969;1397760;1523008;1368980;1564160;;;;;;
652655,806;163219;5834;165376;1363969;1364688;1397760;1527188;1370522;1563136;;;;;;
652678,399;162506;3317;165888;1364688;1365288;1397760;1527194;1368605;1563648;;;;;;
652697,722;159989;1232;166912;1365288;1367287;1397760;1525277;1368519;1564672;;;;;;
652714,727;159440;1040;166400;1367287;1367847;1397760;1526727;1368887;1564160;;;;;;
652740,381;159248;5027;165888;1367847;1368272;1397760;1527095;1373299;1563648;;;;;;
652748,728;162723;1125;166400;1368272;1370623;1397760;1530995;1371748;1564160;;;;;;
652764,382;158821;896;166912;1370623;1371047;1397760;1529444;1371943;1564672;;;;;;
652779,997;159616;896;166912;1371047;1371255;1397760;1530663;1372151;1564672;;;;;;
652830,839;159616;1009;167424;1371255;1371520;1397760;1530871;1372529;1565184;;;;;;
652877,086;160241;4257;166912;1371520;1371767;1397760;1531761;1376024;1564672;;;;;;
652890,362;163489;1088;167424;1371767;1373975;1397760;1535256;1375063;1565184;;;;;;
652913,225;160320;1072;166912;1373975;1374399;1397760;1534295;1375471;1564672;;;;;;
652935,849;160304;1376;167936;1374399;1374399;1397760;1534703;1375775;1565696;;;;;;
652979,578;161632;1760;167424;1374399;1374399;1397760;1536031;1376159;1565184;;;;;;
652985,130;162016;1872;168448;1374399;1374399;1397760;1536415;1376271;1566208;;;;;;
653062,519;163664;5836;167936;1374399;1375151;1397760;1538063;1380987;1565696;;;;;;
653078,749;167628;3503;167936;1375151;1375407;1397760;1542779;1378910;1565696;;;;;;
653083,816;164271;3714;167936;1375407;1375576;1397760;1539678;1379290;1565696;;;;;;
653096,349;164482;992;167936;1375576;1378070;1397760;1540058;1379062;1565696;;;;;;
653141,065;161760;1073;167936;1378070;1378543;1397760;1539830;1379616;1565696;;;;;;
653156,535;161841;960;168448;1378543;1379102;1397760;1540384;1380062;1566208;;;;;;
653178,397;162240;896;167936;1379102;1379454;1397760;1541342;1380350;1565696;;;;;;
653215,009;162176;1392;168960;1379454;1379734;1397760;1541630;1381126;1566720;;;;;;
653227,402;163696;3842;168448;1379734;1380158;1397760;1543430;1384000;1566208;;;;;;
653238,666;166146;1025;168960;1380158;1380510;1397760;1546304;1381535;1566720;;;;;;
653279,419;163329;784;168448;1380510;1380830;1397760;1543839;1381614;1566208;;;;;;
653329,896;163088;1040;168960;1380830;1381014;1397760;1543918;1382054;1566720;;;;;;
653389,922;163856;1200;168960;1381014;1381014;1397760;1544870;1382214;1566720;;;;;;
653423,501;164016;3411;168448;1381329;1381329;1397760;1545345;1384740;1566208;;;;;;
653441,050;166227;6137;168960;1381331;1383141;1397760;1547558;1389278;1566720;;;;;;
653461,509;168953;5495;164864;1383141;1383908;1397760;1552094;1389403;1562624;;;;;;
653477,688;164215;4469;166912;1383908;1383909;1397760;1548123;1388378;1564672;;;;;;
653499,836;163189;8165;163840;1383909;1384151;1397760;1547098;1392316;1561600;;;;;;
653511,215;163813;5823;161792;1384151;1385097;1397760;1547964;1390920;1559552;;;;;;
653532,415;161471;5408;164864;1385097;1385712;1397760;1546568;1391120;1562624;;;;;;
653550,566;160032;4784;164864;1385712;1386168;1397760;1545744;1390952;1562624;;;;;;
653560,792;159408;3969;165888;1386168;1387081;1397760;1545576;1391050;1563648;;;;;;
653607,418;160129;1537;165376;1387081;1389817;1397760;1547210;1391354;1563136;;;;;;
653721,330;157697;1503;165888;1389817;1390073;1397760;1547514;1391576;1563648;;;;;;
653744,394;158175;1375;165888;1390073;1390073;1397760;1548248;1391448;1563648;;;;;;
653804,948;158047;1890;166400;1390073;1390072;1397760;1548120;1391962;1564160;;;;;;
653832,312;159586;3839;166400;1390072;1390073;1397760;1549658;1393912;1564160;;;;;;
653891,370;161535;6083;165888;1390073;1390073;1397760;1551608;1396156;1563648;;;;;;
653906,720;163779;4303;166400;1390073;1390073;1397760;1553852;1394376;1564160;;;;;;
653913,508;161999;4871;166400;1390073;1390073;1397760;1552072;1394944;1564160;;;;;;
653940,458;162567;4143;166400;1390073;1390233;1397760;1552640;1394376;1564160;;;;;;
653979,237;161839;4511;166912;1390233;1390337;1397760;1552072;1394848;1564672;;;;;;
653999,329;163231;6035;164864;1390337;1390337;1397760;1553568;1396372;1562624;;;;;;
654020,166;164755;6742;165376;1390337;1390337;1397760;1555092;1397079;1563136;;;;;;
654036,343;163414;6575;163328;1390337;1390337;1397760;1553751;1396912;1561088;;;;;;
654054,773;163247;8791;163328;1390337;1390529;1397760;1553584;1399320;1561088;;;;;;
654059,941;162391;10735;164352;1390529;1391417;1397760;1552920;1402152;1562112;;;;;;
654082,863;164335;8338;160256;1391417;1392074;1397760;1555752;1400412;1558016;;;;;;
654108,157;157842;9582;159232;1392074;1392614;1397760;1549916;1402196;1556992;;;;;;
654119,174;159086;9696;159744;1392614;1392966;1397760;1551700;1402662;1557504;;;;;;
654147,295;156095;9292;160768;1394101;1394805;1397760;1550196;1404097;1558528;;;;;;
654172,165;155724;11254;158720;1394808;1395751;1397760;1550532;1407005;1556480;;;;;;
654184,634;155638;0;158720;1397759;1337220;1397760;1553397;1337220;1556480;187462;186544;786432;1740859;1523764;2342912
654205,154;144384;8026;159744;1337220;1337221;1397760;1481604;1345247;1557504;;;;;;
654223,533;152410;4965;160768;1337221;1337220;1397760;1489631;1342185;1558528;;;;;;
654236,684;150885;7508;160256;1337220;1337221;1397760;1488105;1344729;1558016;;;;;;
654245,487;153428;4128;161280;1337221;1339114;1397760;1490649;1343242;1559040;;;;;;
654249,342;151584;1088;148992;1339114;1342096;1397760;1490698;1343184;1546752;;;;;;
654285,445;148544;5652;161792;1342096;1342713;1397760;1490640;1348365;1559552;;;;;;
654308,427;153108;1152;160768;1342713;1345105;1397760;1495821;1346257;1558528;;;;;;
654331,537;148608;1024;161280;1345105;1345448;1397760;1493713;1346472;1559040;;;;;;
654415,276;148480;960;161280;1345448;1345760;1397760;1493928;1346720;1559040;;;;;;
654424,884;148416;1024;161792;1345760;1346337;1397760;1494176;1347361;1559552;;;;;;
654465,656;148992;7407;161280;1346337;1346777;1397760;1495329;1354184;1559040;;;;;;
654478,278;155375;3727;162304;1346777;1346777;1397760;1502152;1350504;1560064;;;;;;
654498,063;152207;6676;161280;1346777;1346777;1397760;1498984;1353453;1559040;;;;;;
654515,066;155156;5317;162816;1346777;1346777;1397760;1501933;1352094;1560576;;;;;;
654625,658;155333;4912;162304;1346777;1346777;1397760;1502110;1351689;1560064;;;;;;
654678,026;154928;7027;163328;1346777;1346777;1397760;1501705;1353804;1561088;;;;;;
654729,448;158579;6883;163328;1346777;1346777;1397760;1505356;1353660;1561088;;;;;;
654859,876;158435;9455;161280;1346777;1346777;1397760;1505212;1356232;1559040;;;;;;
654876,802;158959;6943;162304;1346777;1346777;1397760;1505736;1353720;1560064;;;;;;
655214,182;156447;10078;160768;1346777;1346777;1397760;1503224;1356855;1558528;;;;;;
655422,098;158558;7806;161792;1346777;1346777;1397760;1505335;1354583;1559552;;;;;;
655470,427;156286;7790;161792;1346777;1346777;1397760;1503063;1354567;1559552;;;;;;
655499,880;156270;7886;161792;1346777;1346777;1397760;1503047;1354663;1559552;;;;;;
655521,610;156366;10326;160256;1346777;1346777;1397760;1503143;1357103;1558016;;;;;;
655557,511;157782;8750;161280;1346777;1346777;1397760;1504559;1355527;1559040;;;;;;
655573,326;156206;8062;161792;1346777;1347609;1397760;1502983;1355671;1559552;;;;;;
655612,971;156030;9870;161280;1347609;1347801;1397760;1503639;1357671;1559040;;;;;;
655663,167;157838;10334;160256;1347801;1348473;1397760;1505639;1358807;1558016;;;;;;
655705,643;156766;14323;160768;1348473;1349459;1397760;1505239;1363782;1558528;;;;;;
655705,750;22686;13131;155648;1349459;1350187;1397760;1372145;1363318;1553408;;;;;;
655705,779;13131;0;155648;1350187;1345744;1397760;1363318;1345744;1553408;186882;186460;786432;1550200;1532204;2339840
655757,827;141262;5235;146944;1345745;1345745;1397760;1487007;1350980;1544704;;;;;;
655774,153;146547;6971;158720;1345745;1345744;1397760;1492292;1352715;1556480;;;;;;
655781,265;148795;5805;158208;1345744;1345744;1397760;1494539;1351549;1555968;;;;;;
655787,699;147629;4810;159232;1345744;1345745;1397760;1493373;1350555;1556992;;;;;;
655855,714;147658;4887;158720;1345745;1345744;1397760;1493403;1350631;1556480;;;;;;
655859,239;147566;5810;159744;1345744;1345745;1397760;1493310;1351555;1557504;;;;;;
655878,272;149682;5415;159232;1345745;1345744;1397760;1495427;1351159;1556992;;;;;;
655907,728;149287;5287;160768;1345744;1345744;1397760;1495031;1351031;1558528;;;;;;
655943,939;150961;6852;160256;1345744;1345744;1397760;1496705;1352596;1558016;;;;;;
655962,744;152772;10858;160256;1345744;1345745;1397760;1498516;1356603;1558016;;;;;;
655990,705;156780;6822;160768;1345745;1345745;1397760;1502525;1352567;1558528;;;;;;
655990,764;20387;11452;159232;1345744;1346487;1397760;1366131;1357939;1556992;;;;;;
655990,786;11452;0;159232;1346487;1344668;1397760;1357939;1344668;1556992;186460;186457;786432;1544399;1531125;2343424
656043,453;145403;1365;146944;1344668;1344668;1397760;1490071;1346033;1544704;;;;;;
656112,417;146773;6932;160768;1344668;1344668;1397760;1491441;1351600;1558528;;;;;;
656142,771;152340;3655;159744;1344668;1344668;1397760;1497008;1348323;1557504;;;;;;
656182,726;149063;5627;161280;1344668;1344669;1397760;1493731;1350296;1559040;;;;;;
656212,361;152571;5612;160768;1344669;1344668;1397760;1497240;1350280;1558528;;;;;;
656250,994;152556;6824;162304;1344668;1344668;1397760;1497224;1351492;1560064;;;;;;
656276,292;155816;10510;159744;1344668;1344668;1397760;1500484;1355178;1557504;;;;;;
656280,784;159502;9391;161280;1344668;1344668;1397760;1504170;1354059;1559040;;;;;;
656292,616;156847;9611;157184;1344668;1344668;1397760;1501515;1354279;1554944;;;;;;
656310,269;157067;11231;159744;1344668;1344668;1397760;1501735;1355899;1557504;;;;;;
656335,382;156437;10226;160256;1344668;1344668;1397760;1501105;1354894;1558016;;;;;;
656344,418;155634;9891;160256;1344668;1344867;1397760;1500302;1354758;1558016;;;;;;
656378,542;155299;11829;157696;1344867;1345700;1397760;1500166;1357529;1555456;;;;;;
656398,728;157237;9508;159744;1345700;1346716;1397760;1502937;1356224;1557504;;;;;;
656429,674;153380;10834;159232;1346716;1347931;1397760;1500096;1358765;1556992;;;;;;
656453,614;154706;7454;159744;1347931;1348604;1397760;1502637;1356058;1557504;;;;;;
656526,604;151838;7742;159744;1348604;1349380;1397760;1500442;1357122;1557504;;;;;;
656545,088;152126;9235;160768;1349380;1349379;1397760;1501506;1358614;1558528;;;;;;
656574,855;155155;7742;160256;1349379;1349380;1397760;1504534;1357122;1558016;;;;;;
656610,722;153662;7630;161280;1349380;1349380;1397760;1503042;1357010;1559040;;;;;;
656646,780;155086;8156;161280;1349380;1349379;1397760;1504466;1357535;1559040;;;;;;
656674,364;155612;8030;162304;1349379;1349380;1397760;1504991;1357410;1560064;;;;;;
656699,484;157022;8399;161792;1349380;1349379;1397760;1506402;1357778;1559552;;;;;;
656822,484;157283;12265;159744;1349380;1349879;1397760;1506663;1362144;1557504;;;;;;
656854,853;159721;13804;161280;1349879;1351474;1397760;1509600;1365278;1559040;;;;;;
656856,895;161260;13808;156160;1351474;1356138;1397760;1512734;1369946;1553920;;;;;;
656919,201;156120;13108;155648;1356139;1357362;1397760;1512259;1370470;1553408;;;;;;
656935,727;155444;13607;156160;1357362;1357931;1397760;1512806;1371538;1553920;;;;;;
656946,721;151335;12959;151040;1357931;1358699;1397760;1509266;1371658;1548800;;;;;;
656962,465;150687;12031;156672;1358699;1358867;1397760;1509386;1370898;1554432;;;;;;
656980,915;149759;12852;156160;1358867;1359451;1397760;1508626;1372303;1553920;;;;;;
656994,013;150580;12275;157184;1359451;1360067;1397760;1510031;1372342;1554944;;;;;;
657011,470;151027;4895;156672;1360067;1366578;1397760;1511094;1371473;1554432;;;;;;
657040,791;143647;3824;155648;1366578;1367561;1397760;1510225;1371385;1553408;;;;;;
657058,601;141040;3472;140800;1367561;1368233;1397760;1508601;1371705;1538560;;;;;;
657065,534;140688;1476;155648;1368233;1370745;1397760;1508921;1372221;1553408;;;;;;
657093,615;137668;3968;155648;1370745;1370921;1397760;1508413;1374889;1553408;;;;;;
657105,218;140160;4560;156160;1370921;1371810;1397760;1511081;1376370;1553920;;;;;;
657110,869;141264;2818;155648;1371810;1373810;1397760;1513074;1376628;1553408;;;;;;
657136,117;139522;1122;156672;1373810;1374378;1397760;1513332;1375500;1554432;;;;;;
657150,716;139362;5221;156672;1374378;1374658;1397760;1513740;1379879;1554432;;;;;;
657169,918;143461;1017;157696;1374658;1376898;1397760;1518119;1377915;1555456;;;;;;
657184,860;140793;1122;157184;1376898;1377010;1397760;1517691;1378132;1554944;;;;;;
657196,036;140898;6060;158720;1377010;1377282;1397760;1517908;1383342;1556480;;;;;;
657223,628;147372;1086;157696;1377282;1379717;1397760;1524654;1380803;1555456;;;;;;
657249,697;142398;800;159232;1379717;1380211;1397760;1522115;1381011;1556992;;;;;;
657289,275;144160;1457;159232;1380211;1380363;1397760;1524371;1381820;1556992;;;;;;
657305,725;144817;4863;160768;1380363;1380467;1397760;1525180;1385330;1558528;;;;;;
657322,699;150271;1602;159744;1380467;1382823;1397760;1530738;1384425;1557504;;;;;;
657343,735;147010;768;161792;1382823;1383166;1397760;1529833;1383934;1559552;;;;;;
657373,213;148736;2086;161280;1383166;1383167;1397760;1531902;1385253;1559040;;;;;;
657411,588;150054;1859;162816;1383167;1383167;1397760;1533221;1385026;1560576;;;;;;
657425,136;151875;7216;162304;1383167;1383166;1397760;1535042;1390382;1560064;;;;;;
657447,945;157232;4255;162816;1383166;1383167;1397760;1540398;1387422;1560576;;;;;;
657457,408;154271;5627;162304;1383167;1383167;1397760;1537438;1388794;1560064;;;;;;
657471,337;155643;5933;163328;1383167;1383351;1397760;1538810;1389284;1561088;;;;;;
657487,264;157485;5730;163328;1383351;1383455;1397760;1540836;1389185;1561088;;;;;;
657515,434;157282;6336;163328;1383455;1383623;1397760;1540737;1389959;1561088;;;;;;
657531,474;157888;7139;163328;1383623;1383623;1397760;1541511;1390762;1561088;;;;;;
657540,070;158691;5375;163840;1383623;1383623;1397760;1542314;1388998;1561600;;;;;;
657552,425;157439;4783;163328;1383623;1384415;1397760;1541062;1389198;1561088;;;;;;
657571,675;156847;6003;164352;1384415;1385055;1397760;1541262;1391058;1562112;;;;;;
657599,641;159603;6051;164352;1385055;1385623;1397760;1544658;1391674;1562112;;;;;;
657612,725;159651;5034;164864;1385623;1385622;1397760;1545274;1390656;1562624;;;;;;
657642,639;159146;7555;164352;1385622;1385775;1397760;1544768;1393330;1562112;;;;;;
657654,218;161667;5264;164864;1385775;1385775;1397760;1547442;1391039;1562624;;;;;;
657694,127;159888;5215;164864;1385775;1385775;1397760;1545663;1390990;1562624;;;;;;
657724,203;159839;5151;165888;1385775;1385775;1397760;1545614;1390926;1563648;;;;;;
657747,274;161311;5551;165376;1385775;1385775;1397760;1547086;1391326;1563136;;;;;;
657786,577;161711;6949;165376;1385775;1385775;1397760;1547486;1392724;1563136;;;;;;
657796,024;163621;8652;165376;1385775;1385775;1397760;1549396;1394427;1563136;;;;;;
657808,439;165324;6788;164352;1385775;1386262;1397760;1551099;1393050;1562112;;;;;;
657828,138;161412;7553;164864;1386262;1386822;1397760;1547674;1394375;1562624;;;;;;
657852,014;162177;4783;164864;1386822;1387886;1397760;1548999;1392669;1562624;;;;;;
657859,206;159407;6563;164864;1387886;1387975;1397760;1547293;1394538;1562624;;;;;;
657873,826;161187;6702;165376;1387975;1388654;1397760;1549162;1395356;1563136;;;;;;
657907,502;162350;5951;165376;1388654;1388998;1397760;1551004;1394949;1563136;;;;;;
657954,218;161599;5839;165888;1388998;1389166;1397760;1550597;1395005;1563648;;;;;;
657976,073;162511;5663;165888;1389166;1389750;1397760;1551677;1395413;1563648;;;;;;
658003,182;162335;5139;166400;1389750;1390078;1397760;1552085;1395217;1564160;;;;;;
658019,938;162323;6048;165888;1390078;1390078;1397760;1552401;1396126;1563648;;;;;;
658048,578;163232;5343;166400;1390078;1390078;1397760;1553310;1395421;1564160;;;;;;
658085,429;163039;5541;166400;1390078;1390078;1397760;1553117;1395619;1564160;;;;;;
658133,508;163237;5438;166912;1390078;1390078;1397760;1553315;1395516;1564672;;;;;;
658169,927;164158;5870;166912;1390078;1390078;1397760;1554236;1395948;1564672;;;;;;
658192,379;164590;8083;165888;1390078;1390078;1397760;1554668;1398161;1563648;;;;;;
658208,079;165779;8675;166400;1390078;1392135;1397760;1555857;1400810;1564160;;;;;;
658227,895;166371;8686;162304;1392135;1392675;1397760;1558506;1401361;1560064;;;;;;
658245,182;162286;8398;162304;1392675;1393675;1397760;1554961;1402073;1560064;;;;;;
658259,701;161998;8777;163840;1393675;1393675;1397760;1555673;1402452;1561600;;;;;;
658268,434;161353;10275;163328;1393675;1394051;1397760;1555028;1404326;1561088;;;;;;
658284,593;162851;9086;162304;1394051;1394235;1397760;1556902;1403321;1560064;;;;;;
658290,300;159614;8364;162816;1394235;1394994;1397760;1553849;1403358;1560576;;;;;;
658305,792;158892;7983;163328;1394994;1395170;1397760;1553886;1403153;1561088;;;;;;
658307,537;159023;7855;162816;1395170;1395698;1397760;1554193;1403553;1560576;;;;;;
658331,811;158895;6556;163840;1395698;1397122;1397760;1554593;1403678;1561600;;;;;;
658331,870;6556;0;163840;1397122;1350952;1397760;1403678;1350952;1561600;186715;186513;786432;1590393;1537465;2348032
658354,089;152576;1824;154624;1350952;1350952;1397760;1503528;1352776;1552384;;;;;;
658383,206;154400;2612;162304;1350952;1350953;1397760;1505352;1353565;1560064;;;;;;
658387,256;153140;7075;162816;1350953;1350953;1397760;1504093;1358028;1560576;;;;;;
658411,122;157603;5459;163328;1350953;1350952;1397760;1508556;1356411;1561088;;;;;;
658414,083;157011;5039;163328;1350952;1352265;1397760;1507963;1357304;1561088;;;;;;
658428,765;156591;2023;162816;1352265;1354464;1397760;1508856;1356487;1560576;;;;;;
658443,880;153575;5388;163328;1354464;1355256;1397760;1508039;1360644;1561088;;;;;;
658450,107;156940;4628;164352;1355256;1356024;1397760;1512196;1360652;1562112;;;;;;
658464,511;157716;1682;163840;1356024;1358964;1397760;1513740;1360646;1561600;;;;;;
658472,767;154770;1056;163840;1358964;1359700;1397760;1513734;1360756;1561600;;;;;;
658487,170;153632;5619;163840;1359700;1360420;1397760;1513332;1366039;1561600;;;;;;
658496,404;158195;768;163328;1360420;1362907;1397760;1518615;1363675;1561088;;;;;;
658498,712;153344;672;163840;1362907;1363291;1397760;1516251;1363963;1561600;;;;;;
658514,803;153248;704;163840;1363291;1363571;1397760;1516539;1364275;1561600;;;;;;
658555,723;153280;1249;163840;1363571;1363691;1397760;1516851;1364940;1561600;;;;;;
658581,028;153825;2212;164864;1363691;1364043;1397760;1517516;1366255;1562624;;;;;;
658592,880;156324;288;164352;1364043;1364483;1397760;1520367;1364771;1562112;;;;;;
658606,020;154400;4746;164864;1364483;1364588;1397760;1518883;1369334;1562624;;;;;;
658631,486;159370;896;164864;1364588;1366923;1397760;1523958;1367819;1562624;;;;;;
658648,052;155520;1261;165376;1366923;1367115;1397760;1522443;1368376;1563136;;;;;;
658679,025;156909;864;165376;1367115;1367563;1397760;1524024;1368427;1563136;;;;;;
658686,868;156512;4932;165888;1367563;1367563;1397760;1524075;1372495;1563648;;;;;;
658704,892;161604;3744;165888;1367563;1368123;1397760;1529167;1371867;1563648;;;;;;
658712,785;160416;3146;166400;1368123;1370027;1397760;1528539;1373173;1564160;;;;;;
658723,414;160330;1088;165888;1370027;1370771;1397760;1530357;1371859;1563648;;;;;;
658729,907;158272;1024;166912;1370771;1371163;1397760;1529043;1372187;1564672;;;;;;
658741,006;159744;896;166912;1371163;1371339;1397760;1530907;1372235;1564672;;;;;;
658760,453;159616;5256;166400;1371339;1371723;1397760;1530955;1376979;1564160;;;;;;
658770,829;163976;935;166912;1371723;1374196;1397760;1535699;1375131;1564672;;;;;;
658799,488;159655;832;166912;1374196;1374403;1397760;1533851;1375235;1564672;;;;;;
658852,411;159552;768;166912;1374403;1374547;1397760;1533955;1375315;1564672;;;;;;
658863,954;159488;1344;167936;1374547;1374548;1397760;1534035;1375892;1565696;;;;;;
658889,519;161600;1536;167424;1374548;1374884;1397760;1536148;1376420;1565184;;;;;;
658894,818;161792;2400;168448;1374884;1374884;1397760;1536676;1377284;1566208;;;;;;
658908,393;163647;2283;167936;1374884;1375212;1397760;1538531;1377495;1565696;;;;;;
658944,836;163563;6117;165888;1375212;1376211;1397760;1538775;1382328;1563648;;;;;;
658974,935;165861;3360;167424;1376211;1377387;1397760;1542072;1380747;1565184;;;;;;
658995,988;163104;4113;167424;1377387;1377388;1397760;1540491;1381501;1565184;;;;;;
659017,750;163857;5507;165376;1377388;1377388;1397760;1541245;1382895;1563136;;;;;;
659019,928;165251;4207;166912;1377388;1377388;1397760;1542639;1381595;1564672;;;;;;
659039,140;162927;4045;166912;1377388;1379652;1397760;1540315;1383697;1564672;;;;;;
659047,127;162765;2275;167424;1379652;1380108;1397760;1542417;1382383;1565184;;;;;;
659060,003;162019;6162;166400;1380108;1381012;1397760;1542127;1387174;1564160;;;;;;
659065,679;165906;480;166912;1381012;1385935;1397760;1546918;1386415;1564672;;;;;;
659086,243;159200;5188;164352;1385935;1386215;1397760;1545135;1391403;1562112;;;;;;
659122,306;163907;1900;166912;1386216;1388456;1397760;1550123;1390356;1564672;;;;;;
659150,817;160108;4417;166400;1388456;1389792;1397760;1548564;1394209;1564160;;;;;;
659161,152;162625;1200;166912;1389792;1391959;1397760;1552417;1393159;1564672;;;;;;
659190,573;159920;2834;166912;1391959;1392472;1397760;1551879;1395306;1564672;;;;;;
659198,909;161554;1184;167424;1392472;1392615;1397760;1554026;1393799;1565184;;;;;;
659211,970;160928;7656;167424;1392615;1394176;1397760;1553543;1401832;1565184;;;;;;
659224,885;167400;4450;164352;1394176;1397091;1397760;1561576;1401541;1562112;;;;;;
659224,903;4450;0;164352;1397091;1358563;1397760;1401541;1358563;1562112;186715;186548;786432;1588256;1545111;2348544
659229,534;156672;9200;165888;1358563;1358764;1397760;1515235;1367964;1563648;;;;;;
659250,412;165872;1265;162816;1358764;1361429;1397760;1524636;1362694;1560576;;;;;;
659268,368;154865;4268;164352;1361429;1361940;1397760;1516294;1366208;1562112;;;;;;
659288,501;157868;3526;165376;1361940;1362479;1397760;1519808;1366005;1563136;;;;;;
659308,530;158662;6817;164864;1362479;1362855;1397760;1521141;1369672;1562624;;;;;;
659324,051;161953;2209;165376;1362855;1364959;1397760;1524808;1367168;1563136;;;;;;
659345,031;157345;1456;164864;1364959;1365615;1397760;1522304;1367071;1562624;;;;;;
659351,851;156592;1010;165376;1365615;1365886;1397760;1522207;1366896;1563136;;;;;;
659371,052;156658;1442;165376;1365886;1366150;1397760;1522544;1367592;1563136;;;;;;
659380,747;157090;1555;165888;1366150;1366463;1397760;1523240;1368018;1563648;;;;;;
659390,763;158227;3572;165888;1366463;1366559;1397760;1524690;1370131;1563648;;;;;;
659408,467;160244;3468;166912;1366559;1367167;1397760;1526803;1370635;1564672;;;;;;
659421,925;161676;1037;166400;1367167;1369359;1397760;1528843;1370396;1564160;;;;;;
659442,309;159245;1249;166912;1369359;1369359;1397760;1528604;1370608;1564672;;;;;;
659462,986;159969;1200;166912;1369359;1369359;1397760;1529328;1370559;1564672;;;;;;
659482,519;159920;5519;166400;1369359;1369359;1397760;1529279;1374878;1564160;;;;;;
659494,181;164239;4539;166912;1369359;1369359;1397760;1533598;1373898;1564672;;;;;;
659672,528;163259;8084;163840;1369359;1369359;1397760;1532618;1377443;1561600;;;;;;
659734,644;163732;4833;165376;1369359;1369358;1397760;1533091;1374191;1563136;;;;;;
659776,175;160481;4367;165888;1369358;1369359;1397760;1529839;1373726;1563648;;;;;;
659798,518;160527;4239;165376;1369359;1369359;1397760;1529886;1373598;1563136;;;;;;
659823,753;160399;4367;166400;1369359;1369359;1397760;1529758;1373726;1564160;;;;;;
659873,698;161551;6800;165888;1369359;1369359;1397760;1530910;1376159;1563648;;;;;;
659905,797;163984;4815;165888;1369359;1369359;1397760;1533343;1374174;1563648;;;;;;
659930,657;161487;5604;165888;1369359;1369359;1397760;1530846;1374963;1563648;;;;;;
659952,476;162276;7835;164864;1369359;1369359;1397760;1531635;1377194;1562624;;;;;;
659972,574;163483;6019;165376;1369359;1369359;1397760;1532842;1375378;1563136;;;;;;
659978,460;161667;6836;164352;1369359;1369447;1397760;1531026;1376283;1562112;;;;;;
660004,814;161460;9202;163840;1369447;1369543;1397760;1530907;1378745;1561600;;;;;;
660021,094;163826;6942;163840;1369543;1369703;1397760;1533369;1376645;1561600;;;;;;
660033,135;159518;6974;163840;1369703;1370146;1397760;1529221;1377120;1561600;;;;;;
660045,241;159550;5888;164352;1370146;1370692;1397760;1529696;1376580;1562112;;;;;;
660051,863;158976;6115;163840;1370692;1371029;1397760;1529668;1377144;1561600;;;;;;
660065,088;158991;8178;163840;1371029;1371269;1397760;1530020;1379447;1561600;;;;;;
660107,159;161778;8034;161792;1371269;1371501;1397760;1533047;1379535;1559552;;;;;;
660116,392;161634;5678;164352;1371501;1371750;1397760;1533135;1377428;1562112;;;;;;
660133,120;158766;5951;163840;1371750;1371837;1397760;1530516;1377788;1561600;;;;;;
660159,132;159039;5790;164864;1371837;1372142;1397760;1530876;1377932;1562624;;;;;;
660189,373;160414;7619;164864;1372142;1372141;1397760;1532556;1379760;1562624;;;;;;
660211,382;162243;8083;163840;1372141;1372141;1397760;1534384;1380224;1561600;;;;;;
660255,289;161683;6748;164352;1372141;1372436;1397760;1533824;1379184;1562112;;;;;;
660278,786;160348;6959;164864;1372436;1372716;1397760;1532784;1379675;1562624;;;;;;
660297,291;161583;7349;164864;1372716;1372909;1397760;1534299;1380258;1562624;;;;;;
660317,924;161973;6655;165376;1372909;1373277;1397760;1534882;1379932;1563136;;;;;;
660342,798;161791;6432;164864;1373277;1373377;1397760;1535068;1379809;1562624;;;;;;
660354,538;161568;6383;165888;1373377;1373705;1397760;1534945;1380088;1563648;;;;;;
660453,504;162543;8732;165376;1373705;1373945;1397760;1536248;1382677;1563136;;;;;;
660586,410;164892;6351;165376;1373945;1374257;1397760;1538837;1380608;1563136;;;;;;
660627,649;161999;6258;165376;1374257;1374505;1397760;1536256;1380763;1563136;;;;;;
660736,526;161906;8711;164864;1374505;1374593;1397760;1536411;1383304;1562624;;;;;;
660761,341;164359;8819;164864;1374593;1374825;1397760;1538952;1383644;1562624;;;;;;
660781,547;164467;6943;164864;1374825;1375169;1397760;1539292;1382112;1562624;;;;;;
660791,074;161567;9154;163840;1375169;1375361;1397760;1536736;1384515;1561600;;;;;;
660832,714;163778;7518;164864;1375361;1375664;1397760;1539139;1383182;1562624;;;;;;
660966,568;161630;7305;164352;1375664;1376145;1397760;1537294;1383450;1562112;;;;;;
660997,068;161417;8962;164864;1376145;1376617;1397760;1537562;1385579;1562624;;;;;;
661045,314;163586;9010;163840;1376617;1376881;1397760;1540203;1385891;1561600;;;;;;
661105,974;163634;8246;164352;1376881;1377073;1397760;1540515;1385319;1562112;;;;;;
661116,751;161846;10633;164352;1377073;1377233;1397760;1538919;1387866;1562112;;;;;;
661151,592;164233;10202;162304;1377233;1377465;1397760;1541466;1387667;1560064;;;;;;
661182,727;161754;10360;162304;1377465;1377625;1397760;1539219;1387985;1560064;;;;;;
661201,138;161912;8606;162816;1377625;1377945;1397760;1539537;1386551;1560576;;;;;;
661211,044;159134;8350;162816;1377945;1378112;1397760;1537079;1386462;1560576;;;;;;
661341,560;158878;8639;163328;1378112;1378201;1397760;1536990;1386840;1561088;;;;;;
661355,416;160191;8728;163328;1378201;1378569;1397760;1538392;1387297;1561088;;;;;;
661488,986;160280;10597;162816;1378569;1379328;1397760;1538849;1389925;1560576;;;;;;
661497,929;162149;7951;163328;1379328;1379649;1397760;1541477;1387600;1561088;;;;;;
661508,825;159503;7971;163328;1379649;1379920;1397760;1539152;1387891;1561088;;;;;;
661527,386;159523;7055;163328;1379920;1380632;1397760;1539443;1387687;1561088;;;;;;
661627,807;158607;9011;163840;1380632;1380720;1397760;1539239;1389731;1561600;;;;;;
661690,743;161075;7279;163328;1380720;1381176;1397760;1541795;1388455;1561088;;;;;;
661712,379;159343;7071;163840;1381176;1381752;1397760;1540519;1388823;1561600;;;;;;
661802,298;159647;8787;163840;1381752;1382056;1397760;1541399;1390843;1561600;;;;;;
661856,729;161363;7346;163840;1382056;1382496;1397760;1543419;1389842;1561600;;;;;;
662110,679;159922;9695;163840;1382496;1383048;1397760;1542418;1392743;1561600;;;;;;
662369,412;162271;9386;162816;1383048;1383855;1397760;1545319;1393241;1560576;;;;;;
662401,955;160938;9151;163328;1383855;1384063;1397760;1544793;1393214;1561088;;;;;;
662424,478;160703;10587;162816;1384063;1384224;1397760;1544766;1394811;1560576;;;;;;
662441,808;162139;11748;163328;1384224;1386136;1397760;1546363;1397884;1561088;;;;;;
662468,940;163300;9106;160256;1386136;1386743;1397760;1549436;1395849;1558016;;;;;;
662536,839;157586;9905;161792;1386743;1386743;1397760;1544329;1396648;1559552;;;;;;
662572,689;158385;9987;162304;1386743;1386832;1397760;1545128;1396819;1560064;;;;;;
662629,642;159491;12208;161792;1386832;1387167;1397760;1546323;1399375;1559552;;;;;;
662689,070;161712;11471;160768;1387167;1387399;1397760;1548879;1398870;1558528;;;;;;
662704,801;158927;11058;161280;1387399;1387607;1397760;1546326;1398665;1559040;;;;;;
662713,166;158514;9438;161280;1387607;1387959;1397760;1546121;1397397;1559040;;;;;;
662720,098;156894;9246;161280;1387959;1388191;1397760;1544853;1397437;1559040;;;;;;
662759,207;156702;9779;161792;1388191;1388735;1397760;1544893;1398514;1559552;;;;;;
662790,427;158259;9486;161792;1388735;1389071;1397760;1546994;1398557;1559552;;;;;;
662827,555;128999;9987;162304;1389071;1389935;1397760;1518070;1399922;1560064;;;;;;
662827,580;9987;0;162304;1389935;1347964;1397760;1399922;1347964;1560064;186773;186515;786432;1586695;1534479;2346496
662904,782;149504;720;150528;1347964;1347964;1397760;1497468;1348684;1548288;;;;;;
663115,278;150224;3971;160256;1347964;1347965;1397760;1498188;1351936;1558016;;;;;;
663140,476;150403;7421;160768;1347965;1347965;1397760;1498368;1355386;1558528;;;;;;
663156,749;153853;4752;161280;1347965;1347964;1397760;1501818;1352716;1559040;;;;;;
663176,924;152208;7099;161280;1347964;1347965;1397760;1500172;1355064;1559040;;;;;;
663199,972;154552;8410;161792;1347965;1347964;1397760;1502517;1356374;1559552;;;;;;
663211,278;156890;7311;161792;1347964;1347965;1397760;1504854;1355276;1559552;;;;;;
663221,103;155791;7761;162816;1347965;1347964;1397760;1503756;1355725;1560576;;;;;;
663259,940;157777;9114;162304;1347964;1347965;1397760;1505741;1357079;1560064;;;;;;
663328,270;159130;12262;159744;1347965;1348334;1397760;1507095;1360596;1557504;;;;;;
663345,134;159718;8513;161280;1348334;1348334;1397760;1508052;1356847;1559040;;;;;;
663400,597;155969;8753;162304;1348334;1348334;1397760;1504303;1357087;1560064;;;;;;
663488,152;157641;12794;161792;1348334;1349091;1397760;1505975;1361885;1559552;;;;;;
663509,231;161786;9667;159744;1349091;1349092;1397760;1510877;1358759;1557504;;;;;;
663526,153;156099;12319;159232;1349092;1349091;1397760;1505191;1361410;1556992;;;;;;
663542,590;158751;13290;158208;1349091;1349227;1397760;1507842;1362517;1555968;;;;;;
663553,802;156650;10911;159232;1349227;1349596;1397760;1505877;1360507;1556992;;;;;;
663559,258;154271;13589;157696;1349596;1350355;1397760;1503867;1363944;1555456;;;;;;
663568,244;155925;10944;158720;1350355;1351260;1397760;1506280;1362204;1556480;;;;;;
663573,920;153280;9214;159232;1351260;1352484;1397760;1504540;1361698;1556992;;;;;;
663577,359;152574;8433;159232;1352484;1353627;1397760;1505058;1362060;1556992;;;;;;
663580,244;151793;8527;159744;1353627;1354697;1397760;1505420;1363224;1557504;;;;;;
663583,349;152911;7280;159744;1354697;1355983;1397760;1507608;1363263;1557504;;;;;;
663615,135;151664;9288;160256;1355983;1356823;1397760;1507647;1366111;1558016;;;;;;
663650,547;154184;11008;159744;1356823;1357631;1397760;1511007;1368639;1557504;;;;;;
663689,318;155904;6201;160256;1357631;1358807;1397760;1513535;1365008;1558016;;;;;;
663695,264;151609;5764;160256;1358807;1359255;1397760;1510416;1365019;1558016;;;;;;
663698,515;151172;4608;159232;1359255;1360135;1397760;1510427;1364743;1556992;;;;;;
663702,338;148992;7832;159744;1360135;1361439;1397760;1509127;1369271;1557504;;;;;;
663714,378;152216;4524;160256;1361439;1361959;1397760;1513655;1366483;1558016;;;;;;
663729,212;149932;4849;160256;1361959;1362950;1397760;1511891;1367799;1558016;;;;;;
663735,106;150257;5476;160768;1362950;1363958;1397760;1513207;1369434;1558528;;;;;;
663745,182;151396;1282;160256;1363958;1367318;1397760;1515354;1368600;1558016;;;;;;
663747,617;147202;1094;160256;1367318;1368015;1397760;1514520;1369109;1558016;;;;;;
663754,688;146502;1067;160256;1368015;1368150;1397760;1514517;1369217;1558016;;;;;;
663756,166;146475;4709;160768;1368150;1368534;1397760;1514625;1373243;1558528;;;;;;
663769,570;150629;5942;160256;1368534;1369222;1397760;1519163;1375164;1558016;;;;;;
663792,253;151862;4104;161792;1369222;1370017;1397760;1521084;1374121;1559552;;;;;;
663799,125;152072;4211;161280;1370017;1370631;1397760;1522089;1374842;1559040;;;;;;
663872,179;152179;5174;163328;1370631;1371063;1397760;1522810;1376237;1561088;;;;;;
663905,247;155702;4258;162304;1371063;1371615;1397760;1526765;1375873;1560064;;;;;;
663995,773;154784;6802;163840;1371615;1371983;1397760;1526399;1378785;1561600;;;;;;
664010,898;158866;4724;163328;1371983;1372825;1397760;1530849;1377549;1561088;;;;;;
664017,504;156788;5123;164352;1372825;1372826;1397760;1529613;1377949;1562112;;;;;;
664033,713;158211;6572;163840;1372826;1373489;1397760;1531037;1380061;1561600;;;;;;
664049,225;159660;5371;164864;1373489;1374144;1397760;1533149;1379515;1562624;;;;;;
664065,789;159995;3667;164864;1374144;1374809;1397760;1534139;1378476;1562624;;;;;;
664117,980;158291;3552;165376;1374809;1374808;1397760;1533100;1378360;1563136;;;;;;
664226,430;159200;3440;165376;1374808;1374808;1397760;1534008;1378248;1563136;;;;;;
664290,437;159088;5252;165888;1374808;1374809;1397760;1533896;1380061;1563648;;;;;;
664296,131;161412;4386;165376;1374809;1374808;1397760;1536221;1379194;1563136;;;;;;
664316,970;160546;6799;165888;1374808;1374809;1397760;1535354;1381608;1563648;;;;;;
664394,307;163471;7411;164352;1374809;1374809;1397760;1538280;1382220;1562112;;;;;;
664568,641;164083;6727;165376;1374809;1374808;1397760;1538892;1381535;1563136;;;;;;
664673,735;162375;5999;165376;1374808;1374809;1397760;1537183;1380808;1563136;;;;;;
664696,840;161647;7389;165376;1374809;1374808;1397760;1536456;1382197;1563136;;;;;;
664752,158;163037;9705;165376;1374808;1374965;1397760;1537845;1384670;1563136;;;;;;
664766,022;165353;6673;163328;1374965;1375629;1397760;1540318;1382302;1561088;;;;;;
664774,141;160273;7295;164352;1375629;1375629;1397760;1535902;1382924;1562112;;;;;;
664801,606;160895;6927;164352;1375629;1375629;1397760;1536524;1382556;1562112;;;;;;
665008,217;160527;9601;163328;1375629;1375629;1397760;1536156;1385230;1561088;;;;;;
665029,106;163201;9523;162816;1375629;1375629;1397760;1538830;1385152;1560576;;;;;;
665036,625;161075;8272;163328;1375629;1375909;1397760;1536704;1384181;1561088;;;;;;
665055,952;159824;8479;162304;1375909;1376261;1397760;1535733;1384740;1560064;;;;;;
665068,780;159007;11491;162304;1376261;1376717;1397760;1535268;1388208;1560064;;;;;;
665153,691;161716;9286;161280;1376717;1376981;1397760;1538433;1386267;1559040;;;;;;
665177,261;157370;9924;161792;1376981;1377725;1397760;1534351;1387649;1559552;;;;;;
665214,252;158335;8563;161792;1377725;1378285;1397760;1536060;1386848;1559552;;;;;;
665229,621;157043;11702;160256;1378285;1378597;1397760;1535328;1390299;1558016;;;;;;
665240,391;160182;8752;161280;1378597;1378813;1397760;1538779;1387565;1559040;;;;;;
665264,155;156208;11976;159744;1378813;1379101;1397760;1535021;1391077;1557504;;;;;;
665311,938;159432;9647;160768;1379101;1379701;1397760;1538533;1389348;1558528;;;;;;
665321,621;156079;9054;160768;1379701;1379846;1397760;1535780;1388900;1558528;;;;;;
665337,188;155486;11491;160256;1379846;1379925;1397760;1535332;1391416;1558016;;;;;;
665353,731;157923;10312;160768;1379925;1380013;1397760;1537848;1390325;1558528;;;;;;
665370,505;156744;11662;160768;1380013;1380677;1397760;1536757;1392339;1558528;;;;;;
665379,229;158094;9086;160768;1380677;1381213;1397760;1538771;1390299;1558528;;;;;;
665389,966;155518;11326;160768;1381213;1381525;1397760;1536731;1392851;1558528;;;;;;
665399,634;157758;10851;160768;1381525;1382541;1397760;1539283;1393392;1558528;;;;;;
665402,125;157283;8238;160768;1382541;1383485;1397760;1539824;1391723;1558528;;;;;;
665417,721;154670;9880;160768;1383485;1384605;1397760;1538155;1394485;1558528;;;;;;
665443,507;156312;7055;161280;1384605;1385476;1397760;1540917;1392531;1559040;;;;;;
665478,303;154511;8485;161280;1385476;1386276;1397760;1539987;1394761;1559040;;;;;;
665537,845;155941;10222;161280;1386276;1386869;1397760;1542217;1397091;1559040;;;;;;
665551,939;157678;9990;161280;1386869;1387556;1397760;1544547;1397546;1559040;;;;;;
665567,339;157446;6895;161792;1387556;1387940;1397760;1545002;1394835;1559552;;;;;;
665614,723;155375;8830;161792;1387940;1388493;1397760;1543315;1397323;1559552;;;;;;
665636,663;157310;8968;162304;1388493;1388493;1397760;1545803;1397461;1560064;;;;;;
665662,534;157960;11264;161792;1388493;1388492;1397760;1546453;1399756;1559552;;;;;;
665686,713;160256;11013;161792;1388492;1389021;1397760;1548748;1400034;1559552;;;;;;
665698,897;159493;13174;161792;1389021;1389236;1397760;1548514;1402410;1559552;;;;;;
665708,318;161654;12579;158720;1389236;1389988;1397760;1550890;1402567;1556480;;;;;;
665721,422;157987;8236;160256;1389988;1391188;1397760;1547975;1399424;1558016;;;;;;
665729,171;153644;8612;160256;1391188;1392452;1397760;1544832;1401064;1558016;;;;;;
665747,529;154020;9826;160256;1392452;1393285;1397760;1546472;1403111;1558016;;;;;;
665769,159;155234;4975;159744;1393285;1394445;1397760;1548519;1399420;1557504;;;;;;
665775,301;150383;4136;160256;1394445;1395565;1397760;1544828;1399701;1558016;;;;;;
665783,085;149544;7053;160256;1395565;1396133;1397760;1545109;1403186;1558016;;;;;;
665783,109;7053;0;160256;1396133;1366295;1397760;1403186;1366295;1558016;187142;186640;786432;1590328;1552935;2344448
665791,401;145408;2016;147456;1366295;1366295;1397760;1511703;1368311;1545216;;;;;;
665801,418;147424;7545;160256;1366295;1366296;1397760;1513719;1373841;1558016;;;;;;
665812,219;152441;7670;159744;1366296;1368232;1397760;1518737;1375902;1557504;;;;;;
665819,697;152566;1591;160256;1368232;1370915;1397760;1520798;1372506;1558016;;;;;;
665820,439;148023;6984;160768;1370915;1371718;1397760;1518938;1378702;1558528;;;;;;
665826,074;153416;7208;161792;1371718;1372438;1397760;1525134;1379646;1559552;;;;;;
665829,122;155176;3965;161280;1372438;1373733;1397760;1527614;1377698;1559040;;;;;;
665870,841;151933;1120;160768;1373733;1375989;1397760;1525666;1377109;1558528;;;;;;
665900,186;148576;2100;161280;1375989;1376550;1397760;1524565;1378650;1559040;;;;;;
665904,712;149556;4292;161792;1376550;1377288;1397760;1526106;1381580;1559552;;;;;;
665927,276;152260;5940;161280;1377288;1377777;1397760;1529548;1383717;1559040;;;;;;
665941,730;153908;5765;163328;1377777;1378224;1397760;1531685;1383989;1561088;;;;;;
665944,537;156805;992;162816;1378224;1380687;1397760;1535029;1381679;1560576;;;;;;
665950,834;152032;1984;163328;1380687;1380935;1397760;1532719;1382919;1561088;;;;;;
665965,008;153024;1232;162816;1380935;1381408;1397760;1533959;1382640;1560576;;;;;;
665972,668;152272;960;163328;1381408;1381895;1397760;1533680;1382855;1561088;;;;;;
665980,910;152512;4472;163328;1381895;1382056;1397760;1534407;1386528;1561088;;;;;;
665997,337;156024;3153;164352;1382056;1384336;1397760;1538080;1387489;1562112;;;;;;
666003,467;156241;800;163840;1384336;1384992;1397760;1540577;1385792;1561600;;;;;;
666106,365;153888;896;164352;1384992;1385135;1397760;1538880;1386031;1562112;;;;;;
666183,632;154496;4826;164352;1385135;1385824;1397760;1539631;1390650;1562112;;;;;;
666215,171;158426;4692;164864;1385824;1386344;1397760;1544250;1391036;1562624;;;;;;
666248,952;159316;4835;164864;1386344;1386983;1397760;1545660;1391818;1562624;;;;;;
666280,089;159459;4991;165376;1386983;1386983;1397760;1546442;1391974;1563136;;;;;;
666289,381;160639;4671;165376;1386983;1386983;1397760;1547622;1391654;1563136;;;;;;
666391,755;160319;4879;165888;1386983;1386983;1397760;1547302;1391862;1563648;;;;;;
666483,207;161551;8673;165376;1386983;1386983;1397760;1548534;1395656;1563136;;;;;;
666663,997;165345;6323;163328;1386983;1386984;1397760;1552328;1393307;1561088;;;;;;
666684,246;159923;8798;162816;1386984;1386984;1397760;1546907;1395782;1560576;;;;;;
666710,433;162398;7046;162816;1386984;1386983;1397760;1549382;1394029;1560576;;;;;;
666738,840;158598;9541;161280;1386983;1386983;1397760;1545581;1396524;1559040;;;;;;
666760,836;161093;8708;161792;1386983;1386983;1397760;1548076;1395691;1559552;;;;;;
666791,117;158212;9518;159232;1386983;1386983;1397760;1545195;1396501;1556992;;;;;;
666797,562;159022;12756;157696;1386983;1386983;1397760;1546005;1399739;1555456;;;;;;
666818,057;157140;13440;158208;1386983;1387655;1397760;1544123;1401095;1555968;;;;;;
666832,638;157824;11321;157184;1387655;1388096;1397760;1545479;1399417;1554944;;;;;;
666837,394;151609;9951;157696;1388096;1388319;1397760;1539705;1398270;1555456;;;;;;
666845,610;150239;7967;158720;1388319;1389255;1397760;1538558;1397222;1556480;;;;;;
666848,079;149791;6975;158208;1389255;1390383;1397760;1539046;1397358;1555968;;;;;;
666849,141;148799;6115;159744;1390383;1391711;1397760;1539182;1397826;1557504;;;;;;
666858,306;149987;5375;159232;1391711;1392527;1397760;1541698;1397902;1556992;;;;;;
666893,711;149247;6323;160768;1392527;1393512;1397760;1541774;1399835;1558528;;;;;;
666902,878;152243;4137;160256;1393512;1394537;1397760;1545755;1398674;1558016;;;;;;
666909,417;150057;3968;160768;1394537;1394841;1397760;1544594;1398809;1558528;;;;;;
667045,804;150400;5124;160768;1394841;1395449;1397760;1545241;1400573;1558528;;;;;;
667062,750;151556;3296;161280;1395449;1396097;1397760;1547005;1399393;1559040;;;;;;
667155,667;150752;5162;161280;1396097;1396834;1397760;1546849;1401996;1559040;;;;;;
667155,691;5162;0;161280;1396834;1369084;1397760;1401996;1369084;1559040;186655;186655;786432;1588651;1555739;2345472
667181,811;147456;1102;161792;1369084;1369084;1397760;1516540;1370186;1559552;;;;;;
667217,931;149582;5581;161792;1369084;1369587;1397760;1518666;1375168;1559552;;;;;;
667232,083;154061;5767;162816;1369587;1369586;1397760;1523648;1375353;1560576;;;;;;
667243,297;155783;3440;162304;1369586;1369586;1397760;1525369;1373026;1560064;;;;;;
667262,985;153247;3686;163840;1369586;1370043;1397760;1522833;1373729;1561600;;;;;;
667284,921;155750;4707;163328;1370043;1370675;1397760;1525793;1375382;1561088;;;;;;
667346,263;156771;6228;164352;1370675;1370675;1397760;1527446;1376903;1562112;;;;;;
667364,985;159316;4255;163840;1370675;1370674;1397760;1529991;1374929;1561600;;;;;;
667370,799;157343;4560;164864;1370674;1370675;1397760;1528017;1375235;1562624;;;;;;
667381,540;159184;4464;164864;1370675;1371019;1397760;1529859;1375483;1562624;;;;;;
667417,070;159088;1712;165376;1371019;1373954;1397760;1530107;1375666;1563136;;;;;;
667464,982;157360;2287;165376;1373954;1374354;1397760;1531314;1376641;1563136;;;;;;
667481,507;157935;6387;164352;1374354;1374354;1397760;1532289;1380741;1562112;;;;;;
667490,112;161011;6764;164864;1374354;1374353;1397760;1535365;1381117;1562624;;;;;;
667517,395;161388;8225;163840;1374353;1374514;1397760;1535741;1382739;1561600;;;;;;
667537,319;161825;6099;164352;1374514;1374514;1397760;1536339;1380613;1562112;;;;;;
667547,131;159699;5791;164864;1374514;1374514;1397760;1534213;1380305;1562624;;;;;;
667552,671;159903;5834;164352;1374514;1375146;1397760;1534417;1380980;1562112;;;;;;
667561,409;159946;8627;163840;1375146;1376386;1397760;1535092;1385013;1561600;;;;;;
667580,099;162227;4592;164352;1376386;1377234;1397760;1538613;1381826;1562112;;;;;;
667615,127;158192;6382;164864;1377234;1377787;1397760;1535426;1384169;1562624;;;;;;
667684,098;160494;6273;164352;1377787;1378050;1397760;1538281;1384323;1562112;;;;;;
667712,277;160385;9805;162816;1378050;1378051;1397760;1538435;1387856;1560576;;;;;;
667721,297;162066;6380;163840;1378051;1378051;1397760;1540117;1384431;1561600;;;;;;
667750,824;158956;7475;164352;1378051;1378635;1397760;1537007;1386110;1562112;;;;;;
667761,326;161075;8756;162816;1378635;1378635;1397760;1539710;1387391;1560576;;;;;;
667790,742;162356;8030;163840;1378635;1379219;1397760;1540991;1387249;1561600;;;;;;
667805,528;160606;7442;163840;1379219;1379218;1397760;1539825;1386660;1561600;;;;;;
667820,431;160018;8879;162816;1379218;1379219;1397760;1539236;1388098;1560576;;;;;;
667832,894;160431;6987;163328;1379219;1379707;1397760;1539650;1386694;1561088;;;;;;
667836,625;158539;8494;163840;1379707;1380227;1397760;1538246;1388721;1561600;;;;;;
667845,897;161070;6069;163840;1380227;1381122;1397760;1541297;1387191;1561600;;;;;;
667854,220;158645;7172;164352;1381122;1382162;1397760;1539767;1389334;1562112;;;;;;
667872,476;160260;7672;163840;1382162;1383250;1397760;1542422;1390922;1561600;;;;;;
667885,886;160760;8865;164352;1383250;1383786;1397760;1544010;1392651;1562112;;;;;;
667919,892;162465;6098;164352;1383786;1384288;1397760;1546251;1390386;1562112;;;;;;
668034,140;159698;7711;164352;1384288;1385656;1397760;1543986;1393367;1562112;;;;;;
668060,678;160778;9189;162816;1385656;1385655;1397760;1546434;1394844;1560576;;;;;;
668074,972;162789;4907;163840;1385655;1386552;1397760;1548444;1391459;1561600;;;;;;
668102,502;157483;4041;163840;1386552;1386968;1397760;1544035;1391009;1561600;;;;;;
668110,728;156617;4026;163840;1386968;1387575;1397760;1543585;1391601;1561600;;;;;;
668165,759;156602;9070;161792;1387575;1388170;1397760;1544177;1397240;1559552;;;;;;
668217,338;161646;3816;163328;1388170;1388546;1397760;1549816;1392362;1561088;;;;;;
668242,795;155368;7136;163328;1388546;1388546;1397760;1543914;1395682;1561088;;;;;;
668269,454;158688;8087;163328;1388546;1388546;1397760;1547234;1396633;1561088;;;;;;
668289,719;159639;6260;163328;1388546;1388545;1397760;1548185;1394805;1561088;;;;;;
668314,645;157812;8145;163840;1388545;1388546;1397760;1546357;1396691;1561600;;;;;;
668356,104;160721;7375;163840;1388546;1388546;1397760;1549267;1395921;1561600;;;;;;
668367,748;159951;7178;164352;1388546;1388545;1397760;1548497;1395723;1562112;;;;;;
668383,402;160137;8412;163840;1388708;1388708;1397760;1548845;1397120;1561600;;;;;;
668474,626;161500;9724;162816;1388712;1388712;1397760;1550212;1398436;1560576;;;;;;
668496,421;161276;8375;163328;1388712;1388713;1397760;1549988;1397088;1561088;;;;;;
668506,638;159927;8943;163328;1388713;1388713;1397760;1548640;1397656;1561088;;;;;;
668511,458;160495;9479;161280;1388713;1388712;1397760;1549208;1398191;1559040;;;;;;
668524,130;161031;8487;163328;1388712;1389464;1397760;1549743;1397951;1561088;;;;;;
668549,493;159527;9159;162816;1389464;1390255;1397760;1548991;1399414;1560576;;;;;;
668562,343;160199;9508;162816;1390255;1391224;1397760;1550454;1400732;1560576;;;;;;
668597,695;160036;9056;162816;1391224;1392040;1397760;1551260;1401096;1560576;;;;;;
668654,282;159584;7711;163328;1392040;1392328;1397760;1551624;1400039;1561088;;;;;;
668667,464;158721;10803;162304;1392327;1392327;1397760;1551048;1403130;1560064;;;;;;
668673,440;161843;12789;160256;1392327;1392657;1397760;1554170;1405446;1558016;;;;;;
668683,159;160245;7167;161280;1392657;1393921;1397760;1552902;1401088;1559040;;;;;;
668687,308;154623;6927;161792;1393921;1394417;1397760;1548544;1401344;1559552;;;;;;
668721,016;154895;8232;161280;1394417;1395257;1397760;1549312;1403489;1559040;;;;;;
668728,191;156200;7979;162304;1395257;1396257;1397760;1551457;1404236;1560064;;;;;;
668728,220;7979;0;162304;1396257;1378571;1397760;1404236;1378571;1560064;186824;186654;786432;1591060;1565225;2346496
668737,522;148992;3216;161792;1378571;1378572;1397760;1527563;1381788;1559552;;;;;;
668741,675;152208;3410;161792;1378572;1378572;1397760;1530780;1381982;1559552;;;;;;
668746,743;151890;3552;152064;1378572;1378572;1397760;1530462;1382124;1549824;;;;;;
668751,544;152032;1680;161280;1378572;1380444;1397760;1530604;1382124;1559040;;;;;;
668754,964;149118;5428;161280;1380444;1380964;1397760;1529562;1386392;1559040;;;;;;
668760,084;152884;7296;162304;1380964;1382139;1397760;1533848;1389435;1560064;;;;;;
668770,184;156288;5008;161792;1382139;1383006;1397760;1538427;1388014;1559552;;;;;;
668785,926;154000;6898;162816;1383006;1383853;1397760;1537006;1390751;1560576;;;;;;
668789,733;156914;1018;162304;1383853;1386357;1397760;1540767;1387375;1560064;;;;;;
668791,941;151034;1377;162304;1386357;1386831;1397760;1537391;1388208;1560064;;;;;;
668795,115;150881;992;162304;1386831;1387576;1397760;1537712;1388568;1560064;;;;;;
668801,456;150496;2619;162816;1387576;1387856;1397760;1538072;1390475;1560576;;;;;;
668805,470;152635;7530;162304;1387856;1388851;1397760;1540491;1396381;1560064;;;;;;
668810,572;157546;7666;162304;1388851;1390650;1397760;1546397;1398316;1560064;;;;;;
668817,627;157170;5107;162304;1390650;1393046;1397760;1547820;1398153;1560064;;;;;;
668825,355;154611;5488;163328;1393046;1394280;1397760;1547657;1399768;1561088;;;;;;
668834,038;156528;1268;162816;1394280;1397031;1397760;1550808;1398299;1560576;;;;;;
668834,063;1268;0;162816;1397031;1381722;1397760;1398299;1381722;1560576;186654;186654;786432;1584953;1568376;2347008
668840,221;151040;2175;163328;1381722;1381722;1397760;1532762;1383897;1561088;;;;;;
668845,001;153727;2861;163328;1381722;1381722;1397760;1535449;1384583;1561088;;;;;;
668856,283;154413;6749;172032;1381722;1381722;1397760;1536135;1388471;1569792;;;;;;
668920,689;168029;9037;172544;1381722;1381722;1397760;1549751;1390759;1570304;;;;;;
668927,079;170317;9505;181248;1381722;1381723;1397760;1552039;1391228;1579008;;;;;;
668941,746;178465;7528;182272;1381723;1381723;1397760;1560188;1389251;1580032;;;;;;
668948,092;176488;9808;191488;1381723;1381722;1397760;1558211;1391530;1589248;;;;;;
668980,232;187984;8396;192000;1381722;1381722;1397760;1569706;1390118;1589760;;;;;;
668984,255;186572;8796;202752;1381722;1381722;1397760;1568294;1390518;1600512;;;;;;
669010,013;197212;11046;202752;1381722;1381723;1397760;1578934;1392769;1600512;;;;;;
669037,807;199462;9730;211968;1381723;1381722;1397760;1581185;1391452;1609728;;;;;;
669077,430;207874;13907;205312;1381722;1381722;1397760;1589596;1395629;1603072;;;;;;
669093,478;204883;11057;195584;1381722;1381722;1397760;1586605;1392779;1593344;;;;;;
669109,652;195377;12099;189952;1381722;1381722;1397760;1577099;1393821;1587712;;;;;;
669137,606;189763;12273;183808;1381722;1382148;1397760;1571485;1394421;1581568;;;;;;
669144,166;183793;11708;195072;1382148;1384246;1397760;1565941;1395954;1592832;;;;;;
669152,145;188348;13038;199680;1384246;1384245;1397760;1572594;1397283;1597440;;;;;;
669164,041;194286;11779;200192;1384245;1384613;1397760;1578531;1396392;1597952;;;;;;
669227,359;193027;9936;205824;1384613;1385612;1397760;1577640;1395548;1603584;;;;;;
669254,824;200795;10067;208896;1385612;1386492;1397760;1586407;1396559;1606656;;;;;;
669275,505;201043;12695;217600;1386492;1386772;1397760;1587535;1399467;1615360;;;;;;
669290,455;212887;11123;217600;1386772;1387336;1397760;1599659;1398459;1615360;;;;;;
669349,813;211315;12970;206336;1387336;1387696;1397760;1598651;1400666;1604096;;;;;;
669362,170;205994;13076;199168;1387696;1387928;1397760;1593690;1401004;1596928;;;;;;
669377,991;198932;8672;187904;1387928;1391335;1397760;1586860;1400007;1585664;;;;;;
669383,921;187872;10063;198656;1391335;1392567;1397760;1579207;1402630;1596416;;;;;;
669391,720;198479;8640;205312;1392567;1392567;1397760;1591046;1401207;1603072;;;;;;
669401,957;197056;10047;205312;1392567;1392743;1397760;1589623;1402790;1603072;;;;;;
669454,445;198463;10295;192512;1392743;1392943;1397760;1591206;1403238;1590272;;;;;;
669474,994;192055;10792;186368;1392943;1393311;1397760;1584998;1404103;1584128;;;;;;
669502,029;185896;10209;179200;1393311;1394974;1397760;1579207;1405183;1576960;;;;;;
669512,048;179169;11797;175616;1394974;1395550;1397760;1574143;1407347;1573376;;;;;;
669512,081;11797;0;175616;1395550;1391904;1397760;1407347;1391904;1573376;186654;186654;786432;1594001;1578558;2359808
669521,123;163328;1710;159744;1391904;1391904;1397760;1555232;1393614;1557504;;;;;;
669534,460;159406;1296;154112;1391904;1391905;1397760;1551310;1393201;1551872;;;;;;
669548,617;153777;3781;151552;1392553;1392553;1397760;1546330;1396334;1549312;;;;;;
669551,602;151237;6051;148992;1392557;1392558;1397760;1543794;1398609;1546752;;;;;;
669566,099;148899;7456;153600;1392558;1392557;1397760;1541457;1400013;1551360;;;;;;
669579,425;149792;4639;158720;1392557;1392557;1397760;1542349;1397196;1556480;;;;;;
669584,550;146975;4431;159232;1392557;1392557;1397760;1539532;1396988;1556992;;;;;;
669617,540;147791;7518;159232;1392557;1392558;1397760;1540348;1400076;1556992;;;;;;
669648,402;150878;10077;159232;1392558;1392557;1397760;1543436;1402634;1556992;;;;;;
669681,639;154461;6305;159744;1392557;1392558;1397760;1547018;1398863;1557504;;;;;;
669687,264;150689;6900;160768;1392558;1392557;1397760;1543247;1399457;1558528;;;;;;
669724,211;152820;6899;160256;1392557;1392558;1397760;1545377;1399457;1558016;;;;;;
669765,011;152819;7835;161792;1392558;1392558;1397760;1545377;1400393;1559552;;;;;;
669776,792;155803;10235;161280;1392558;1392558;1397760;1548361;1402793;1559040;;;;;;
669798,560;158203;10291;161280;1392558;1392558;1397760;1550761;1402849;1559040;;;;;;
669815,238;157747;7967;161280;1392558;1392902;1397760;1550305;1400869;1559040;;;;;;
669831,352;155253;11411;159744;1392901;1393093;1397760;1548154;1404504;1557504;;;;;;
669856,196;157843;10288;160768;1393093;1393333;1397760;1550936;1403621;1558528;;;;;;
669861,807;156720;8414;161280;1393333;1393646;1397760;1550053;1402060;1559040;;;;;;
669864,790;155358;8734;160768;1393646;1394153;1397760;1549004;1402887;1558528;;;;;;
669888,503;155678;8630;167424;1394153;1394313;1397760;1549831;1402943;1565184;;;;;;
669893,446;165302;7854;169472;1394313;1394401;1397760;1559615;1402255;1567232;;;;;;
669901,400;164526;10986;180224;1394401;1394769;1397760;1558927;1405755;1577984;;;;;;
669917,818;178410;8157;180736;1394769;1395425;1397760;1573179;1403582;1578496;;;;;;
669922,476;175581;10911;190976;1395425;1395513;1397760;1571006;1406424;1588736;;;;;;
669941,452;189087;8611;191488;1395513;1395881;1397760;1584600;1404492;1589248;;;;;;
669974,318;186787;9695;201728;1395881;1396345;1397760;1582668;1406040;1599488;;;;;;
669989,583;200159;9008;193024;1396345;1396905;1397760;1596504;1405913;1590784;;;;;;
669989,611;9008;0;193024;1396905;1396119;1397760;1405913;1396119;1590784;186654;186639;786432;1592567;1582758;2377216
669999,014;183808;5855;183296;1396119;1396120;1397760;1579927;1401975;1581056;;;;;;
670014,570;183007;4782;176128;1396120;1396120;1397760;1579127;1400902;1573888;;;;;;
670027,016;175790;5204;170496;1396120;1396120;1397760;1571910;1401324;1568256;;;;;;
670050,687;170068;6383;165888;1396120;1396120;1397760;1566188;1402503;1563648;;;;;;
670063,373;165615;7458;161280;1396120;1396120;1397760;1561735;1403578;1559040;;;;;;
670069,252;161058;8427;166912;1396120;1396120;1397760;1557178;1404547;1564672;;;;;;
670082,553;166635;7923;161792;1396120;1396120;1397760;1562755;1404043;1559552;;;;;;
670094,460;161011;6543;159744;1396120;1396120;1397760;1557131;1402663;1557504;;;;;;
670106,108;159631;9427;163328;1396120;1396119;1397760;1555751;1405546;1561088;;;;;;
670147,695;160979;7199;163328;1396119;1396120;1397760;1557098;1403319;1561088;;;;;;
670180,858;158751;7567;163840;1396120;1396120;1397760;1554871;1403687;1561600;;;;;;
670218,045;159631;7596;163328;1396120;1396120;1397760;1555751;1403716;1561088;;;;;;
670234,756;159660;8924;163840;1396120;1396120;1397760;1555780;1405044;1561600;;;;;;
670247,725;161443;0;163840;1397744;1397678;1397760;1559187;1397678;1561600;186639;186639;786432;1745826;1584317;2348032
670265,459;152576;0;163840;1397678;1397156;1397760;1550254;1397156;1561600;186639;186639;786432;1736893;1583795;2348032
670278,556;152576;3138;163840;1397156;1397157;1397760;1549732;1400295;1561600;;;;;;
670285,849;155714;2912;165888;1397157;1397156;1397760;1552871;1400068;1563648;;;;;;
670299,482;157024;3652;166400;1397156;1397157;1397760;1554180;1400809;1564160;;;;;;
670306,461;157764;8411;167936;1397157;1397157;1397760;1554921;1405568;1565696;;;;;;
670309,630;164059;8773;167936;1397157;1397156;1397760;1561216;1405929;1565696;;;;;;
670330,016;164421;8595;169984;1397156;1397157;1397760;1561577;1405752;1567744;;;;;;
670337,394;166273;8179;170496;1397156;1397157;1397760;1563429;1405336;1568256;;;;;;
670346,154;165875;8735;171520;1397157;1397157;1397760;1563032;1405892;1569280;;;;;;
670350,703;168479;10464;172032;1397157;1397156;1397760;1565636;1407620;1569792;;;;;;
670360,794;170208;9708;175616;1397156;1397156;1397760;1567364;1406864;1573376;;;;;;
670371,581;172012;9596;175616;1397156;1397157;1397760;1569168;1406753;1573376;;;;;;
670383,366;171900;10851;177664;1397157;1397157;1397760;1569057;1408008;1575424;;;;;;
670396,257;175203;10098;178176;1397157;1397156;1397760;1572360;1407254;1575936;;;;;;
670407,859;174450;10118;179712;1397156;1397157;1397760;1571606;1407275;1577472;;;;;;
670460,294;176006;9984;180224;1397157;1397157;1397760;1573163;1407141;1577984;;;;;;
670483,653;175872;0;180224;1397757;1397297;1397760;1573629;1397297;1577984;186639;186639;786432;1760268;1583936;2364416
670512,466;165888;0;180224;1397297;1397278;1397760;1563185;1397278;1577984;186639;186639;786432;1749824;1583917;2364416
670532,537;165888;3338;180224;1397278;1397751;1397760;1563166;1401089;1577984;186639;186639;786432;1749805;1587728;2364416
670552,329;165888;1436;180224;1397751;1397343;1397760;1563639;1398779;1577984;186639;186639;786432;1750278;1585418;2364416
670572,994;165888;6019;180224;1397342;1397343;1397760;1563230;1403362;1577984;;;;;;
670581,943;173443;4977;181248;1397343;1397343;1397760;1570786;1402320;1579008;;;;;;
670586,588;172401;6270;183808;1397343;1397343;1397760;1569744;1403613;1581568;;;;;;
670592,017;175742;6352;183296;1397343;1397342;1397760;1573085;1403694;1581056;;;;;;
670619,728;175824;10679;185856;1397342;1397342;1397760;1573166;1408021;1583616;;;;;;
670647,078;182711;10686;186368;1397342;1397343;1397760;1580053;1408029;1584128;;;;;;
670722,836;182718;0;186368;1397753;1397694;1397760;1580471;1397694;1584128;186806;186754;786432;1767277;1584448;2370560
670750,380;172032;0;186368;1397694;1395647;1397760;1569726;1395647;1584128;186754;186639;786432;1756480;1582286;2370560
670772,313;172032;2078;188416;1395647;1395648;1397760;1567679;1397726;1586176;;;;;;
670789,792;176158;2496;188928;1395648;1395648;1397760;1571806;1398144;1586688;;;;;;
670798,316;176576;4512;189952;1395648;1395648;1397760;1572224;1400160;1587712;;;;;;
670821,034;180128;10898;190464;1395648;1395648;1397760;1575776;1406546;1588224;;;;;;
670844,605;186514;8115;190464;1395648;1395648;1397760;1582162;1403763;1588224;;;;;;
670961,625;184755;9732;191488;1395648;1395648;1397760;1580403;1405380;1589248;;;;;;
671007,181;186372;7042;190976;1395648;1395648;1397760;1582020;1402690;1588736;;;;;;
671020,189;184706;8926;192000;1395648;1395648;1397760;1580354;1404574;1589760;;;;;;
671041,239;186590;9140;193024;1395648;1395647;1397760;1582238;1404787;1590784;;;;;;
671060,366;187828;9854;193024;1395647;1395648;1397760;1583475;1405502;1590784;;;;;;
671145,935;188542;10158;194048;1395648;1395648;1397760;1584190;1405806;1591808;;;;;;
671334,914;189870;9159;194048;1395648;1395648;1397760;1585518;1404807;1591808;;;;;;
671549,421;188871;10252;194560;1395648;1395648;1397760;1584519;1405900;1592320;;;;;;
671598,216;190476;11635;194560;1395648;1395648;1397760;1586124;1407283;1592320;;;;;;
671609,812;191859;10866;195072;1395648;1395648;1397760;1587507;1406514;1592832;;;;;;
671632,880;191090;10832;195584;1395648;1396312;1397760;1586738;1407144;1593344;;;;;;
671707,449;191056;13644;195584;1396312;1396736;1397760;1587368;1410380;1593344;;;;;;
671731,452;193868;11859;196608;1396736;1397201;1397760;1590604;1409060;1594368;;;;;;
671769,911;192083;0;196608;1397753;1389041;1397760;1589836;1389041;1594368;186806;186639;786432;1776642;1575680;2380800
671800,576;180224;4972;197120;1389041;1389042;1397760;1569265;1394014;1594880;;;;;;
671804,149;185708;4440;197632;1389042;1389041;1397760;1574750;1393481;1595392;;;;;;
671866,418;185176;6832;198144;1389041;1389042;1397760;1574217;1395874;1595904;;;;;;
671902,266;189104;8611;198656;1389042;1389041;1397760;1578146;1397652;1596416;;;;;;
671943,915;190883;12923;198656;1389041;1389041;1397760;1579924;1401964;1596416;;;;;;
671985,845;195707;7933;199168;1389041;1389042;1397760;1584748;1396975;1596928;;;;;;
672012,508;190717;7244;199680;1389042;1389041;1397760;1579759;1396285;1597440;;;;;;
672093,145;191052;11375;199680;1389041;1389041;1397760;1580093;1400416;1597440;;;;;;
672137,574;195183;14053;199680;1389041;1389041;1397760;1584224;1403094;1597440;;;;;;
672156,128;197861;9921;200704;1389041;1389041;1397760;1586902;1398962;1598464;;;;;;
672164,866;193729;9470;201216;1389041;1389041;1397760;1582770;1398511;1598976;;;;;;
672254,754;194814;11554;201216;1389041;1389042;1397760;1583855;1400596;1598976;;;;;;
672280,324;196898;13250;201216;1389042;1389041;1397760;1585940;1402291;1598976;;;;;;
672288,585;198594;12752;202240;1389041;1389041;1397760;1587635;1401793;1600000;;;;;;
672303,201;198096;12587;203264;1389041;1389041;1397760;1587137;1401628;1601024;;;;;;
672326,054;198955;13434;203776;1389041;1390510;1397760;1587996;1403944;1601536;;;;;;
672358,117;199802;10614;204800;1390510;1390670;1397760;1590312;1401284;1602560;;;;;;
672380,293;199030;12111;205312;1390670;1391333;1397760;1589700;1403444;1603072;;;;;;
672416,437;200527;13046;206848;1391333;1391829;1397760;1591860;1404875;1604608;;;;;;
672439,573;202998;11110;206848;1391829;1392869;1397760;1594827;1403979;1604608;;;;;;
672460,111;201062;14671;206848;1392869;1393181;1397760;1593931;1407852;1604608;;;;;;
672477,708;205135;10943;207872;1393181;1393621;1397760;1598316;1404564;1605632;;;;;;
672518,274;201362;10462;206848;1393621;1393982;1397760;1594983;1404444;1604608;;;;;;
672550,316;201950;9807;207872;1393982;1394454;1397760;1595932;1404261;1605632;;;;;;
672602,257;201295;12084;208896;1394454;1394902;1397760;1595749;1406986;1606656;;;;;;
672645,510;204596;9775;208896;1394902;1395166;1397760;1599498;1404941;1606656;;;;;;
672689,279;202287;11148;208384;1395166;1396011;1397760;1597453;1407159;1606144;;;;;;
672734,044;204684;12881;208896;1396011;1396419;1397760;1600695;1409300;1606656;;;;;;
672748,053;206417;10391;209408;1396419;1396811;1397760;1602836;1407202;1607168;;;;;;
672772,765;204951;9428;209920;1396811;1397363;1397760;1601762;1406791;1607680;;;;;;
672772,790;9428;0;209920;1397363;1390245;1397760;1406791;1390245;1607680;187482;186641;786432;1594273;1576886;2394112
672791,069;194560;6608;210432;1390245;1390245;1397760;1584805;1396853;1608192;;;;;;
672804,727;201680;7387;210944;1390245;1390245;1397760;1591925;1397632;1608704;;;;;;
672816,341;202459;5857;212480;1390245;1390245;1397760;1592704;1396102;1610240;;;;;;
672824,429;202465;5428;212480;1390245;1390245;1397760;1592710;1395673;1610240;;;;;;
672831,061;202036;6279;214528;1390245;1390245;1397760;1592281;1396524;1612288;;;;;;
672847,489;204935;8326;214528;1390245;1390245;1397760;1595180;1398571;1612288;;;;;;
672875,237;206982;7851;214016;1390245;1390245;1397760;1597227;1398096;1611776;;;;;;
672891,936;208043;7888;215040;1390245;1390245;1397760;1598288;1398133;1612800;;;;;;
673092,395;208080;12260;216576;1390245;1390245;1397760;1598325;1402505;1614336;;;;;;
673115,052;213988;13597;217088;1390245;1390245;1397760;1604233;1403842;1614848;;;;;;
673155,470;215325;9473;218624;1390245;1390245;1397760;1605570;1399718;1616384;;;;;;
673173,760;212737;10101;219136;1390245;1390245;1397760;1602982;1400346;1616896;;;;;;
673218,635;213365;14407;219136;1390245;1390245;1397760;1603610;1404652;1616896;;;;;;
673257,646;218183;13895;220160;1390245;1390245;1397760;1608428;1404140;1617920;;;;;;
673286,612;217671;15992;221184;1390245;1390245;1397760;1607916;1406237;1618944;;;;;;
673314,601;219768;11697;222720;1390245;1391307;1397760;1610013;1403004;1620480;;;;;;
673472,194;215473;16467;222720;1391307;1391683;1397760;1606780;1408150;1620480;;;;;;
673508,747;220755;13943;223744;1391683;1392042;1397760;1612438;1405985;1621504;;;;;;
673581,930;218231;18849;222720;1392042;1392746;1397760;1610273;1411595;1620480;;;;;;
673602,748;222113;14827;224768;1392746;1393226;1397760;1614859;1408053;1622528;;;;;;
673636,168;218091;16025;225280;1393226;1393579;1397760;1611317;1409604;1623040;;;;;;
673654,634;219801;14515;225792;1393579;1394211;1397760;1613380;1408726;1623552;;;;;;
673871,481;218291;13348;223744;1394211;1395054;1397760;1612502;1408402;1621504;;;;;;
673950,544;218148;15231;225280;1395054;1395558;1397760;1613202;1410789;1623040;;;;;;
673983,534;220031;12318;225280;1395558;1396246;1397760;1615589;1408564;1623040;;;;;;
674044,417;218142;16962;225792;1396246;1396797;1397760;1614388;1413759;1623552;;;;;;
674044,451;16962;0;225792;1396797;1397602;1397760;1413759;1397602;1623552;187317;186760;786432;1601076;1584362;2409984
674084,010;205824;0;225792;1397602;1394146;1397760;1603426;1394146;1623552;186760;186644;786432;1790186;1580790;2409984
674278,867;205824;4773;227328;1394146;1394147;1397760;1599970;1398920;1625088;;;;;;
674394,129;211109;9376;227840;1394147;1394146;1397760;1605256;1403522;1625600;;;;;;
674462,761;215425;7922;228352;1394146;1394146;1397760;1609571;1402068;1626112;;;;;;
674494,764;214770;8620;228352;1394146;1394146;1397760;1608916;1402766;1626112;;;;;;
674534,606;215468;5986;228864;1394146;1394147;1397760;1609614;1400133;1626624;;;;;;
674600,748;174912;14948;228864;1394147;1394147;1397760;1569059;1409095;1626624;;;;;;
674600,790;14948;0;228864;1394147;1396358;1397760;1409095;1396358;1626624;186649;186649;786432;1595744;1583007;2413056
674685,437;207872;8412;229376;1396358;1396358;1397760;1604230;1404770;1627136;;;;;;
674717,127;216796;11948;229376;1396358;1396359;1397760;1613154;1408307;1627136;;;;;;
674721,344;220332;18469;228352;1396359;1396358;1397760;1616691;1414827;1626112;;;;;;
674741,255;226341;11142;229888;1396358;1396358;1397760;1622699;1407500;1627648;;;;;;
674755,941;219014;15153;232960;1396358;1396358;1397760;1615372;1411511;1630720;;;;;;
674784,792;227121;13109;233472;1396358;1396358;1397760;1623479;1409467;1631232;;;;;;
674815,420;225077;15185;236032;1396358;1396358;1397760;1621435;1411543;1633792;;;;;;
674861,926;230225;16517;236032;1396358;1396358;1397760;1626583;1412875;1633792;;;;;;
674898,382;231557;18379;238592;1396358;1396358;1397760;1627915;1414737;1636352;;;;;;
674918,471;234955;14199;239616;1396358;1396359;1397760;1631313;1410558;1637376;;;;;;
674929,352;230775;15852;241152;1396359;1396358;1397760;1627134;1412210;1638912;;;;;;
675009,234;234476;19915;241152;1396358;1396358;1397760;1630834;1416273;1638912;;;;;;
675050,332;238539;21442;242176;1396358;1396358;1397760;1634897;1417800;1639936;;;;;;
675078,748;240066;17090;244224;1396358;1396358;1397760;1636424;1413448;1641984;;;;;;
675168,986;235714;19762;244736;1396358;1396358;1397760;1632072;1416120;1642496;;;;;;
675294,026;239410;0;244736;1397756;1391859;1397760;1637166;1391859;1642496;186818;186651;786432;1823984;1578510;2428928
675367,870;219648;6009;245248;1391859;1391859;1397760;1611507;1397868;1643008;;;;;;
675411,050;225657;6837;246784;1391859;1391859;1397760;1617516;1398696;1644544;;;;;;
675485,349;227509;7978;247296;1391859;1391859;1397760;1619368;1399837;1645056;;;;;;
675515,427;228650;6195;248320;1391859;1391859;1397760;1620509;1398054;1646080;;;;;;
675545,893;227891;6450;248320;1391859;1391859;1397760;1619750;1398309;1646080;;;;;;
675586,317;228146;7151;247808;1391859;1391859;1397760;1620005;1399010;1645568;;;;;;
675688,100;229871;6575;248320;1391859;1391859;1397760;1621730;1398434;1646080;;;;;;
675712,433;229295;8313;246784;1391859;1391859;1397760;1621154;1400172;1644544;;;;;;
675740,025;232057;10530;247808;1391859;1391859;1397760;1623916;1402389;1645568;;;;;;
675759,814;234274;10516;245248;1391859;1391860;1397760;1626133;1402376;1643008;;;;;;
675782,880;235796;11287;246784;1391860;1391859;1397760;1627656;1403146;1644544;;;;;;
675789,944;236567;12376;248320;1391859;1391859;1397760;1628426;1404235;1646080;;;;;;
675815,761;239704;9624;247808;1391859;1391859;1397760;1631563;1401483;1645568;;;;;;
675847,005;236952;10689;246784;1391859;1391860;1397760;1628811;1402549;1644544;;;;;;
675871,773;240065;9936;248320;1391860;1391859;1397760;1631925;1401795;1646080;;;;;;
675901,246;239312;11425;248832;1391859;1392827;1397760;1631171;1404252;1646592;;;;;;
675914,358;242849;12115;249344;1392827;1393434;1397760;1635676;1405549;1647104;;;;;;
675935,200;243539;9570;251392;1393434;1393802;1397760;1636973;1403372;1649152;;;;;;
675941,353;243554;9327;251392;1393802;1393803;1397760;1637356;1403130;1649152;;;;;;
675948,803;243311;8975;253952;1393803;1394171;1397760;1637114;1403146;1651712;;;;;;
676103,142;246543;15130;253952;1394171;1394507;1397760;1640714;1409637;1651712;;;;;;
676146,529;252698;11844;257024;1394507;1394707;1397760;1647205;1406551;1654784;;;;;;
676426,672;251972;10892;257536;1394707;1395035;1397760;1646679;1405927;1655296;;;;;;
676476,585;251020;15843;258048;1395035;1395370;1397760;1646055;1411213;1655808;;;;;;
676506,887;256995;13086;259072;1395370;1395843;1397760;1652365;1408929;1656832;;;;;;
676527,380;254238;12787;260608;1395843;1396346;1397760;1650081;1409133;1658368;;;;;;
676604,493;255475;11053;260608;1396346;1396866;1397760;1651821;1407919;1658368;;;;;;
676657,049;253741;14803;261120;1396866;1397403;1397760;1650607;1412206;1658880;;;;;;
676657,105;14803;2756;261120;1397403;1397711;1397760;1412206;1400467;1658880;186651;186633;786432;1598857;1587100;2445312
676704,419;246468;2605;261120;1397711;1397689;1397760;1644179;1400294;1658880;186633;186633;786432;1830812;1586927;2445312
676764,476;243712;0;261120;1397688;1397578;1397760;1641400;1397578;1658880;186633;186633;786432;1828033;1584211;2445312
676897,784;200212;5416;261120;1397578;1397006;1397760;1597790;1402422;1658880;186637;186637;786432;1784427;1589059;2445312
677005,863;243712;1995;261120;1397006;1397466;1397760;1640718;1399461;1658880;186703;186697;786432;1827421;1586158;2445312
677367,205;243712;0;261120;1397465;1396575;1397760;1641177;1396575;1658880;186697;186697;786432;1827874;1583272;2445312
677490,455;243712;5227;261632;1396575;1396576;1397760;1640287;1401803;1659392;;;;;;
677698,312;248939;8414;262656;1396576;1396576;1397760;1645515;1404990;1660416;;;;;;
677744,686;253150;6218;263168;1396576;1396576;1397760;1649726;1402794;1660928;;;;;;
677796,845;250954;9064;263168;1396576;1396576;1397760;1647530;1405640;1660928;;;;;;
677847,045;254824;8655;263680;1396576;1396575;1397760;1651400;1405230;1661440;;;;;;
677884,253;254415;11277;264192;1396575;1396576;1397760;1650990;1407853;1661952;;;;;;
677905,867;258061;9132;264192;1396576;1396575;1397760;1654637;1405707;1661952;;;;;;
678141,142;255916;10523;264192;1396575;1396576;1397760;1652491;1407099;1661952;;;;;;
678165,452;76985;14098;264704;1396575;1396575;1397760;1473560;1410673;1662464;;;;;;
678165,478;14098;6097;264704;1396575;1395100;1397760;1410673;1401197;1662464;186756;186751;786432;1597429;1587948;2448896
678537,366;254417;11508;265216;1395100;1395101;1397760;1649517;1406609;1662976;;;;;;
678585,110;259828;8246;265216;1395101;1395100;1397760;1654929;1403346;1662976;;;;;;
678607,974;256566;6821;265728;1395100;1395100;1397760;1651666;1401921;1663488;;;;;;
678611,367;256165;6803;266240;1395100;1395101;1397760;1651265;1401904;1664000;;;;;;
678620,379;256147;7673;270848;1395101;1395100;1397760;1651248;1402773;1668608;;;;;;
678626,629;262137;6697;270848;1395100;1395100;1397760;1657237;1401797;1668608;;;;;;
678650,775;261161;16188;275968;1395100;1395141;1397760;1656261;1411329;1673728;;;;;;
678683,484;275772;11416;277504;1395141;1395188;1397760;1670913;1406604;1675264;;;;;;
678703,492;271000;9335;281600;1395188;1395204;1397760;1666188;1404539;1679360;;;;;;
678733,636;274014;14101;282112;1395204;1395437;1397760;1669218;1409538;1679872;;;;;;
678759,333;278805;12061;287232;1395437;1395661;1397760;1674242;1407722;1684992;;;;;;
678889,258;281373;12814;287232;1395661;1395676;1397760;1677034;1408490;1684992;;;;;;
679029,743;282126;16133;289280;1395676;1395869;1397760;1677802;1412002;1687040;;;;;;
679097,712;287493;11783;290816;1395869;1395893;1397760;1683362;1407676;1688576;;;;;;
679431,438;283143;16224;290816;1395893;1395933;1397760;1679036;1412157;1688576;;;;;;
679523,450;288608;15683;292352;1395933;1397076;1397760;1684541;1412759;1690112;;;;;;
679523,522;15683;5870;292352;1397076;1397545;1397760;1412759;1403415;1690112;187428;186735;786432;1600187;1590150;2476544
679527,451;189660;10400;292352;1397546;1396353;1397760;1587206;1406753;1690112;186742;186742;786432;1773948;1593495;2476544
679740,706;272384;11397;295424;1396352;1396433;1397760;1668736;1407830;1693184;;;;;;
679774,198;286341;14134;294912;1396433;1396457;1397760;1682774;1410591;1692672;;;;;;
679983,319;289078;18468;296960;1396457;1396457;1397760;1685535;1414925;1694720;;;;;;
680577,947;295460;16990;298496;1396457;1396705;1397760;1691917;1413695;1696256;;;;;;
680966,741;293982;18747;300032;1396705;1396784;1397760;1690687;1415531;1697792;;;;;;
681032,100;296763;12571;301056;1396784;1397170;1397760;1693547;1409741;1698816;;;;;;
681032,139;12571;0;301056;1397170;1392881;1397760;1409741;1392881;1698816;186921;186747;786432;1596662;1579628;2485248
681104,914;278016;6631;302080;1392881;1392882;1397760;1670897;1399513;1699840;;;;;;
681181,610;286183;6243;302592;1392882;1392882;1397760;1679065;1399125;1700352;;;;;;
681269,225;285795;7592;303616;1392882;1392882;1397760;1678677;1400474;1701376;;;;;;
681312,787;288680;11704;304128;1392882;1392882;1397760;1681562;1404586;1701888;;;;;;
681353,874;292584;10395;303616;1392882;1392882;1397760;1685466;1403277;1701376;;;;;;
681398,643;293531;11994;304128;1392882;1392882;1397760;1686413;1404876;1701888;;;;;;
681444,909;295130;10739;303616;1392882;1392882;1397760;1688012;1403621;1701376;;;;;;
681553,900;295923;13928;304640;1392882;1392882;1397760;1688805;1406810;1702400;;;;;;
681604,026;299112;14983;306176;1392882;1392882;1397760;1691994;1407865;1703936;;;;;;
681672,582;301703;15719;306688;1392882;1392882;1397760;1694585;1408601;1704448;;;;;;
681701,136;302439;18365;307712;1392882;1392882;1397760;1695321;1411247;1705472;;;;;;
681730,629;305597;16339;309248;1392882;1392882;1397760;1698479;1409221;1707008;;;;;;
681754,698;303571;17018;313856;1392882;1392882;1397760;1696453;1409900;1711616;;;;;;
681779,546;308346;19145;313856;1392882;1392882;1397760;1701228;1412027;1711616;;;;;;
681861,294;310473;17623;318976;1392882;1392882;1397760;1703355;1410505;1716736;;;;;;
681988,956;313047;18567;319488;1392882;1393794;1397760;1705929;1412361;1717248;;;;;;
682159,468;313991;17427;323072;1393794;1394881;1397760;1707785;1412308;1720832;;;;;;
682259,965;315923;20576;323072;1394881;1395690;1397760;1710804;1416266;1720832;;;;;;
682365,590;319072;15076;325632;1395690;1396850;1397760;1714762;1411926;1723392;;;;;;
682365,667;15076;8400;325632;1396850;1397348;1397760;1411926;1405748;1723392;186752;186745;786432;1598678;1592493;2509824
682477,656;309456;11100;325632;1397736;1397759;1397760;1707192;1408859;1723392;186745;186745;786432;1893937;1595604;2509824
682480,513;15151;11700;325632;1397758;1397743;1397760;1412909;1409443;1723392;186745;186745;786432;1599654;1596188;2509824
682528,760;301056;14860;325632;1397742;1397365;1397760;1698798;1412225;1723392;186753;186753;786432;1885551;1598978;2509824
682610,153;301056;9068;325632;1397364;1397502;1397760;1698420;1406570;1723392;186753;186753;786432;1885173;1593323;2509824
682921,284;301056;11919;325632;1397501;1397665;1397760;1698557;1409584;1723392;186753;186753;786432;1885310;1596337;2509824
683037,693;301056;5342;325632;1397665;1397667;1397760;1698721;1403009;1723392;186753;186753;786432;1885474;1589762;2509824
683083,851;301056;5200;325632;1397666;1397665;1397760;1698722;1402865;1723392;186753;186753;786432;1885475;1589618;2509824
683118,812;301056;4063;325632;1397664;1397710;1397760;1698720;1401773;1723392;186753;186684;786432;1885473;1588457;2509824
683258,966;301056;11181;325632;1397709;1397619;1397760;1698765;1408800;1723392;186852;186852;786432;1885617;1595652;2509824
683340,057;301056;8909;325632;1397618;1397388;1397760;1698674;1406297;1723392;186852;186736;786432;1885526;1593033;2509824
683468,694;301056;10866;325632;1397388;1397476;1397760;1698444;1408342;1723392;186736;186733;786432;1885180;1595075;2509824
683826,520;301056;5393;325632;1397475;1397502;1397760;1698531;1402895;1723392;186733;186730;786432;1885264;1589625;2509824
683937,165;301056;12198;325632;1397501;1397636;1397760;1698557;1409834;1723392;186750;186659;786432;1885307;1596493;2509824
684037,822;301056;6635;325632;1397636;1397261;1397760;1698692;1403896;1723392;186687;186687;786432;1885379;1590583;2509824
684126,869;301056;11398;325632;1397260;1397634;1397760;1698316;1409032;1723392;186687;186687;786432;1885003;1595719;2509824
684186,436;301056;15094;325632;1397634;1397584;1397760;1698690;1412678;1723392;186690;186690;786432;1885380;1599368;2509824
684241,654;301056;13799;325632;1397583;1397543;1397760;1698639;1411342;1723392;186690;186690;786432;1885329;1598032;2509824
684312,207;301056;16473;325632;1397543;1397500;1397760;1698599;1413973;1723392;186690;186690;786432;1885289;1600663;2509824
684394,727;300907;14133;325632;1397500;1397538;1397760;1698407;1411671;1723392;186690;186690;786432;1885097;1598361;2509824
684483,838;301056;6777;325632;1397538;1397752;1397760;1698594;1404529;1723392;186690;186690;786432;1885284;1591219;2509824
684720,898;301056;8504;325632;1397751;1397587;1397760;1698807;1406091;1723392;186690;186690;786432;1885497;1592781;2509824
684759,860;301028;13790;325632;1397587;1397446;1397760;1698615;1411236;1723392;186737;186737;786432;1885352;1597973;2509824
684811,313;301056;11052;325632;1397446;1397357;1397760;1698502;1408409;1723392;186750;186750;786432;1885252;1595159;2509824
684919,031;301056;16687;325632;1397356;1397559;1397760;1698412;1414246;1723392;186917;186866;786432;1885329;1601112;2509824
684966,959;301056;10225;325632;1397558;1397502;1397760;1698614;1407727;1723392;186866;186731;786432;1885480;1594458;2509824
685336,115;301056;15231;325632;1397501;1397584;1397760;1698557;1412815;1723392;186731;186731;786432;1885288;1599546;2509824
685438,155;301056;13804;325632;1397583;1397466;1397760;1698639;1411270;1723392;186731;186731;786432;1885370;1598001;2509824
685590,228;301056;14895;325632;1397465;1397489;1397760;1698521;1412384;1723392;186733;186733;786432;1885254;1599117;2509824
685626,472;301056;9665;325632;1397489;1397471;1397760;1698545;1407136;1723392;186733;186733;786432;1885278;1593869;2509824
685731,185;301056;11293;325632;1397471;1397441;1397760;1698527;1408734;1723392;186749;186749;786432;1885276;1595483;2509824
685828,179;230691;17968;325632;1397441;1397273;1397760;1628132;1415241;1723392;186754;186754;786432;1814886;1601995;2509824
685962,347;301056;14302;325632;1397273;1397715;1397760;1698329;1412017;1723392;186757;186757;786432;1885086;1598774;2509824
686051,272;301056;13721;325632;1397714;1397691;1397760;1698770;1411412;1723392;186757;186757;786432;1885527;1598169;2509824
686102,006;301056;16031;325632;1397691;1397655;1397760;1698747;1413686;1723392;186766;186766;786432;1885513;1600452;2509824
686200,472;301056;13692;325632;1397655;1397628;1397760;1698711;1411320;1723392;186766;186766;786432;1885477;1598086;2509824
686322,719;196710;17119;325632;1397628;1397572;1397760;1594338;1414691;1723392;186766;186766;786432;1781104;1601457;2509824
686384,056;301056;13810;325632;1397572;1397536;1397760;1698628;1411346;1723392;186766;186766;786432;1885394;1598112;2509824
686663,485;301056;15275;325632;1397535;1397493;1397760;1698591;1412768;1723392;186766;186766;786432;1885357;1599534;2509824
686743,123;301056;14942;325632;1397493;1397704;1397760;1698549;1412646;1723392;186766;186745;786432;1885315;1599391;2509824
686890,389;301056;11994;325632;1397704;1397416;1397760;1698760;1409410;1723392;186745;186745;786432;1885505;1596155;2509824
687123,674;301035;13215;325632;1397415;1397371;1397760;1698450;1410586;1723392;186751;186748;786432;1885201;1597334;2509824
687335,067;301056;10950;325632;1397371;1397716;1397760;1698427;1408666;1723392;186751;186735;786432;1885178;1595401;2509824
687404,297;301056;12744;325632;1397715;1397673;1397760;1698771;1410417;1723392;186735;186735;786432;1885506;1597152;2509824
687637,327;301056;14320;325632;1397673;1397527;1397760;1698729;1411847;1723392;186753;186753;786432;1885482;1598600;2509824
687701,966;301056;13375;325632;1397527;1397488;1397760;1698583;1410863;1723392;186753;186750;786432;1885336;1597613;2509824
687795,912;301056;16319;325632;1397488;1397484;1397760;1698544;1413803;1723392;186750;186750;786432;1885294;1600553;2509824
687892,793;301056;19668;325632;1397484;1397481;1397760;1698540;1417149;1723392;186750;186750;786432;1885290;1603899;2509824
687943,281;301056;19132;325632;1397480;1397468;1397760;1698536;1416600;1723392;186750;186750;786432;1885286;1603350;2509824
688026,146;301056;15592;325632;1397467;1397468;1397760;1698523;1413060;1723392;186750;186750;786432;1885273;1599810;2509824
688061,042;301056;19618;325632;1397467;1397438;1397760;1698523;1417056;1723392;186750;186750;786432;1885273;1603806;2509824
688080,468;104708;21737;325632;1397438;1397438;1397760;1502146;1419175;1723392;186750;186750;786432;1688896;1605925;2509824
688230,476;301056;18967;325632;1397437;1397422;1397760;1698493;1416389;1723392;186756;186753;786432;1885249;1603142;2509824
688514,109;301056;16261;325632;1397422;1397411;1397760;1698478;1413672;1723392;186755;186755;786432;1885233;1600427;2509824
688716,969;301056;21246;325632;1397410;1397266;1397760;1698466;1418512;1723392;186755;186755;786432;1885221;1605267;2509824
688789,639;301056;26786;325632;1397266;1397750;1397760;1698322;1424536;1723392;186755;186728;786432;1885077;1611264;2509824
688890,509;301056;18700;325632;1397750;1397606;1397760;1698806;1416306;1723392;186728;186519;786432;1885534;1602825;2509824
689080,995;301056;13955;325632;1397606;1397600;1397760;1698662;1411555;1723392;186553;186553;786432;1885215;1598108;2509824
689228,478;301056;16058;325632;1397600;1397576;1397760;1698656;1413634;1723392;186594;186592;786432;1885250;1600226;2509824
689327,737;301056;15137;325632;1397575;1397576;1397760;1698631;1412713;1723392;186642;186642;786432;1885273;1599355;2509824
689405,106;301056;15129;325632;1397575;1397562;1397760;1698631;1412691;1723392;186709;186709;786432;1885340;1599400;2509824
689507,934;301056;15499;325632;1397562;1397561;1397760;1698618;1413060;1723392;186722;186719;786432;1885340;1599779;2509824
689543,111;301056;14223;325632;1397561;1397552;1397760;1698617;1411775;1723392;186719;186714;786432;1885336;1598489;2509824
689573,348;301056;15473;325632;1397552;1397553;1397760;1698608;1413026;1723392;186714;186714;786432;1885322;1599740;2509824
689595,537;301056;17478;325632;1397552;1397280;1397760;1698608;1414758;1723392;186774;186723;786432;1885382;1601481;2509824
689689,214;301056;20705;325632;1397279;1397278;1397760;1698335;1417983;1723392;186830;186830;786432;1885165;1604813;2509824
689729,944;301056;17994;325632;1397278;1397268;1397760;1698334;1415262;1723392;186830;186714;786432;1885164;1601976;2509824
689771,653;301056;17136;325632;1397267;1397268;1397760;1698323;1414404;1723392;186714;186714;786432;1885037;1601118;2509824
689803,801;301056;17574;325632;1397267;1397268;1397760;1698323;1414842;1723392;186714;186714;786432;1885037;1601556;2509824
689827,799;301056;19053;325632;1397267;1397268;1397760;1698323;1416321;1723392;186714;186714;786432;1885037;1603035;2509824
689857,231;301056;20213;325632;1397267;1397267;1397760;1698323;1417480;1723392;186717;186717;786432;1885040;1604197;2509824
689876,223;301056;21080;325632;1397266;1397265;1397760;1698322;1418345;1723392;186717;186717;786432;1885039;1605062;2509824
689890,726;301056;24357;325632;1397265;1397254;1397760;1698321;1421611;1723392;186723;186723;786432;1885044;1608334;2509824
689901,788;301056;19699;325632;1397254;1397254;1397760;1698310;1416953;1723392;186723;186723;786432;1885033;1603676;2509824
689911,475;301056;22337;325632;1397254;1397254;1397760;1698310;1419591;1723392;186724;186724;786432;1885034;1606315;2509824
689921,751;301056;20861;325632;1397253;1397253;1397760;1698309;1418114;1723392;186724;186724;786432;1885033;1604838;2509824
689929,272;301056;22598;325632;1397252;1397253;1397760;1698308;1419851;1723392;186724;186724;786432;1885032;1606575;2509824
689943,135;301056;24879;325632;1397252;1397253;1397760;1698308;1422132;1723392;186724;186724;786432;1885032;1608856;2509824
689960,070;301056;22727;325632;1397252;1397750;1397760;1698308;1420477;1723392;186724;186724;786432;1885032;1607201;2509824
689972,838;300965;24746;325632;1397750;1397750;1397760;1698715;1422496;1723392;186724;186724;786432;1885439;1609220;2509824
689985,479;301056;24279;325632;1397749;1397724;1397760;1698805;1422003;1723392;187059;186956;786432;1885864;1608959;2509824
690011,222;301056;26071;325632;1397724;1397724;1397760;1698780;1423795;1723392;186956;186724;786432;1885736;1610519;2509824
690044,493;301056;26992;325632;1397723;1397453;1397760;1698779;1424445;1723392;186892;186840;786432;1885671;1611285;2509824
690078,530;301056;24496;325632;1397453;1397453;1397760;1698509;1421949;1723392;186840;186724;786432;1885349;1608673;2509824
690154,829;301056;27460;325632;1397453;1397451;1397760;1698509;1424911;1723392;186724;186724;786432;1885233;1611635;2509824
690283,011;301056;25752;325632;1397451;1397451;1397760;1698507;1423203;1723392;186724;186724;786432;1885231;1609927;2509824
690591,000;301056;27067;325632;1397451;1397450;1397760;1698507;1424517;1723392;186733;186727;786432;1885240;1611244;2509824
690716,651;301056;29489;325632;1397449;1397448;1397760;1698505;1426937;1723392;186727;186727;786432;1885232;1613664;2509824
690761,957;301056;28674;325632;1397447;1397448;1397760;1698503;1426122;1723392;186727;186727;786432;1885230;1612849;2509824
690808,271;301056;28074;325632;1397447;1397448;1397760;1698503;1425522;1723392;186727;186727;786432;1885230;1612249;2509824
690838,425;301056;30451;325632;1397447;1397446;1397760;1698503;1427897;1723392;186733;186733;786432;1885236;1614630;2509824
690880,740;301056;26855;325632;1397446;1397446;1397760;1698502;1424301;1723392;186733;186713;786432;1885235;1611014;2509824
690930,142;301056;27824;325632;1397446;1397447;1397760;1698502;1425271;1723392;186713;186713;786432;1885215;1611984;2509824
691482,375;301056;20855;325632;1397446;1397431;1397760;1698502;1418286;1723392;186728;186728;786432;1885230;1605014;2509824
691525,815;301056;21301;325632;1397431;1397378;1397760;1698487;1418679;1723392;186735;186644;786432;1885222;1605323;2509824
691571,204;301056;23988;325632;1397378;1397377;1397760;1698434;1421365;1723392;186678;186678;786432;1885112;1608043;2509824
691591,088;301055;19058;325632;1397378;1397374;1397760;1698433;1416432;1723392;186678;186678;786432;1885111;1603110;2509824
691635,851;301056;20994;325632;1397374;1397375;1397760;1698430;1418369;1723392;186678;186678;786432;1885108;1605047;2509824
691654,031;301056;21461;325632;1397374;1397366;1397760;1698430;1418827;1723392;186678;186663;786432;1885108;1605490;2509824
691673,760;301056;21960;325632;1397366;1397365;1397760;1698422;1419325;1723392;186663;186663;786432;1885085;1605988;2509824
691698,191;300820;24429;325632;1397366;1397366;1397760;1698186;1421795;1723392;186663;186663;786432;1884849;1608458;2509824
691724,601;301056;24149;325632;1397365;1397366;1397760;1698421;1421515;1723392;186669;186669;786432;1885090;1608184;2509824
691744,096;301056;24234;325632;1397365;1397326;1397760;1698421;1421560;1723392;186669;186669;786432;1885090;1608229;2509824
691760,830;301056;24768;325632;1397325;1397325;1397760;1698381;1422093;1723392;186672;186672;786432;1885053;1608765;2509824
691791,993;301056;25216;325632;1397324;1397325;1397760;1698380;1422541;1723392;186672;186672;786432;1885052;1609213;2509824
691872,880;301056;25018;325632;1397324;1397325;1397760;1698380;1422343;1723392;186672;186672;786432;1885052;1609015;2509824
691932,529;301056;28903;325632;1397324;1397325;1397760;1698380;1426228;1723392;186672;186672;786432;1885052;1612900;2509824
691964,300;301056;26240;325632;1397324;1397324;1397760;1698380;1423564;1723392;186672;186672;786432;1885052;1610236;2509824
692217,451;301056;32553;325632;1397324;1397567;1397760;1698380;1430120;1723392;186839;186787;786432;1885219;1616907;2509824
692321,481;301056;23106;325632;1397567;1397568;1397760;1698623;1420674;1723392;186850;186734;786432;1885473;1607408;2509824
692414,151;301056;26628;325632;1397567;1397568;1397760;1698623;1424196;1723392;186734;186734;786432;1885357;1610930;2509824
692640,196;301056;25281;325632;1397567;1397567;1397760;1698623;1422848;1723392;186734;186734;786432;1885357;1609582;2509824
692757,235;301056;26558;325632;1397567;1397566;1397760;1698623;1424124;1723392;186734;186728;786432;1885357;1610852;2509824
693172,038;301056;20445;325632;1397566;1397566;1397760;1698622;1418011;1723392;186728;186728;786432;1885350;1604739;2509824
693229,341;301056;23121;325632;1397752;1397580;1397760;1698808;1420701;1723392;186728;186728;786432;1885536;1607429;2509824
693260,876;301056;22822;325632;1397583;1397569;1397760;1698639;1420391;1723392;186728;186728;786432;1885367;1607119;2509824
693377,095;301056;25707;325632;1397569;1397566;1397760;1698625;1423273;1723392;186728;186728;786432;1885353;1610001;2509824
693405,425;301056;23537;325632;1397566;1397566;1397760;1698622;1421103;1723392;186728;186728;786432;1885350;1607831;2509824
693444,112;301056;23734;325632;1397566;1397566;1397760;1698622;1421300;1723392;186728;186728;786432;1885350;1608028;2509824
693532,518;301056;26231;325632;1397565;1397557;1397760;1698621;1423788;1723392;186730;186683;786432;1885351;1610471;2509824
693657,700;301056;26170;325632;1397556;1397555;1397760;1698612;1423725;1723392;186684;186684;786432;1885296;1610409;2509824
693681,721;301056;27845;325632;1397555;1397286;1397760;1698611;1425131;1723392;186851;186799;786432;1885462;1611930;2509824
693746,144;301056;27375;325632;1397286;1397283;1397760;1698342;1424658;1723392;186808;186692;786432;1885150;1611350;2509824
693853,464;301056;27038;325632;1397282;1397271;1397760;1698338;1424309;1723392;186692;186692;786432;1885030;1611001;2509824
693892,353;301056;26940;325632;1397271;1397271;1397760;1698327;1424211;1723392;186692;186692;786432;1885019;1610903;2509824
694207,233;301056;26903;325632;1397271;1397271;1397760;1698327;1424174;1723392;186860;186808;786432;1885187;1610982;2509824
694271,447;301056;29599;325632;1397271;1397271;1397760;1698327;1426870;1723392;186814;186698;786432;1885141;1613568;2509824
694590,553;301056;24798;325632;1397271;1397272;1397760;1698327;1422070;1723392;186701;186701;786432;1885028;1608771;2509824
694974,493;301056;28566;325632;1397271;1397268;1397760;1698327;1425834;1723392;186701;186602;786432;1885028;1612436;2509824
695068,316;301056;26968;325632;1397268;1397267;1397760;1698324;1424235;1723392;186614;186594;786432;1884938;1610829;2509824
695132,487;301056;25600;325632;1397267;1397268;1397760;1698323;1422868;1723392;186594;186594;786432;1884917;1609462;2509824
695175,925;301056;25977;325632;1397267;1397755;1397760;1698323;1423732;1723392;186600;186600;786432;1884923;1610332;2509824
695404,213;301056;32816;325632;1397754;1397754;1397760;1698810;1430570;1723392;186672;186672;786432;1885482;1617242;2509824
695783,869;301056;21238;325632;1397754;1397749;1397760;1698810;1418987;1723392;186675;186675;786432;1885485;1605662;2509824
695843,696;301043;24686;325632;1397749;1397715;1397760;1698792;1422401;1723392;186690;186690;786432;1885482;1609091;2509824
697076,739;300905;23817;325632;1397715;1397710;1397760;1698620;1421527;1723392;186866;186797;786432;1885486;1608324;2509824
697456,047;301056;25226;325632;1397710;1397579;1397760;1698766;1422805;1723392;186797;186533;786432;1885563;1609338;2509824
698216,412;301056;25509;325632;1397579;1397578;1397760;1698635;1423087;1723392;186533;186533;786432;1885168;1609620;2509824
698304,635;301056;22743;325632;1397578;1397504;1397760;1698634;1420247;1723392;186536;186424;786432;1885170;1606671;2509824
698492,205;301056;25369;325632;1397503;1397501;1397760;1698559;1422870;1723392;186643;186591;786432;1885202;1609461;2509824
698566,396;301056;22514;325632;1397500;1397500;1397760;1698556;1420014;1723392;186759;186591;786432;1885315;1606605;2509824
698610,234;301056;22690;325632;1397500;1397743;1397760;1698556;1420433;1723392;186808;186641;786432;1885364;1607074;2509824
698648,704;301056;22372;325632;1397743;1397744;1397760;1698799;1420116;1723392;186811;186644;786432;1885610;1606760;2509824
698787,441;301056;25445;325632;1397743;1397744;1397760;1698799;1423189;1723392;186647;186531;786432;1885446;1609720;2509824
698854,598;301056;27316;325632;1397743;1397742;1397760;1698799;1425058;1723392;186704;186652;786432;1885503;1611710;2509824
698898,113;301056;27731;325632;1397742;1397742;1397760;1698798;1425473;1723392;186908;186740;786432;1885706;1612213;2509824
699203,489;301056;27536;325632;1397742;1397731;1397760;1698798;1425267;1723392;186740;186625;786432;1885538;1611892;2509824
699480,277;301056;26416;325632;1397731;1397730;1397760;1698787;1424146;1723392;186629;186629;786432;1885416;1610775;2509824
699655,583;301056;30060;325632;1397729;1397450;1397760;1698785;1427510;1723392;186800;186748;786432;1885585;1614258;2509824
699693,134;301056;29601;325632;1397449;1397450;1397760;1698505;1427051;1723392;186754;186626;786432;1885259;1613677;2509824
699847,816;301056;28478;325632;1397449;1397449;1397760;1698505;1425927;1723392;186798;186746;786432;1885303;1612673;2509824
699885,732;301056;34857;325632;1397449;1397448;1397760;1698505;1432305;1723392;186748;186632;786432;1885253;1618937;2509824
699912,795;301056;28548;325632;1397448;1397448;1397760;1698504;1425996;1723392;186637;186637;786432;1885141;1612633;2509824
699923,885;301056;28334;325632;1397448;1397448;1397760;1698504;1425782;1723392;186637;186637;786432;1885141;1612419;2509824
699934,213;301056;30390;325632;1397448;1397448;1397760;1698504;1427838;1723392;186637;186637;786432;1885141;1614475;2509824
699950,386;301056;31062;325632;1397448;1397448;1397760;1698504;1428510;1723392;186684;186684;786432;1885188;1615194;2509824
699986,097;301056;29697;325632;1397448;1397448;1397760;1698504;1427145;1723392;186684;186684;786432;1885188;1613829;2509824
700186,373;301056;32278;325632;1397448;1397448;1397760;1698504;1429726;1723392;186860;186809;786432;1885364;1616535;2509824
700206,499;301056;32226;325632;1397447;1397448;1397760;1698503;1429674;1723392;186809;186693;786432;1885312;1616367;2509824
700292,690;301056;33136;325632;1397447;1397447;1397760;1698503;1430583;1723392;186693;186693;786432;1885196;1617276;2509824
700366,822;301056;33127;325632;1397447;1397425;1397760;1698503;1430552;1723392;186693;186693;786432;1885196;1617245;2509824
700504,715;301056;33225;325632;1397425;1397425;1397760;1698481;1430650;1723392;186860;186809;786432;1885341;1617459;2509824
700659,985;301056;37150;325632;1397425;1397669;1397760;1698481;1434819;1723392;186982;186815;786432;1885463;1621634;2509824
700809,466;301056;34587;325632;1397668;1397669;1397760;1698724;1432256;1723392;186982;186741;786432;1885706;1618997;2509824
700912,135;301056;34877;325632;1397668;1397668;1397760;1698724;1432545;1723392;186908;186741;786432;1885632;1619286;2509824
701375,574;301056;35681;325632;1397668;1397652;1397760;1698724;1433333;1723392;186747;186581;786432;1885471;1619914;2509824
701423,161;301041;31245;325632;1397652;1397651;1397760;1698693;1428896;1723392;186581;186581;786432;1885274;1615477;2509824
701568,476;301056;30340;325632;1397651;1397651;1397760;1698707;1427991;1723392;186584;186584;786432;1885291;1614575;2509824
701662,291;301056;30848;325632;1397651;1397651;1397760;1698707;1428499;1723392;186600;186600;786432;1885307;1615099;2509824
701726,392;301056;34283;325632;1397650;1397639;1397760;1698706;1431922;1723392;186603;186603;786432;1885309;1618525;2509824
701749,255;301056;33990;325632;1397638;1397370;1397760;1698694;1431360;1723392;186620;186568;786432;1885314;1617928;2509824
701767,628;301056;33815;325632;1397369;1397369;1397760;1698425;1431184;1723392;186722;186722;786432;1885147;1617906;2509824
701796,126;301056;31805;325632;1397369;1397369;1397760;1698425;1429174;1723392;186890;186722;786432;1885315;1615896;2509824
701863,365;301056;32201;325632;1397369;1397613;1397760;1698425;1429814;1723392;186890;186722;786432;1885315;1616536;2509824
701915,621;300638;38905;325632;1397613;1397613;1397760;1698251;1436518;1723392;186722;186606;786432;1884973;1623124;2509824
702003,891;301056;34596;325632;1397612;1397345;1397760;1698668;1431941;1723392;186777;186725;786432;1885445;1618666;2509824
702171,692;301056;41256;325632;1397345;1397345;1397760;1698401;1438601;1723392;186728;186612;786432;1885129;1625213;2509824
702208,366;301056;36757;325632;1397345;1397345;1397760;1698401;1434102;1723392;186612;186609;786432;1885013;1620711;2509824
702256,835;301056;36217;325632;1397345;1397345;1397760;1698401;1433562;1723392;186637;186637;786432;1885038;1620199;2509824
702313,473;301056;35593;325632;1397345;1397345;1397760;1698401;1432938;1723392;186805;186753;786432;1885206;1619691;2509824
702358,395;301053;37905;325632;1397346;1397588;1397760;1698399;1435493;1723392;186848;186680;786432;1885247;1622173;2509824
702393,316;301056;38084;325632;1397588;1397588;1397760;1698644;1435672;1723392;186774;186774;786432;1885418;1622446;2509824
702445,499;300873;40100;325632;1397589;1397588;1397760;1698462;1437688;1723392;186774;186658;786432;1885236;1624346;2509824
702539,541;301056;41119;325632;1397587;1397588;1397760;1698643;1438707;1723392;186993;186941;786432;1885636;1625648;2509824
702655,726;301056;40223;325632;1397587;1397588;1397760;1698643;1437811;1723392;186944;186661;786432;1885587;1624472;2509824
702744,524;301056;39297;325632;1397587;1397588;1397760;1698643;1436885;1723392;186713;186713;786432;1885356;1623598;2509824
702798,268;301056;40690;325632;1397587;1397586;1397760;1698643;1438276;1723392;186713;186713;786432;1885356;1624989;2509824
702881,059;301056;40128;325632;1397586;1397318;1397760;1698642;1437446;1723392;186884;186832;786432;1885526;1624278;2509824
703546,891;301056;39956;325632;1397317;1397310;1397760;1698373;1437266;1723392;186838;186722;786432;1885211;1623988;2509824
703707,952;301056;39040;325632;1397310;1397310;1397760;1698366;1436350;1723392;186735;186691;786432;1885101;1623041;2509824
703758,640;301056;37379;325632;1397310;1397311;1397760;1698366;1434690;1723392;186691;186691;786432;1885057;1621381;2509824
703978,484;300905;36718;325632;1397310;1397310;1397760;1698215;1434028;1723392;186700;186700;786432;1884915;1620728;2509824
704042,028;301056;41437;325632;1397310;1397309;1397760;1698366;1438746;1723392;186700;186700;786432;1885066;1625446;2509824
704142,961;301056;35981;325632;1397309;1397310;1397760;1698365;1433291;1723392;186703;186703;786432;1885068;1619994;2509824
704224,471;301056;39006;325632;1397309;1397309;1397760;1698365;1436315;1723392;186870;186818;786432;1885235;1623133;2509824
704285,064;301056;35786;325632;1397309;1397310;1397760;1698365;1433096;1723392;186818;186703;786432;1885183;1619799;2509824
704311,287;301056;38929;325632;1397309;1397309;1397760;1698365;1436238;1723392;186870;186818;786432;1885235;1623056;2509824
704427,928;301056;36460;325632;1397309;1397309;1397760;1698365;1433769;1723392;186986;186818;786432;1885351;1620587;2509824
704479,098;301056;39827;325632;1397308;1397309;1397760;1698364;1437136;1723392;186818;186703;786432;1885182;1623839;2509824
704494,974;301056;37702;325632;1397308;1397309;1397760;1698364;1435011;1723392;186870;186818;786432;1885234;1621829;2509824
704609,483;301056;36631;325632;1397308;1397309;1397760;1698364;1433940;1723392;186986;186818;786432;1885350;1620758;2509824
704692,807;301056;36634;325632;1397308;1397309;1397760;1698364;1433943;1723392;186823;186707;786432;1885187;1620650;2509824
704926,748;301056;39542;325632;1397308;1397308;1397760;1698364;1436850;1723392;186884;186832;786432;1885248;1623682;2509824
705160,258;301056;42091;325632;1397308;1397308;1397760;1698364;1439399;1723392;186832;186716;786432;1885196;1626115;2509824
705214,952;301056;38774;325632;1397307;1397307;1397760;1698363;1436081;1723392;186721;186719;786432;1885084;1622800;2509824
705281,222;301056;36504;325632;1397307;1397307;1397760;1698363;1433811;1723392;186719;186719;786432;1885082;1620530;2509824
705308,521;301056;37319;325632;1397307;1397307;1397760;1698363;1434626;1723392;186886;186834;786432;1885249;1621460;2509824
705350,469;301056;36674;325632;1397307;1397308;1397760;1698363;1433982;1723392;186834;186719;786432;1885197;1620701;2509824
705416,614;301056;37053;325632;1397307;1397308;1397760;1698363;1434361;1723392;186719;186719;786432;1885082;1621080;2509824
705459,709;301056;38132;325632;1397307;1397307;1397760;1698363;1435439;1723392;186886;186834;786432;1885249;1622273;2509824
705540,347;301056;37066;325632;1397307;1397308;1397760;1698363;1434374;1723392;186836;186720;786432;1885199;1621094;2509824
705680,134;301056;35911;325632;1397307;1397308;1397760;1698363;1433219;1723392;186720;186720;786432;1885083;1619939;2509824
705716,120;301056;36500;325632;1397307;1397276;1397760;1698363;1433776;1723392;186720;186550;786432;1885083;1620326;2509824
705758,117;301056;35564;325632;1397276;1397272;1397760;1698332;1432836;1723392;186550;186550;786432;1884882;1619386;2509824
705807,374;301056;35885;325632;1397272;1397273;1397760;1698328;1433158;1723392;186550;186550;786432;1884878;1619708;2509824
705831,826;301056;41332;325632;1397272;1397271;1397760;1698328;1438603;1723392;186727;186675;786432;1885055;1625278;2509824
705854,756;301056;38304;325632;1397270;1397271;1397760;1698326;1435575;1723392;186675;186559;786432;1885001;1622134;2509824
705915,557;301056;37995;325632;1397270;1397271;1397760;1698326;1435266;1723392;186559;186559;786432;1884885;1621825;2509824
705978,846;301056;37494;325632;1397270;1397271;1397760;1698326;1434765;1723392;186894;186791;786432;1885220;1621556;2509824
706023,289;301056;40564;325632;1397270;1397271;1397760;1698326;1437835;1723392;186823;186591;786432;1885149;1624426;2509824
706049,101;301056;41510;325632;1397270;1397271;1397760;1698326;1438781;1723392;186591;186591;786432;1884917;1625372;2509824
706083,814;301056;40868;325632;1397270;1397271;1397760;1698326;1438139;1723392;186591;186591;786432;1884917;1624730;2509824
706109,381;301056;41922;325632;1397270;1397271;1397760;1698326;1439193;1723392;186759;186707;786432;1885085;1625900;2509824
706137,987;301056;44242;325632;1397270;1397271;1397760;1698326;1441513;1723392;186707;186591;786432;1885033;1628104;2509824
706159,560;301056;43042;325632;1397270;1397271;1397760;1698326;1440313;1723392;186596;186596;786432;1884922;1626909;2509824
706231,084;301056;41685;325632;1397270;1397271;1397760;1698326;1438956;1723392;186764;186712;786432;1885090;1625668;2509824
706352,881;301056;41091;325632;1397270;1397271;1397760;1698326;1438362;1723392;186879;186712;786432;1885205;1625074;2509824
706414,460;301056;45234;325632;1397270;1397271;1397760;1698326;1442505;1723392;186712;186596;786432;1885038;1629101;2509824
706580,171;301056;41014;325632;1397270;1397754;1397760;1698326;1438768;1723392;186764;186712;786432;1885090;1625480;2509824
706642,785;301056;42448;325632;1397753;1397754;1397760;1698809;1440202;1723392;186715;186599;786432;1885524;1626801;2509824
706754,252;301056;42059;325632;1397753;1397743;1397760;1698809;1439802;1723392;186599;186587;786432;1885408;1626389;2509824
706796,090;301056;41965;325632;1397742;1397743;1397760;1698798;1439708;1723392;186624;186624;786432;1885422;1626332;2509824
706898,768;300926;42249;325632;1397743;1397743;1397760;1698669;1439992;1723392;186795;186743;786432;1885464;1626735;2509824
706966,566;301056;46891;325632;1397742;1397742;1397760;1698798;1444633;1723392;186746;186630;786432;1885544;1631263;2509824
707103,747;301056;43667;325632;1397741;1397742;1397760;1698797;1441409;1723392;186630;186630;786432;1885427;1628039;2509824
707147,102;301056;43472;325632;1397741;1397741;1397760;1698797;1441213;1723392;186798;186746;786432;1885595;1627959;2509824
707339,559;301056;43686;325632;1397741;1397742;1397760;1698797;1441428;1723392;186757;186589;786432;1885554;1628017;2509824
707535,784;301056;44489;325632;1397741;1397741;1397760;1698797;1442230;1723392;186768;186768;786432;1885565;1628998;2509824
707599,173;301056;43986;325632;1397741;1397741;1397760;1698797;1441727;1723392;186768;186652;786432;1885565;1628379;2509824
707638,456;301056;41642;325632;1397741;1397741;1397760;1698797;1439383;1723392;186652;186652;786432;1885449;1626035;2509824
707835,545;301056;43911;325632;1397741;1397741;1397760;1698797;1441652;1723392;186699;186699;786432;1885496;1628351;2509824
707869,677;301056;42782;325632;1397741;1397741;1397760;1698797;1440523;1723392;186867;186815;786432;1885664;1627338;2509824
707985,113;301056;44770;325632;1397741;1397741;1397760;1698797;1442511;1723392;186821;186705;786432;1885618;1629216;2509824
708059,163;301056;44922;325632;1397741;1397734;1397760;1698797;1442656;1723392;186705;186686;786432;1885502;1629342;2509824
708090,644;301056;42845;325632;1397734;1397735;1397760;1698790;1440580;1723392;186686;186686;786432;1885476;1627266;2509824
708170,001;301056;44536;325632;1397734;1397734;1397760;1698790;1442270;1723392;186686;186686;786432;1885476;1628956;2509824
708252,881;301056;44199;325632;1397734;1397734;1397760;1698790;1441933;1723392;186686;186686;786432;1885476;1628619;2509824
708518,341;301035;44513;325632;1397734;1397734;1397760;1698769;1442247;1723392;186698;186698;786432;1885467;1628945;2509824
708615,855;301056;46898;325632;1397734;1397734;1397760;1698790;1444632;1723392;186701;186698;786432;1885491;1631330;2509824
708694,104;301056;46409;325632;1397734;1397734;1397760;1698790;1444143;1723392;186865;186813;786432;1885655;1630956;2509824
708848,451;301056;42280;325632;1397734;1397734;1397760;1698790;1440014;1723392;186984;186816;786432;1885774;1626830;2509824
709285,673;301056;44354;325632;1397734;1397733;1397760;1698790;1442087;1723392;186996;186811;786432;1885786;1628898;2509824
709457,633;301056;43730;325632;1397733;1397734;1397760;1698789;1441464;1723392;186816;186700;786432;1885605;1628164;2509824
709496,149;301056;41974;325632;1397733;1397733;1397760;1698789;1439707;1723392;186700;186700;786432;1885489;1626407;2509824
709537,118;301056;43497;325632;1397733;1397733;1397760;1698789;1441230;1723392;186701;186610;786432;1885490;1627840;2509824
709557,609;301056;45160;325632;1397733;1397733;1397760;1698789;1442893;1723392;186610;186610;786432;1885399;1629503;2509824
709648,453;301056;48256;325632;1397733;1397733;1397760;1698789;1445989;1723392;186778;186726;786432;1885567;1632715;2509824
709686,723;301056;44180;325632;1397733;1397733;1397760;1698789;1441913;1723392;186894;186726;786432;1885683;1628639;2509824
709949,351;301056;45292;325632;1397733;1397733;1397760;1698789;1443025;1723392;186726;186610;786432;1885515;1629635;2509824
709983,279;300984;47131;325632;1397733;1397733;1397760;1698717;1444864;1723392;186610;186610;786432;1885327;1631474;2509824
710012,743;301056;49954;325632;1397733;1397733;1397760;1698789;1447687;1723392;186789;186738;786432;1885578;1634425;2509824
710030,684;301056;47843;325632;1397733;1397733;1397760;1698789;1445576;1723392;186743;186627;786432;1885532;1632203;2509824
710045,976;301056;46101;325632;1397733;1397733;1397760;1698789;1443834;1723392;186627;186627;786432;1885416;1630461;2509824
710072,653;301056;46341;325632;1397733;1397733;1397760;1698789;1444074;1723392;186627;186627;786432;1885416;1630701;2509824
710102,287;301056;47016;325632;1397733;1397733;1397760;1698789;1444749;1723392;186794;186743;786432;1885583;1631492;2509824
710147,816;301056;46161;325632;1397733;1397733;1397760;1698789;1443894;1723392;186931;186764;786432;1885720;1630658;2509824
710206,288;301056;48850;325632;1397733;1397733;1397760;1698789;1446583;1723392;186960;186792;786432;1885749;1633375;2509824
710301,826;301056;46755;325632;1397733;1397733;1397760;1698789;1444488;1723392;186960;186792;786432;1885749;1631280;2509824
710350,125;301056;46195;325632;1397733;1397733;1397760;1698789;1443928;1723392;186960;186792;786432;1885749;1630720;2509824
710427,155;301056;49320;325632;1397733;1397733;1397760;1698789;1447053;1723392;186792;186666;786432;1885581;1633719;2509824
710529,740;301056;46532;325632;1397733;1397733;1397760;1698789;1444265;1723392;186666;186666;786432;1885455;1630931;2509824
710681,768;301056;52659;325632;1397733;1397733;1397760;1698789;1450392;1723392;186836;186784;786432;1885625;1637176;2509824
710762,339;301056;47721;325632;1397732;1397733;1397760;1698788;1445454;1723392;186784;186669;786432;1885572;1632123;2509824
710805,040;301056;51710;325632;1397732;1397733;1397760;1698788;1449443;1723392;186899;186847;786432;1885687;1636290;2509824
710845,001;301056;47637;325632;1397732;1397733;1397760;1698788;1445370;1723392;186847;186714;786432;1885635;1632084;2509824
711211,647;301056;53100;325632;1397732;1397733;1397760;1698788;1450833;1723392;186881;186829;786432;1885669;1637662;2509824
711305,046;301056;49470;325632;1397732;1397733;1397760;1698788;1447203;1723392;186832;186717;786432;1885620;1633920;2509824
711517,291;301056;49343;325632;1397732;1397733;1397760;1698788;1447076;1723392;186885;186833;786432;1885673;1633909;2509824
711912,939;301056;45463;325632;1397732;1397733;1397760;1698788;1443196;1723392;186833;186718;786432;1885621;1629914;2509824
712006,761;301056;47655;325632;1397732;1397732;1397760;1698788;1445387;1723392;186718;186667;786432;1885506;1632054;2509824
712030,886;301056;49599;325632;1397732;1397733;1397760;1698788;1447332;1723392;186930;186826;786432;1885718;1634158;2509824
712517,886;301056;50617;325632;1397732;1397719;1397760;1698788;1448336;1723392;186903;186787;786432;1885691;1635123;2509824
712790,612;301056;52079;325632;1397719;1397701;1397760;1698775;1449780;1723392;186787;186671;786432;1885562;1636451;2509824
712909,232;301056;45622;325632;1397701;1397700;1397760;1698757;1443322;1723392;186671;186573;786432;1885428;1629895;2509824
713211,970;301043;48489;325632;1397701;1397701;1397760;1698744;1446190;1723392;186573;186573;786432;1885317;1632763;2509824
713593,729;301056;50000;325632;1397700;1397701;1397760;1698756;1447701;1723392;186585;186585;786432;1885341;1634286;2509824
713632,081;301056;49134;325632;1397700;1397700;1397760;1698756;1446834;1723392;186619;186614;786432;1885375;1633448;2509824
713661,448;301056;51850;325632;1397699;1397699;1397760;1698755;1449549;1723392;186623;186623;786432;1885378;1636172;2509824
713686,316;301056;47938;325632;1397699;1397700;1397760;1698755;1445638;1723392;186623;186623;786432;1885378;1632261;2509824
713710,377;301056;49331;325632;1397699;1397699;1397760;1698755;1447030;1723392;186623;186623;786432;1885378;1633653;2509824
713772,917;301004;49690;325632;1397700;1397700;1397760;1698704;1447390;1723392;186633;186633;786432;1885337;1634023;2509824
713866,475;301056;51551;325632;1397699;1397700;1397760;1698755;1449251;1723392;186804;186752;786432;1885559;1636003;2509824
713924,230;301056;49606;325632;1397699;1397699;1397760;1698755;1447305;1723392;186752;186636;786432;1885507;1633941;2509824
714079,389;301056;52467;325632;1397699;1397700;1397760;1698755;1450167;1723392;186639;186639;786432;1885394;1636806;2509824
714130,735;301056;52346;325632;1397699;1397700;1397760;1698755;1450046;1723392;186650;186650;786432;1885405;1636696;2509824
714184,663;301056;51571;325632;1397699;1397699;1397760;1698755;1449270;1723392;186988;186884;786432;1885743;1636154;2509824
714244,423;301056;58971;325632;1397699;1397699;1397760;1698755;1456670;1723392;186887;186656;786432;1885642;1643326;2509824
714280,830;301056;53369;325632;1397699;1397699;1397760;1698755;1451068;1723392;186703;186703;786432;1885458;1637771;2509824
714321,877;301056;54903;325632;1397699;1397700;1397760;1698755;1452603;1723392;186713;186713;786432;1885468;1639316;2509824
714455,218;301056;53747;325632;1397699;1397699;1397760;1698755;1451446;1723392;186895;186844;786432;1885650;1638290;2509824
714539,918;301056;53679;325632;1397699;1397699;1397760;1698755;1451378;1723392;186844;186728;786432;1885599;1638106;2509824
714806,588;301056;53688;325632;1397699;1397700;1397760;1698755;1451388;1723392;186898;186847;786432;1885653;1638235;2509824
714842,810;301056;55294;325632;1397699;1397699;1397760;1698755;1452993;1723392;186847;186731;786432;1885602;1639724;2509824
714875,351;301056;54606;325632;1397699;1397700;1397760;1698755;1452306;1723392;186731;186731;786432;1885486;1639037;2509824
714905,647;301056;57963;325632;1397699;1397699;1397760;1698755;1455662;1723392;186898;186847;786432;1885653;1642509;2509824
714931,652;301056;53200;325632;1397699;1397700;1397760;1698755;1450900;1723392;186862;186746;786432;1885617;1637646;2509824
714984,467;301056;54967;325632;1397699;1397699;1397760;1698755;1452666;1723392;186919;186868;786432;1885674;1639534;2509824
715157,950;301056;59032;325632;1397699;1397700;1397760;1698755;1456732;1723392;187035;186853;786432;1885790;1643585;2509824
715228,691;301056;55136;325632;1397699;1397700;1397760;1698755;1452836;1723392;186856;186740;786432;1885611;1639576;2509824
715258,021;301056;53926;325632;1397699;1397699;1397760;1698755;1451625;1723392;186740;186740;786432;1885495;1638365;2509824
715282,420;301056;57649;325632;1397699;1397699;1397760;1698755;1455348;1723392;187075;186972;786432;1885830;1642320;2509824
715328,694;301056;58425;325632;1397699;1397699;1397760;1698755;1456124;1723392;187139;186804;786432;1885894;1642928;2509824
715360,315;301056;57743;325632;1397699;1397699;1397760;1698755;1455442;1723392;186972;186856;786432;1885727;1642298;2509824
715379,050;301056;55918;325632;1397699;1397699;1397760;1698755;1453617;1723392;186856;186740;786432;1885611;1640357;2509824
715386,835;301056;60997;325632;1397699;1397699;1397760;1698755;1458696;1723392;186740;186688;786432;1885495;1645384;2509824
715410,178;301056;63258;325632;1397699;1397699;1397760;1698755;1460957;1723392;187026;186975;786432;1885781;1647932;2509824
715434,835;301056;61055;325632;1397699;1397699;1397760;1698755;1458754;1723392;186975;186691;786432;1885730;1645445;2509824
715505,294;301056;60180;325632;1397699;1397700;1397760;1698755;1457880;1723392;187032;186981;786432;1885787;1644861;2509824
715527,025;301056;59105;325632;1397699;1397699;1397760;1698755;1456804;1723392;186981;186749;786432;1885736;1643553;2509824
715545,632;301056;58403;325632;1397699;1397700;1397760;1698755;1456103;1723392;186761;186761;786432;1885516;1642864;2509824
715553,427;301056;58171;325632;1397699;1397699;1397760;1698755;1455870;1723392;186766;186766;786432;1885521;1642636;2509824
715563,010;301056;58925;325632;1397699;1397699;1397760;1698755;1456624;1723392;187078;186975;786432;1885833;1643599;2509824
715607,165;301056;61614;325632;1397699;1397699;1397760;1698755;1459313;1723392;187166;186998;786432;1885921;1646311;2509824
715638,277;301056;61921;325632;1397699;1397699;1397760;1698755;1459620;1723392;187166;186882;786432;1885921;1646502;2509824
715648,572;301056;59443;325632;1397699;1397699;1397760;1698755;1457142;1723392;186882;186766;786432;1885637;1643908;2509824
715668,372;301056;63541;325632;1397699;1397699;1397760;1698755;1461240;1723392;187101;186998;786432;1885856;1648238;2509824
715743,460;301056;62935;325632;1397699;1397699;1397760;1698755;1460634;1723392;187166;186882;786432;1885921;1647516;2509824
715803,405;301056;64173;325632;1397699;1397699;1397760;1698755;1461872;1723392;187004;186837;786432;1885759;1648709;2509824
715863,461;301056;61448;325632;1397699;1397699;1397760;1698755;1459147;1723392;186882;186882;786432;1885637;1646029;2509824
715887,471;301056;62754;325632;1397699;1397699;1397760;1698755;1460453;1723392;187050;186882;786432;1885805;1647335;2509824
716110,505;301056;63011;325632;1397699;1397699;1397760;1698755;1460710;1723392;186882;186766;786432;1885637;1647476;2509824
716215,059;301056;60468;325632;1397699;1397699;1397760;1698755;1458167;1723392;186766;186764;786432;1885521;1644931;2509824
716321,714;301056;62616;325632;1397699;1397699;1397760;1698755;1460315;1723392;186772;186772;786432;1885527;1647087;2509824
716396,412;301056;64326;325632;1397699;1397699;1397760;1698755;1462025;1723392;186940;186888;786432;1885695;1648913;2509824
716430,004;300966;64918;325632;1397699;1397699;1397760;1698665;1462617;1723392;186888;186772;786432;1885553;1649389;2509824
716447,873;300973;63171;325632;1397699;1397699;1397760;1698672;1460870;1723392;186772;186772;786432;1885444;1647642;2509824
716477,621;301056;63668;325632;1397698;1397699;1397760;1698754;1461367;1723392;186940;186888;786432;1885694;1648255;2509824
716957,872;301056;56415;325632;1397698;1397699;1397760;1698754;1454114;1723392;187056;186888;786432;1885810;1641002;2509824
717032,644;300932;55811;325632;1397699;1397699;1397760;1698631;1453510;1723392;186888;186772;786432;1885519;1640282;2509824
717176,004;301056;56023;325632;1397698;1397699;1397760;1698754;1453722;1723392;186940;186871;786432;1885694;1640593;2509824
717251,100;301056;59189;325632;1397698;1397699;1397760;1698754;1456888;1723392;186871;186735;786432;1885625;1643623;2509824
717322,642;301056;56097;325632;1397698;1397699;1397760;1698754;1453796;1723392;186735;186735;786432;1885489;1640531;2509824
717364,911;301056;56334;325632;1397698;1397698;1397760;1698754;1454032;1723392;186735;186735;786432;1885489;1640767;2509824
717472,737;301056;58066;325632;1397698;1397699;1397760;1698754;1455765;1723392;186735;186735;786432;1885489;1642500;2509824
717641,818;300998;57920;325632;1397698;1397699;1397760;1698696;1455619;1723392;186735;186735;786432;1885431;1642354;2509824
717687,669;301056;60608;325632;1397698;1397698;1397760;1698754;1458306;1723392;186735;186720;786432;1885489;1645026;2509824
717714,809;301056;58158;325632;1397698;1397698;1397760;1698754;1455856;1723392;186720;186717;786432;1885474;1642573;2509824
717787,491;301056;60682;325632;1397698;1397698;1397760;1698754;1458380;1723392;186717;186717;786432;1885471;1645097;2509824
717817,094;301056;57991;325632;1397698;1397698;1397760;1698754;1455689;1723392;186717;186717;786432;1885471;1642406;2509824
717934,185;301056;62480;325632;1397698;1397698;1397760;1698754;1460178;1723392;186884;186833;786432;1885638;1647011;2509824
718055,341;301056;63143;325632;1397698;1397698;1397760;1698754;1460841;1723392;186833;186717;786432;1885587;1647558;2509824
718145,130;301056;65054;325632;1397698;1397699;1397760;1698754;1462753;1723392;186729;186729;786432;1885483;1649482;2509824
718159,973;301056;64908;325632;1397698;1397698;1397760;1698754;1462606;1723392;186896;186844;786432;1885650;1649450;2509824
718201,255;301056;62731;325632;1397698;1397698;1397760;1698754;1460429;1723392;187012;186844;786432;1885766;1647273;2509824
718271,711;301056;66579;325632;1397698;1397698;1397760;1698754;1464277;1723392;187012;186844;786432;1885766;1651121;2509824
718340,003;301056;62794;325632;1397698;1397698;1397760;1698754;1460492;1723392;187012;186844;786432;1885766;1647336;2509824
718433,900;301056;67381;325632;1397698;1397698;1397760;1698754;1465079;1723392;186844;186729;786432;1885598;1651808;2509824
718470,307;301056;65196;325632;1397698;1397699;1397760;1698754;1462895;1723392;186729;186729;786432;1885483;1649624;2509824
718481,031;301056;65278;325632;1397698;1397698;1397760;1698754;1462976;1723392;186729;186729;786432;1885483;1649705;2509824
718598,001;301056;70454;325632;1397698;1397698;1397760;1698754;1468152;1723392;187067;186963;786432;1885821;1655115;2509824
718653,051;301056;65261;325632;1397698;1397698;1397760;1698754;1462959;1723392;186963;186732;786432;1885717;1649691;2509824
718686,620;301056;66700;325632;1397698;1397698;1397760;1698754;1464398;1723392;186732;186732;786432;1885486;1651130;2509824
718744,430;301056;69487;325632;1397698;1397698;1397760;1698754;1467185;1723392;186732;186720;786432;1885486;1653905;2509824
718773,282;301056;66389;325632;1397698;1397698;1397760;1698754;1464087;1723392;186737;186737;786432;1885491;1650824;2509824
718786,725;301056;67054;325632;1397698;1397698;1397760;1698754;1464752;1723392;186737;186737;786432;1885491;1651489;2509824
718833,018;301056;68184;325632;1397698;1397698;1397760;1698754;1465882;1723392;187072;186969;786432;1885826;1652851;2509824
718852,881;301056;67163;325632;1397698;1397698;1397760;1698754;1464861;1723392;187136;186853;786432;1885890;1651714;2509824
718901,993;301056;72226;325632;1397698;1397698;1397760;1698754;1469924;1723392;187025;186858;786432;1885779;1656782;2509824
718935,051;301056;69736;325632;1397698;1397699;1397760;1698754;1467435;1723392;186875;186760;786432;1885629;1654195;2509824
718961,588;301056;69413;325632;1397698;1397698;1397760;1698754;1467111;1723392;186927;186875;786432;1885681;1653986;2509824
718985,474;301056;70381;325632;1397698;1397698;1397760;1698754;1468079;1723392;186875;186760;786432;1885629;1654839;2509824
718993,316;301056;71021;325632;1397698;1397698;1397760;1698754;1468719;1723392;186927;186875;786432;1885681;1655594;2509824
719001,235;301056;70750;325632;1397698;1397698;1397760;1698754;1468448;1723392;186875;186760;786432;1885629;1655208;2509824
719017,864;301056;69667;325632;1397698;1397698;1397760;1698754;1467365;1723392;186760;186760;786432;1885514;1654125;2509824
719048,963;301056;70439;325632;1397698;1397699;1397760;1698754;1468138;1723392;186760;186760;786432;1885514;1654898;2509824
719180,803;301056;70511;325632;1397698;1397699;1397760;1698754;1468210;1723392;186930;186878;786432;1885684;1655088;2509824
719246,987;301056;73944;325632;1397698;1397699;1397760;1698754;1471643;1723392;186881;186765;786432;1885635;1658408;2509824
719267,690;301056;73442;325632;1397698;1397698;1397760;1698754;1471140;1723392;186765;186765;786432;1885519;1657905;2509824
719296,554;301056;69817;325632;1397698;1397699;1397760;1698754;1467516;1723392;186765;186765;786432;1885519;1654281;2509824
719317,664;301056;70245;325632;1397698;1397699;1397760;1698754;1467944;1723392;186765;186765;786432;1885519;1654709;2509824
719327,342;301056;72779;325632;1397698;1397698;1397760;1698754;1470477;1723392;186933;186881;786432;1885687;1657358;2509824
719338,562;301056;71382;325632;1397698;1397698;1397760;1698754;1469080;1723392;187052;186884;786432;1885806;1655964;2509824
719440,517;301056;71378;325632;1397698;1397698;1397760;1698754;1469076;1723392;187219;187000;786432;1885973;1656076;2509824
719481,902;301056;70275;325632;1397698;1397699;1397760;1698754;1467974;1723392;187000;186768;786432;1885754;1654742;2509824
719525,069;301056;70823;325632;1397698;1397698;1397760;1698754;1468521;1723392;186768;186768;786432;1885522;1655289;2509824
719557,847;301056;75504;325632;1397698;1397699;1397760;1698754;1473203;1723392;186768;186751;786432;1885522;1659954;2509824
719594,289;301040;74090;325632;1397698;1397698;1397760;1698738;1471788;1723392;186751;186751;786432;1885489;1658539;2509824
719628,973;301056;72315;325632;1397698;1397698;1397760;1698754;1470013;1723392;186751;186751;786432;1885505;1656764;2509824
719660,224;301056;71705;325632;1397698;1397698;1397760;1698754;1469403;1723392;186751;186751;786432;1885505;1656154;2509824
719673,531;301056;71989;325632;1397698;1397698;1397760;1698754;1469687;1723392;186751;186748;786432;1885505;1656435;2509824
719687,117;301056;73886;325632;1397698;1397698;1397760;1698754;1471584;1723392;186748;186748;786432;1885502;1658332;2509824
719701,393;301056;72289;325632;1397698;1397698;1397760;1698754;1469987;1723392;186748;186748;786432;1885502;1656735;2509824
719728,026;301056;73284;325632;1397698;1397699;1397760;1698754;1470983;1723392;186915;186864;786432;1885669;1657847;2509824
719754,893;301056;72564;325632;1397698;1397698;1397760;1698754;1470262;1723392;186864;186748;786432;1885618;1657010;2509824
719898,471;301056;72306;325632;1397698;1397698;1397760;1698754;1470004;1723392;186915;186864;786432;1885669;1656868;2509824
719926,853;301056;74313;325632;1397698;1397698;1397760;1698754;1472011;1723392;186864;186748;786432;1885618;1658759;2509824
719960,035;301056;71873;325632;1397698;1397699;1397760;1698754;1469572;1723392;186748;186748;786432;1885502;1656320;2509824
720051,579;301056;76866;325632;1397698;1397698;1397760;1698754;1474564;1723392;186915;186864;786432;1885669;1661428;2509824
720355,667;301056;74111;325632;1397698;1397699;1397760;1698754;1471810;1723392;187031;186864;786432;1885785;1658674;2509824
720421,972;301056;76742;325632;1397698;1397698;1397760;1698754;1474440;1723392;186878;186763;786432;1885632;1661203;2509824
720445,195;301056;72192;325632;1397698;1397699;1397760;1698754;1469891;1723392;186763;186763;786432;1885517;1656654;2509824
720456,756;301056;72694;325632;1397698;1397698;1397760;1698754;1470392;1723392;186763;186763;786432;1885517;1657155;2509824
720463,047;301056;74611;325632;1397698;1397699;1397760;1698754;1472310;1723392;186763;186763;786432;1885517;1659073;2509824
720486,565;301056;72641;325632;1397698;1397699;1397760;1698754;1470340;1723392;186763;186763;786432;1885517;1657103;2509824
720495,984;301056;76907;325632;1397698;1397698;1397760;1698754;1474605;1723392;186930;186878;786432;1885684;1661483;2509824
720528,966;301056;72010;325632;1397698;1397698;1397760;1698754;1469708;1723392;186878;186763;786432;1885632;1656471;2509824
720558,011;301056;71937;325632;1397698;1397698;1397760;1698754;1469635;1723392;186763;186763;786432;1885517;1656398;2509824
720581,126;301056;72092;325632;1397698;1397698;1397760;1698754;1469790;1723392;186779;186728;786432;1885533;1656518;2509824
720751,467;301056;70229;325632;1397698;1397698;1397760;1698754;1467927;1723392;186878;186878;786432;1885632;1654805;2509824
720878,990;301056;71033;325632;1397698;1397698;1397760;1698754;1468731;1723392;187046;186878;786432;1885800;1655609;2509824
720913,100;301056;72924;325632;1397698;1397698;1397760;1698754;1470622;1723392;186893;186777;786432;1885647;1657399;2509824
720940,366;301056;73028;325632;1397698;1397698;1397760;1698754;1470726;1723392;186777;186777;786432;1885531;1657503;2509824
721005,635;301056;72392;325632;1397698;1397698;1397760;1698754;1470090;1723392;186945;186893;786432;1885699;1656983;2509824
721024,732;301056;70978;325632;1397698;1397698;1397760;1698754;1468676;1723392;186893;186777;786432;1885647;1655453;2509824
721050,970;301056;70171;325632;1397698;1397698;1397760;1698754;1467869;1723392;186777;186777;786432;1885531;1654646;2509824
721110,627;301056;72022;325632;1397698;1397698;1397760;1698754;1469720;1723392;186945;186893;786432;1885699;1656613;2509824
721153,228;301056;72676;325632;1397698;1397698;1397760;1698754;1470374;1723392;187060;186893;786432;1885814;1657267;2509824
721280,605;301056;77304;325632;1397698;1397698;1397760;1698754;1475002;1723392;186893;186777;786432;1885647;1661779;2509824
721329,411;301056;71707;325632;1397698;1397698;1397760;1698754;1469405;1723392;186777;186777;786432;1885531;1656182;2509824
721361,542;301056;72238;325632;1397698;1397698;1397760;1698754;1469936;1723392;186945;186893;786432;1885699;1656829;2509824
721446,676;301056;75631;325632;1397698;1397698;1397760;1698754;1473329;1723392;187060;186893;786432;1885814;1660222;2509824
721584,382;301056;76342;325632;1397698;1397698;1397760;1698754;1474040;1723392;186893;186774;786432;1885647;1660814;2509824
721613,812;301056;75990;325632;1397698;1397698;1397760;1698754;1473688;1723392;186774;186754;786432;1885528;1660442;2509824
721658,921;301056;74192;325632;1397698;1397698;1397760;1698754;1471890;1723392;186754;186754;786432;1885508;1658644;2509824
721712,321;301056;79586;325632;1397698;1397699;1397760;1698754;1477285;1723392;187040;186988;786432;1885794;1664273;2509824
721757,768;301056;76862;325632;1397698;1397698;1397760;1698754;1474560;1723392;186988;186757;786432;1885742;1661317;2509824
721770,062;301056;75355;325632;1397698;1397698;1397760;1698754;1473053;1723392;186757;186757;786432;1885511;1659810;2509824
721790,723;301056;78233;325632;1397698;1397698;1397760;1698754;1475931;1723392;186924;186873;786432;1885678;1662804;2509824
721959,121;301056;74716;325632;1397698;1397698;1397760;1698754;1472414;1723392;187040;186873;786432;1885794;1659287;2509824
721990,073;301056;76661;325632;1397698;1397698;1397760;1698754;1474359;1723392;186873;186757;786432;1885627;1661116;2509824
722267,513;301052;71284;325632;1397698;1397698;1397760;1698750;1468982;1723392;186757;186757;786432;1885507;1655739;2509824
722502,921;301056;71148;325632;1397698;1397698;1397760;1698754;1468846;1723392;186757;186757;786432;1885511;1655603;2509824
722564,498;301056;71513;325632;1397698;1397698;1397760;1698754;1469211;1723392;186757;186727;786432;1885511;1655938;2509824
722587,927;300795;71587;325632;1397698;1397698;1397760;1698493;1469285;1723392;186727;186727;786432;1885220;1656012;2509824
722607,715;300921;77293;325632;1397698;1397430;1397760;1698619;1474723;1723392;186895;186843;786432;1885514;1661566;2509824
722630,146;301056;73396;325632;1397429;1397429;1397760;1698485;1470825;1723392;187010;186843;786432;1885495;1657668;2509824
722662,774;301056;74664;325632;1397429;1397430;1397760;1698485;1472094;1723392;187022;186855;786432;1885507;1658949;2509824
722713,438;301056;73032;325632;1397429;1397429;1397760;1698485;1470461;1723392;187022;186855;786432;1885507;1657316;2509824
722768,309;301056;76237;325632;1397429;1397430;1397760;1698485;1473667;1723392;187022;186855;786432;1885507;1660522;2509824
722805,316;300556;74369;325632;1397429;1397429;1397760;1697985;1471798;1723392;186855;186739;786432;1884840;1658537;2509824
722820,731;301056;77421;325632;1397429;1397429;1397760;1698485;1474850;1723392;186739;186739;786432;1885224;1661589;2509824
722850,079;301056;74862;325632;1397429;1397429;1397760;1698485;1472291;1723392;186739;186739;786432;1885224;1659030;2509824
722882,276;301056;76934;325632;1397429;1397429;1397760;1698485;1474363;1723392;186911;186859;786432;1885396;1661222;2509824
722923,532;301056;78188;325632;1397429;1397430;1397760;1698485;1475618;1723392;187027;186859;786432;1885512;1662477;2509824
722955,924;301056;79291;325632;1397429;1397430;1397760;1698485;1476721;1723392;187027;186859;786432;1885512;1663580;2509824
722988,673;301056;75835;325632;1397429;1397429;1397760;1698485;1473264;1723392;186859;186744;786432;1885344;1660008;2509824
723016,128;301056;72877;325632;1397429;1397429;1397760;1698485;1470306;1723392;186744;186744;786432;1885229;1657050;2509824
723030,299;301056;73127;325632;1397429;1397430;1397760;1698485;1470557;1723392;186749;186749;786432;1885234;1657306;2509824
723079,749;301056;77917;325632;1397429;1397429;1397760;1698485;1475346;1723392;186752;186752;786432;1885237;1662098;2509824
723123,209;301056;78874;325632;1397429;1397429;1397760;1698485;1476303;1723392;186928;186876;786432;1885413;1663179;2509824
723146,975;301056;78120;325632;1397429;1397429;1397760;1698485;1475549;1723392;186876;186761;786432;1885361;1662310;2509824
723167,846;301056;77563;325632;1397429;1397429;1397760;1698485;1474992;1723392;186761;186761;786432;1885246;1661753;2509824
723231,441;301056;76398;325632;1397429;1397429;1397760;1698485;1473827;1723392;186761;186761;786432;1885246;1660588;2509824
723347,299;301056;81197;325632;1397429;1397429;1397760;1698485;1478626;1723392;186928;186876;786432;1885413;1665502;2509824
723408,642;301056;78875;325632;1397429;1397428;1397760;1698485;1476303;1723392;186881;186765;786432;1885366;1663068;2509824
723440,967;301056;76517;325632;1397427;1397428;1397760;1698483;1473945;1723392;186765;186765;786432;1885248;1660710;2509824
723474,687;301056;78166;325632;1397427;1397427;1397760;1698483;1475593;1723392;186765;186765;786432;1885248;1662358;2509824
723491,144;301056;79499;325632;1397427;1397427;1397760;1698483;1476926;1723392;186933;186881;786432;1885416;1663807;2509824
723513,333;301010;81372;325632;1397427;1397428;1397760;1698437;1478800;1723392;186881;186765;786432;1885318;1665565;2509824
723522,686;301013;80105;325632;1397428;1397427;1397760;1698441;1477532;1723392;186765;186765;786432;1885206;1664297;2509824
723532,519;301056;83361;325632;1397427;1397428;1397760;1698483;1480789;1723392;186765;186765;786432;1885248;1667554;2509824
723542,239;301056;83089;325632;1397427;1397428;1397760;1698483;1480517;1723392;186933;186881;786432;1885416;1667398;2509824
723550,943;301056;82005;325632;1397427;1397428;1397760;1698483;1479433;1723392;186881;186765;786432;1885364;1666198;2509824
723569,126;301056;81580;325632;1397427;1397428;1397760;1698483;1479008;1723392;186765;186765;786432;1885248;1665773;2509824
723583,860;301056;80874;325632;1397427;1397428;1397760;1698483;1478302;1723392;186765;186765;786432;1885248;1665067;2509824
723591,344;301056;86003;325632;1397427;1397428;1397760;1698483;1483431;1723392;187100;186997;786432;1885583;1670428;2509824
723610,750;301056;83083;325632;1397427;1397428;1397760;1698483;1480511;1723392;186997;186881;786432;1885480;1667392;2509824
723619,478;301056;87210;325632;1397427;1397427;1397760;1698483;1484637;1723392;187049;186881;786432;1885532;1671518;2509824
723627,242;301056;86416;325632;1397427;1397428;1397760;1698483;1483844;1723392;186881;186765;786432;1885364;1670609;2509824
723633,545;301056;88738;325632;1397427;1397427;1397760;1698483;1486165;1723392;186933;186881;786432;1885416;1673046;2509824
723645,515;301056;85926;325632;1397427;1397427;1397760;1698483;1483353;1723392;186887;186887;786432;1885370;1670240;2509824
723662,176;301056;84577;325632;1397427;1397428;1397760;1698483;1482005;1723392;186887;186771;786432;1885370;1668776;2509824
723679,476;301056;85827;325632;1397427;1397427;1397760;1698483;1483254;1723392;186771;186771;786432;1885254;1670025;2509824
723687,322;301056;87219;325632;1397427;1397428;1397760;1698483;1484647;1723392;186771;186771;786432;1885254;1671418;2509824
723697,302;301056;88266;325632;1397427;1397427;1397760;1698483;1485693;1723392;186939;186887;786432;1885422;1672580;2509824
723714,981;301056;87160;325632;1397427;1397428;1397760;1698483;1484588;1723392;187055;186887;786432;1885538;1671475;2509824
723845,332;301056;89354;325632;1397427;1397427;1397760;1698483;1486781;1723392;187055;186887;786432;1885538;1673668;2509824
723883,323;301056;87926;325632;1397427;1397427;1397760;1698483;1485353;1723392;187055;186887;786432;1885538;1672240;2509824
723905,792;301056;85198;325632;1397427;1397427;1397760;1698483;1482625;1723392;186887;186771;786432;1885370;1669396;2509824
723932,289;301056;85396;325632;1397427;1397427;1397760;1698483;1482823;1723392;186771;186771;786432;1885254;1669594;2509824
723955,290;301056;90593;325632;1397427;1397427;1397760;1698483;1488020;1723392;186939;186887;786432;1885422;1674907;2509824
723993,259;301056;89155;325632;1397427;1397427;1397760;1698483;1486582;1723392;186887;186771;786432;1885370;1673353;2509824
724013,092;301056;89050;325632;1397427;1397427;1397760;1698483;1486477;1723392;186771;186771;786432;1885254;1673248;2509824
724038,002;300995;90282;325632;1397428;1397427;1397760;1698423;1487709;1723392;186771;186771;786432;1885194;1674480;2509824
724073,238;301056;87714;325632;1397427;1397671;1397760;1698483;1485385;1723392;186939;186887;786432;1885422;1672272;2509824
724123,744;301056;91375;325632;1397670;1397670;1397760;1698726;1489045;1723392;186887;186771;786432;1885613;1675816;2509824
724143,427;301056;92509;325632;1397670;1397670;1397760;1698726;1490179;1723392;186771;186771;786432;1885497;1676950;2509824
724167,406;301056;86823;325632;1397670;1397670;1397760;1698726;1484493;1723392;186771;186771;786432;1885497;1671264;2509824
724187,506;301056;92141;325632;1397670;1397670;1397760;1698726;1489811;1723392;186939;186887;786432;1885665;1676698;2509824
724225,226;301056;91687;325632;1397669;1397670;1397760;1698725;1489357;1723392;186887;186771;786432;1885612;1676128;2509824
724283,474;301056;89132;325632;1397669;1397670;1397760;1698725;1486802;1723392;187106;187055;786432;1885831;1673857;2509824
724336,662;301056;91118;325632;1397669;1397669;1397760;1698725;1488787;1723392;187222;186887;786432;1885947;1675674;2509824
724357,668;301056;92899;325632;1397669;1397670;1397760;1698725;1490569;1723392;186887;186771;786432;1885612;1677340;2509824
724397,137;301056;88750;325632;1397669;1397669;1397760;1698725;1486419;1723392;186771;186771;786432;1885496;1673190;2509824
724479,824;301056;92851;325632;1397669;1397669;1397760;1698725;1490520;1723392;186939;186887;786432;1885664;1677407;2509824
724515,590;301056;90526;325632;1397669;1397669;1397760;1698725;1488195;1723392;186887;186771;786432;1885612;1674966;2509824
724539,239;301056;92187;325632;1397669;1397669;1397760;1698725;1489856;1723392;186771;186771;786432;1885496;1676627;2509824
724696,408;301056;90400;325632;1397669;1397670;1397760;1698725;1488070;1723392;186939;186887;786432;1885664;1674957;2509824
724711,476;300617;90665;325632;1397669;1397400;1397760;1698286;1488065;1723392;187055;186887;786432;1885341;1674952;2509824
724740,632;301056;93013;325632;1397400;1397400;1397760;1698456;1490413;1723392;186887;186771;786432;1885343;1677184;2509824
724751,882;301056;91702;325632;1397400;1397400;1397760;1698456;1489102;1723392;186771;186771;786432;1885227;1675873;2509824
724764,065;301056;95314;325632;1397400;1397400;1397760;1698456;1492714;1723392;186771;186771;786432;1885227;1679485;2509824
724777,481;301056;91705;325632;1397400;1397400;1397760;1698456;1489105;1723392;186771;186768;786432;1885227;1675873;2509824
724791,093;301056;92864;325632;1397400;1397401;1397760;1698456;1490265;1723392;186768;186768;786432;1885224;1677033;2509824
724804,946;301056;91048;325632;1397400;1397401;1397760;1698456;1488449;1723392;186768;186768;786432;1885224;1675217;2509824
724821,169;301056;91655;325632;1397400;1397401;1397760;1698456;1489056;1723392;186936;186884;786432;1885392;1675940;2509824
724837,963;301056;89946;325632;1397400;1397401;1397760;1698456;1487347;1723392;187052;186884;786432;1885508;1674231;2509824
724900,757;301056;88828;325632;1397400;1397400;1397760;1698456;1486228;1723392;186884;186717;786432;1885340;1672945;2509824
724929,183;301056;93593;325632;1397400;1397400;1397760;1698456;1490993;1723392;187052;187000;786432;1885508;1677993;2509824
725026,834;301056;90888;325632;1397400;1397401;1397760;1698456;1488289;1723392;187000;186768;786432;1885456;1675057;2509824
725214,764;301056;89094;325632;1397400;1397400;1397760;1698456;1486494;1723392;186768;186768;786432;1885224;1673262;2509824
725240,141;301056;88082;325632;1397400;1397400;1397760;1698456;1485482;1723392;186768;186768;786432;1885224;1672250;2509824
725254,224;301056;88945;325632;1397400;1397400;1397760;1698456;1486345;1723392;186768;186768;786432;1885224;1673113;2509824
725265,987;301042;95689;325632;1397400;1397400;1397760;1698442;1493089;1723392;187438;187232;786432;1885880;1680321;2509824
725276,546;301056;93140;325632;1397400;1397400;1397760;1698456;1490540;1723392;187567;187000;786432;1886023;1677540;2509824
725293,223;301056;93524;325632;1397399;1397399;1397760;1698455;1490923;1723392;187000;186768;786432;1885455;1677691;2509824
725312,716;301056;94882;325632;1397399;1397400;1397760;1698455;1492282;1723392;187341;187186;786432;1885796;1679468;2509824
725346,775;301056;93919;325632;1397399;1397399;1397760;1698455;1491318;1723392;187186;186839;786432;1885641;1678157;2509824
725364,956;301056;92016;325632;1397399;1397399;1397760;1698455;1489415;1723392;186839;186839;786432;1885294;1676254;2509824
725387,556;301056;93944;325632;1397399;1397399;1397760;1698455;1491343;1723392;186839;186839;786432;1885294;1678182;2509824
725400,715;300576;91973;325632;1397399;1397400;1397760;1697975;1489373;1723392;186839;186839;786432;1884814;1676212;2509824
725507,596;301056;96264;325632;1397399;1397400;1397760;1698455;1493664;1723392;186839;186839;786432;1885294;1680503;2509824
725735,504;301056;92033;325632;1397399;1397388;1397760;1698455;1489421;1723392;186839;186823;786432;1885294;1676244;2509824
725761,182;301056;94638;325632;1397388;1397388;1397760;1698444;1492026;1723392;186993;186934;786432;1885437;1678960;2509824
725818,251;301056;95237;325632;1397388;1397388;1397760;1698444;1492625;1723392;187102;186935;786432;1885546;1679560;2509824
725867,303;301056;96821;325632;1397388;1397387;1397760;1698444;1494208;1723392;186990;186874;786432;1885434;1681082;2509824
725910,176;301056;95488;325632;1397386;1397387;1397760;1698442;1492875;1723392;186874;186874;786432;1885316;1679749;2509824
725933,012;301056;93224;325632;1397386;1397386;1397760;1698442;1490610;1723392;186874;186874;786432;1885316;1677484;2509824
725974,114;301056;96355;325632;1397386;1397386;1397760;1698442;1493741;1723392;187041;186989;786432;1885483;1680730;2509824
725987,295;301056;94270;325632;1397386;1397387;1397760;1698442;1491657;1723392;186989;186874;786432;1885431;1678531;2509824
726010,254;301056;96175;325632;1397386;1397386;1397760;1698442;1493561;1723392;187041;186989;786432;1885483;1680550;2509824
726030,026;301056;96081;325632;1397386;1397386;1397760;1698442;1493467;1723392;186989;186874;786432;1885431;1680341;2509824
726089,827;301056;93844;325632;1397386;1397386;1397760;1698442;1491230;1723392;186874;186874;786432;1885316;1678104;2509824
726134,737;301056;92470;325632;1397386;1397386;1397760;1698442;1489856;1723392;186874;186874;786432;1885316;1676730;2509824
726179,260;300662;92977;325632;1397386;1397386;1397760;1698048;1490363;1723392;186877;186877;786432;1884925;1677240;2509824
726231,133;301056;96136;325632;1397386;1397386;1397760;1698442;1493522;1723392;187044;186992;786432;1885486;1680514;2509824
726264,269;301056;92571;325632;1397386;1397386;1397760;1698442;1489957;1723392;186992;186877;786432;1885434;1676834;2509824
726380,805;301056;91842;325632;1397386;1397387;1397760;1698442;1489229;1723392;187044;186992;786432;1885486;1676221;2509824
726537,099;301056;91007;325632;1397386;1397386;1397760;1698442;1488393;1723392;186992;186874;786432;1885434;1675267;2509824
726599,439;301056;90909;325632;1397386;1397386;1397760;1698442;1488295;1723392;187050;186998;786432;1885492;1675293;2509824
726641,219;301056;89979;325632;1397386;1397386;1397760;1698442;1487365;1723392;186998;186882;786432;1885440;1674247;2509824
726693,563;301056;86870;325632;1397386;1397386;1397760;1698442;1484256;1723392;187050;186998;786432;1885492;1671254;2509824
726998,439;301056;88558;325632;1397386;1397386;1397760;1698442;1485944;1723392;186998;186882;786432;1885440;1672826;2509824
727026,985;301056;89482;325632;1397386;1397386;1397760;1698442;1486868;1723392;186887;186887;786432;1885329;1673755;2509824
727056,401;301056;87961;325632;1397386;1397386;1397760;1698442;1485347;1723392;186887;186887;786432;1885329;1672234;2509824
727126,478;301056;86496;325632;1397386;1397386;1397760;1698442;1483882;1723392;186887;186887;786432;1885329;1670769;2509824
727239,314;301056;89266;325632;1397386;1397386;1397760;1698442;1486652;1723392;187055;187003;786432;1885497;1673655;2509824
727357,171;301056;87719;325632;1397386;1397386;1397760;1698442;1485105;1723392;187171;186920;786432;1885613;1672025;2509824
727538,808;301056;84591;325632;1397386;1397386;1397760;1698442;1481977;1723392;186920;186804;786432;1885362;1668781;2509824
727562,647;300565;87243;325632;1397386;1397386;1397760;1697951;1484629;1723392;186804;186804;786432;1884755;1671433;2509824
727576,260;301056;90008;325632;1397386;1397386;1397760;1698442;1487394;1723392;186804;186804;786432;1885246;1674198;2509824
727595,611;301056;91759;325632;1397386;1397386;1397760;1698442;1489145;1723392;186971;186920;786432;1885413;1676065;2509824
727641,637;301056;86144;325632;1397386;1397386;1397760;1698442;1483530;1723392;186920;186804;786432;1885362;1670334;2509824
727679,740;301056;86479;325632;1397386;1397386;1397760;1698442;1483865;1723392;186804;186804;786432;1885246;1670669;2509824
727753,797;301056;90487;325632;1397386;1397386;1397760;1698442;1487873;1723392;186971;186920;786432;1885413;1674793;2509824
727819,591;301056;88282;325632;1397386;1397386;1397760;1698442;1485668;1723392;186920;186786;786432;1885362;1672454;2509824
727860,729;301056;89835;325632;1397386;1397386;1397760;1698442;1487221;1723392;186786;186786;786432;1885228;1674007;2509824
727880,146;301056;87458;325632;1397386;1397386;1397760;1698442;1484844;1723392;186786;186786;786432;1885228;1671630;2509824
727890,882;301056;87945;325632;1397386;1397386;1397760;1698442;1485331;1723392;186786;186786;786432;1885228;1672117;2509824
727927,535;301056;87328;325632;1397386;1397386;1397760;1698442;1484714;1723392;186954;186902;786432;1885396;1671616;2509824
728075,829;301056;93638;325632;1397386;1397386;1397760;1698442;1491024;1723392;186902;186786;786432;1885344;1677810;2509824
728089,309;301056;87895;325632;1397386;1397386;1397760;1698442;1485281;1723392;186786;186786;786432;1885228;1672067;2509824
728102,330;301056;87873;325632;1397386;1397386;1397760;1698442;1485259;1723392;186786;186786;786432;1885228;1672045;2509824
728131,206;301056;92107;325632;1397386;1397386;1397760;1698442;1489493;1723392;186786;186786;786432;1885228;1676279;2509824
728199,714;301056;89055;325632;1397386;1397386;1397760;1698442;1486441;1723392;186786;186786;786432;1885228;1673227;2509824
728228,880;301056;91037;325632;1397386;1397386;1397760;1698442;1488423;1723392;186786;186786;786432;1885228;1675209;2509824
728249,166;301056;92150;325632;1397386;1397386;1397760;1698442;1489536;1723392;186786;186786;786432;1885228;1676322;2509824
728266,765;301056;89990;325632;1397386;1397386;1397760;1698442;1487376;1723392;186786;186786;786432;1885228;1674162;2509824
728278,873;301056;91307;325632;1397386;1397386;1397760;1698442;1488693;1723392;186786;186786;786432;1885228;1675479;2509824
728493,522;301056;91497;325632;1397386;1397386;1397760;1698442;1488883;1723392;186786;186786;786432;1885228;1675669;2509824
728590,285;301056;93971;325632;1397386;1397386;1397760;1698442;1491357;1723392;186786;186783;786432;1885228;1678140;2509824
728637,613;301056;95637;325632;1397386;1397386;1397760;1698442;1493023;1723392;186951;186865;786432;1885393;1679888;2509824
728661,836;301056;95037;325632;1397386;1397386;1397760;1698442;1492423;1723392;186868;186752;786432;1885310;1679175;2509824
728674,792;301056;94509;325632;1397385;1397386;1397760;1698441;1491895;1723392;186752;186752;786432;1885193;1678647;2509824
728708,104;301056;95743;325632;1397385;1397385;1397760;1698441;1493128;1723392;186920;186868;786432;1885361;1679996;2509824
728719,502;301056;93076;325632;1397385;1397386;1397760;1698441;1490462;1723392;186868;186752;786432;1885309;1677214;2509824
728769,252;301056;96507;325632;1397385;1397386;1397760;1698441;1493893;1723392;186767;186767;786432;1885208;1680660;2509824
728801,791;301056;96706;325632;1397385;1397385;1397760;1698441;1494091;1723392;186767;186767;786432;1885208;1680858;2509824
728809,411;301056;93985;325632;1397385;1397386;1397760;1698441;1491371;1723392;186767;186767;786432;1885208;1678138;2509824
728967,296;301056;91963;325632;1397385;1397386;1397760;1698441;1489349;1723392;186767;186767;786432;1885208;1676116;2509824
729027,331;301056;95026;325632;1397385;1397386;1397760;1698441;1492412;1723392;186767;186767;786432;1885208;1679179;2509824
729055,125;301056;94279;325632;1397385;1397386;1397760;1698441;1491665;1723392;186767;186767;786432;1885208;1678432;2509824
729073,018;301056;94322;325632;1397385;1397386;1397760;1698441;1491708;1723392;186767;186767;786432;1885208;1678475;2509824
729114,058;301056;92758;325632;1397385;1397386;1397760;1698441;1490144;1723392;186767;186767;786432;1885208;1676911;2509824
729165,005;301056;94110;325632;1397385;1397386;1397760;1698441;1491496;1723392;186767;186767;786432;1885208;1678263;2509824
729195,887;301056;92382;325632;1397385;1397386;1397760;1698441;1489768;1723392;186767;186767;786432;1885208;1676535;2509824
729260,658;301056;94639;325632;1397385;1397386;1397760;1698441;1492025;1723392;186767;186767;786432;1885208;1678792;2509824
729292,972;301056;93493;325632;1397385;1397386;1397760;1698441;1490879;1723392;186767;186767;786432;1885208;1677646;2509824
729327,214;301056;96641;325632;1397385;1397386;1397760;1698441;1494027;1723392;186790;186790;786432;1885231;1680817;2509824
729339,568;301056;95667;325632;1397385;1397386;1397760;1698441;1493053;1723392;186790;186790;786432;1885231;1679843;2509824
729374,109;301056;96892;325632;1397385;1397386;1397760;1698441;1494278;1723392;186796;186796;786432;1885237;1681074;2509824
729401,210;301056;94595;325632;1397385;1397386;1397760;1698441;1491981;1723392;186796;186796;786432;1885237;1678777;2509824
729415,691;301056;93767;325632;1397385;1397386;1397760;1698441;1491153;1723392;186796;186796;786432;1885237;1677949;2509824
729424,207;300956;95314;325632;1397386;1397385;1397760;1698342;1492699;1723392;186796;186796;786432;1885138;1679495;2509824
729441,391;301056;96233;325632;1397385;1397386;1397760;1698441;1493619;1723392;186796;186796;786432;1885237;1680415;2509824
729465,128;301056;99131;325632;1397385;1397386;1397760;1698441;1496517;1723392;186964;186912;786432;1885405;1683429;2509824
729531,446;301056;94828;325632;1397385;1397386;1397760;1698441;1492214;1723392;186912;186796;786432;1885353;1679010;2509824
729546,774;301056;99155;325632;1397385;1397385;1397760;1698441;1496540;1723392;186964;186912;786432;1885405;1683452;2509824
729554,944;301056;97222;325632;1397385;1397385;1397760;1698441;1494607;1723392;186912;186796;786432;1885353;1681403;2509824
729564,057;301024;98253;325632;1397386;1397385;1397760;1698410;1495638;1723392;186796;186796;786432;1885206;1682434;2509824
729576,172;301056;97976;325632;1397385;1397385;1397760;1698441;1495361;1723392;186796;186796;786432;1885237;1682157;2509824
729599,778;301056;99096;325632;1397385;1397386;1397760;1698441;1496482;1723392;186964;186912;786432;1885405;1683394;2509824
729639,502;301056;97070;325632;1397385;1397386;1397760;1698441;1494456;1723392;186912;186796;786432;1885353;1681252;2509824
729699,310;301056;97076;325632;1397385;1397386;1397760;1698441;1494462;1723392;186796;186796;786432;1885237;1681258;2509824
729818,040;301056;99639;325632;1397385;1397386;1397760;1698441;1497025;1723392;186964;186912;786432;1885405;1683937;2509824
729830,473;301056;96177;325632;1397385;1397386;1397760;1698441;1493563;1723392;186912;186796;786432;1885353;1680359;2509824
729922,167;300954;98401;325632;1397385;1397386;1397760;1698339;1495787;1723392;186796;186796;786432;1885135;1682583;2509824
729953,451;301056;98086;325632;1397385;1397385;1397760;1698441;1495471;1723392;186796;186790;786432;1885237;1682261;2509824
729976,762;301056;96548;325632;1397385;1397385;1397760;1698441;1493933;1723392;186790;186790;786432;1885231;1680723;2509824
730120,855;301056;100134;325632;1397385;1397386;1397760;1698441;1497520;1723392;186958;186906;786432;1885399;1684426;2509824
730254,439;301056;98221;325632;1397385;1397386;1397760;1698441;1495607;1723392;186906;186749;786432;1885347;1682356;2509824
730307,965;301056;96133;325632;1397385;1397386;1397760;1698441;1493519;1723392;186749;186730;786432;1885190;1680249;2509824
730412,241;301056;101013;325632;1397385;1397385;1397760;1698441;1498398;1723392;186903;186852;786432;1885344;1685250;2509824
730451,490;301056;99035;325632;1397385;1397386;1397760;1698441;1496421;1723392;186852;186736;786432;1885293;1683157;2509824
730498,720;301056;96681;325632;1397385;1397386;1397760;1698441;1494067;1723392;186736;186736;786432;1885177;1680803;2509824
730590,148;301056;97045;325632;1397385;1397386;1397760;1698441;1494431;1723392;186736;186736;786432;1885177;1681167;2509824
730732,835;301056;98740;325632;1397385;1397386;1397760;1698441;1496126;1723392;186736;186686;786432;1885177;1682812;2509824
731139,035;301056;95832;325632;1397385;1397386;1397760;1698441;1493218;1723392;186686;186686;786432;1885127;1679904;2509824
731181,726;301056;95785;325632;1397385;1397386;1397760;1698441;1493171;1723392;186686;186633;786432;1885127;1679804;2509824
731463,139;300814;95402;325632;1397385;1397386;1397760;1698199;1492788;1723392;186636;186633;786432;1884835;1679421;2509824
731540,397;301056;94693;325632;1397385;1397386;1397760;1698441;1492079;1723392;186633;186633;786432;1885074;1678712;2509824
731563,233;301056;99974;325632;1397385;1397386;1397760;1698441;1497360;1723392;186653;186653;786432;1885094;1684013;2509824
731583,725;301056;95554;325632;1397385;1397385;1397760;1698441;1492939;1723392;186653;186653;786432;1885094;1679592;2509824
731924,153;301056;97480;325632;1397385;1397386;1397760;1698441;1494866;1723392;186821;186769;786432;1885262;1681635;2509824
731951,040;301056;97351;325632;1397385;1397385;1397760;1698441;1494736;1723392;186772;186656;786432;1885213;1681392;2509824
731982,851;301056;92799;325632;1397385;1397386;1397760;1698441;1490185;1723392;186671;186671;786432;1885112;1676856;2509824
732005,698;301056;92407;325632;1397385;1397386;1397760;1698441;1489793;1723392;186671;186671;786432;1885112;1676464;2509824
732161,454;301056;96201;325632;1397385;1397385;1397760;1698441;1493586;1723392;186838;186787;786432;1885279;1680373;2509824
732237,311;301056;92917;325632;1397385;1397386;1397760;1698441;1490303;1723392;186787;186671;786432;1885228;1676974;2509824
732259,070;301056;92941;325632;1397385;1397386;1397760;1698441;1490327;1723392;186671;186671;786432;1885112;1676998;2509824
732288,590;301056;96265;325632;1397385;1397386;1397760;1698441;1493651;1723392;186674;186674;786432;1885115;1680325;2509824
732326,121;300837;97757;325632;1397386;1397386;1397760;1698223;1495143;1723392;186674;186674;786432;1884897;1681817;2509824
732344,865;301056;95530;325632;1397385;1397386;1397760;1698441;1492916;1723392;186674;186674;786432;1885115;1679590;2509824
732380,404;301056;96237;325632;1397385;1397386;1397760;1698441;1493623;1723392;186841;186790;786432;1885282;1680413;2509824
732424,973;301056;97960;325632;1397385;1397386;1397760;1698441;1495346;1723392;186957;186790;786432;1885398;1682136;2509824
732499,082;301056;96780;325632;1397385;1397386;1397760;1698441;1494166;1723392;186968;186800;786432;1885409;1680966;2509824
732521,622;301056;97438;325632;1397385;1397385;1397760;1698441;1494823;1723392;186800;186684;786432;1885241;1681507;2509824
732537,100;301056;98982;325632;1397385;1397386;1397760;1698441;1496368;1723392;186753;186702;786432;1885194;1683070;2509824
732569,323;301056;97567;325632;1397385;1397386;1397760;1698441;1494953;1723392;186834;186820;786432;1885275;1681773;2509824
732677,586;301056;99335;325632;1397385;1397386;1397760;1698441;1496721;1723392;186820;186704;786432;1885261;1683425;2509824
732723,229;301056;99382;325632;1397385;1397386;1397760;1698441;1496768;1723392;186704;186704;786432;1885145;1683472;2509824
732816,922;301056;95101;325632;1397385;1397386;1397760;1698441;1492487;1723392;186871;186820;786432;1885312;1679307;2509824
732846,501;301056;94973;325632;1397385;1397386;1397760;1698441;1492359;1723392;186820;186704;786432;1885261;1679063;2509824
732866,029;301056;95688;325632;1397385;1397386;1397760;1698441;1493074;1723392;186872;186820;786432;1885313;1679894;2509824
732945,920;301056;96607;325632;1397385;1397386;1397760;1698441;1493993;1723392;186820;186701;786432;1885261;1680694;2509824
733005,861;301056;95578;325632;1397385;1397385;1397760;1698441;1492963;1723392;186701;186701;786432;1885142;1679664;2509824
733038,429;301056;95431;325632;1397385;1397386;1397760;1698441;1492817;1723392;186701;186701;786432;1885142;1679518;2509824
733051,999;301056;95677;325632;1397385;1397385;1397760;1698441;1493062;1723392;186701;186670;786432;1885142;1679732;2509824
733083,345;301056;99261;325632;1397385;1397386;1397760;1698441;1496647;1723392;186838;186786;786432;1885279;1683433;2509824
733138,094;301056;101013;325632;1397385;1397386;1397760;1698441;1498399;1723392;186786;186670;786432;1885227;1685069;2509824
733158,981;301056;100256;325632;1397385;1397386;1397760;1698441;1497642;1723392;186670;186667;786432;1885111;1684309;2509824
733180,543;301056;100090;325632;1397385;1397386;1397760;1698441;1497476;1723392;186667;186667;786432;1885108;1684143;2509824
733219,018;301056;100957;325632;1397385;1397386;1397760;1698441;1498343;1723392;186667;186667;786432;1885108;1685010;2509824
733283,575;301056;100377;325632;1397385;1397384;1397760;1698441;1497761;1723392;186667;186664;786432;1885108;1684425;2509824
733366,714;301056;101902;325632;1397384;1397385;1397760;1698440;1499287;1723392;186831;186780;786432;1885271;1686067;2509824
733453,253;301056;100343;325632;1397384;1397385;1397760;1698440;1497728;1723392;186780;186664;786432;1885220;1684392;2509824
733551,329;301056;101290;325632;1397384;1397385;1397760;1698440;1498675;1723392;186831;186780;786432;1885271;1685455;2509824
733901,254;301056;101048;325632;1397384;1397376;1397760;1698440;1498424;1723392;186780;186664;786432;1885220;1685088;2509824
734105,354;301056;99523;325632;1397376;1397376;1397760;1698432;1496899;1723392;186682;186651;786432;1885114;1683550;2509824
734252,079;301056;104146;325632;1397376;1397377;1397760;1698432;1501523;1723392;186651;186651;786432;1885083;1688174;2509824
734273,463;301056;102773;325632;1397376;1397376;1397760;1698432;1500149;1723392;186666;186666;786432;1885098;1686815;2509824
734310,946;301056;100579;325632;1397376;1397376;1397760;1698432;1497955;1723392;186666;186666;786432;1885098;1684621;2509824
734544,805;301056;97806;325632;1397376;1397377;1397760;1698432;1495183;1723392;186666;186666;786432;1885098;1681849;2509824
734731,112;301056;99420;325632;1397376;1397376;1397760;1698432;1496796;1723392;186666;186660;786432;1885098;1683456;2509824
734944,889;301056;98154;325632;1397376;1397376;1397760;1698432;1495530;1723392;186663;186650;786432;1885095;1682180;2509824
735005,142;301056;101754;325632;1397376;1397377;1397760;1698432;1499131;1723392;186650;186650;786432;1885082;1685781;2509824
735074,886;301056;97497;325632;1397376;1397376;1397760;1698432;1494873;1723392;186650;186650;786432;1885082;1681523;2509824
735148,167;301056;100976;325632;1397376;1397376;1397760;1698432;1498352;1723392;186818;186766;786432;1885250;1685118;2509824
735190,603;301056;97910;325632;1397376;1397376;1397760;1698432;1495286;1723392;186766;186650;786432;1885198;1681936;2509824
735423,183;301056;101118;325632;1397376;1397376;1397760;1698432;1498494;1723392;186818;186766;786432;1885250;1685260;2509824
735662,524;301056;99637;325632;1397376;1397376;1397760;1698432;1497013;1723392;186766;186630;786432;1885198;1683643;2509824
735839,887;301056;98543;325632;1397376;1397376;1397760;1698432;1495919;1723392;186630;186630;786432;1885062;1682549;2509824
735974,328;301056;99712;325632;1397376;1397376;1397760;1698432;1497088;1723392;186630;186627;786432;1885062;1683715;2509824
736008,569;301056;98438;325632;1397376;1397377;1397760;1698432;1495815;1723392;186627;186627;786432;1885059;1682442;2509824
736046,067;301056;101119;325632;1397376;1397376;1397760;1698432;1498495;1723392;186627;186627;786432;1885059;1685122;2509824
736069,527;301056;100524;325632;1397376;1397376;1397760;1698432;1497900;1723392;186627;186624;786432;1885059;1684524;2509824
736161,709;301056;100736;325632;1397376;1397377;1397760;1698432;1498113;1723392;186624;186624;786432;1885056;1684737;2509824
736185,756;301056;99983;325632;1397376;1397376;1397760;1698432;1497359;1723392;186624;186624;786432;1885056;1683983;2509824
736328,891;301056;98839;325632;1397376;1397377;1397760;1698432;1496216;1723392;186624;186624;786432;1885056;1682840;2509824
736354,889;301056;100215;325632;1397376;1397370;1397760;1698432;1497585;1723392;186656;186648;786432;1885088;1684233;2509824
736421,937;301056;98456;325632;1397370;1397370;1397760;1698426;1495826;1723392;186648;186648;786432;1885074;1682474;2509824
736553,848;301056;98712;325632;1397370;1397370;1397760;1698426;1496082;1723392;186654;186654;786432;1885080;1682736;2509824
736893,534;301056;99941;325632;1397370;1397370;1397760;1698426;1497311;1723392;186654;186654;786432;1885080;1683965;2509824
737016,751;301056;99379;325632;1397370;1397370;1397760;1698426;1496749;1723392;186654;186654;786432;1885080;1683403;2509824
737080,903;301056;101450;325632;1397370;1397370;1397760;1698426;1498820;1723392;186657;186646;786432;1885083;1685466;2509824
737118,114;301056;105465;325632;1397370;1397370;1397760;1698426;1502835;1723392;186672;186672;786432;1885098;1689507;2509824
737144,154;301056;101483;325632;1397370;1397370;1397760;1698426;1498853;1723392;186672;186672;786432;1885098;1685525;2509824
737156,984;301056;103524;325632;1397370;1397370;1397760;1698426;1500894;1723392;186672;186669;786432;1885098;1687563;2509824
737181,386;301056;102547;325632;1397370;1397370;1397760;1698426;1499917;1723392;186699;186699;786432;1885125;1686616;2509824
737199,322;301056;104880;325632;1397370;1397370;1397760;1698426;1502250;1723392;186699;186699;786432;1885125;1688949;2509824
737211,740;301056;104418;325632;1397370;1397370;1397760;1698426;1501788;1723392;186699;186699;786432;1885125;1688487;2509824
737226,203;301056;102928;325632;1397370;1397370;1397760;1698426;1500298;1723392;186699;186699;786432;1885125;1686997;2509824
737259,745;301056;104658;325632;1397370;1397370;1397760;1698426;1502028;1723392;186699;186699;786432;1885125;1688727;2509824
737274,691;301056;106181;325632;1397370;1397370;1397760;1698426;1503551;1723392;186846;186794;786432;1885272;1690345;2509824
737401,902;301056;104378;325632;1397370;1397370;1397760;1698426;1501748;1723392;186818;186818;786432;1885244;1688566;2509824
737507,356;301056;102007;325632;1397370;1397370;1397760;1698426;1499377;1723392;186985;186818;786432;1885411;1686195;2509824
737524,482;301056;100751;325632;1397370;1397370;1397760;1698426;1498121;1723392;186818;186702;786432;1885244;1684823;2509824
737543,389;301056;100948;325632;1397370;1397370;1397760;1698426;1498318;1723392;186702;186702;786432;1885128;1685020;2509824
737560,069;301056;101131;325632;1397370;1397370;1397760;1698426;1498501;1723392;186702;186702;786432;1885128;1685203;2509824
737631,550;301056;101983;325632;1397370;1397370;1397760;1698426;1499353;1723392;186702;186702;786432;1885128;1686055;2509824
737644,419;301056;101497;325632;1397370;1397370;1397760;1698426;1498867;1723392;186702;186702;786432;1885128;1685569;2509824
737699,291;301056;101413;325632;1397370;1397370;1397760;1698426;1498783;1723392;186702;186702;786432;1885128;1685485;2509824
737728,696;301056;100880;325632;1397370;1397370;1397760;1698426;1498250;1723392;186702;186702;786432;1885128;1684952;2509824
737762,744;301056;100911;325632;1397370;1397370;1397760;1698426;1498281;1723392;186702;186696;786432;1885128;1684977;2509824
737803,513;301056;103463;325632;1397370;1397370;1397760;1698426;1500833;1723392;186705;186677;786432;1885131;1687510;2509824
737821,216;301056;101148;325632;1397370;1397370;1397760;1698426;1498518;1723392;186679;186679;786432;1885105;1685197;2509824
737834,786;301056;101961;325632;1397370;1397370;1397760;1698426;1499331;1723392;186680;186680;786432;1885106;1686011;2509824
737851,334;301056;102643;325632;1397370;1397370;1397760;1698426;1500013;1723392;186680;186680;786432;1885106;1686693;2509824
737884,641;300999;104748;325632;1397370;1397370;1397760;1698369;1502118;1723392;186680;186680;786432;1885049;1688798;2509824
737912,095;301056;101717;325632;1397370;1397370;1397760;1698426;1499087;1723392;186680;186677;786432;1885106;1685764;2509824
737946,395;301056;104478;325632;1397370;1397370;1397760;1698426;1501848;1723392;186677;186677;786432;1885103;1688525;2509824
738002,545;301056;102528;325632;1397370;1397370;1397760;1698426;1499898;1723392;186677;186677;786432;1885103;1686575;2509824
738077,598;301056;103401;325632;1397370;1397370;1397760;1698426;1500771;1723392;186677;186677;786432;1885103;1687448;2509824
738107,389;301056;103896;325632;1397370;1397370;1397760;1698426;1501266;1723392;186690;186690;786432;1885116;1687956;2509824
738184,315;301056;105298;325632;1397370;1397370;1397760;1698426;1502668;1723392;186690;186690;786432;1885116;1689358;2509824
738218,362;300999;105302;325632;1397719;1397434;1397760;1698718;1502736;1723392;186693;186693;786432;1885411;1689429;2509824
738229,967;301056;105242;325632;1397433;1397370;1397760;1698489;1502612;1723392;186693;186693;786432;1885182;1689305;2509824
738257,677;301056;104716;325632;1397370;1397370;1397760;1698426;1502086;1723392;186693;186693;786432;1885119;1688779;2509824
738266,321;301056;106353;325632;1397370;1397370;1397760;1698426;1503723;1723392;186693;186693;786432;1885119;1690416;2509824
738314,527;301056;105939;325632;1397370;1397370;1397760;1698426;1503309;1723392;186693;186693;786432;1885119;1690002;2509824
738338,002;301056;110250;325632;1397370;1397370;1397760;1698426;1507620;1723392;186729;186729;786432;1885155;1694349;2509824
738348,282;301056;108461;325632;1397370;1397370;1397760;1698426;1505831;1723392;186729;186729;786432;1885155;1692560;2509824
738361,219;301056;107674;325632;1397370;1397370;1397760;1698426;1505044;1723392;186729;186729;786432;1885155;1691773;2509824
738372,451;301056;107159;325632;1397370;1397370;1397760;1698426;1504529;1723392;186729;186729;786432;1885155;1691258;2509824
738418,041;301056;108378;325632;1397370;1397370;1397760;1698426;1505748;1723392;186729;186729;786432;1885155;1692477;2509824
738471,070;301056;107985;325632;1397370;1397370;1397760;1698426;1505355;1723392;186729;186729;786432;1885155;1692084;2509824
738514,549;301056;109360;325632;1397370;1397370;1397760;1698426;1506730;1723392;186729;186729;786432;1885155;1693459;2509824
738528,526;301056;109778;325632;1397370;1397370;1397760;1698426;1507148;1723392;186729;186729;786432;1885155;1693877;2509824
738554,110;301056;108380;325632;1397370;1397370;1397760;1698426;1505750;1723392;186729;186729;786432;1885155;1692479;2509824
738597,397;301056;108475;325632;1397370;1397370;1397760;1698426;1505845;1723392;186729;186729;786432;1885155;1692574;2509824
738664,870;301038;107930;325632;1397370;1397370;1397760;1698408;1505300;1723392;186729;186729;786432;1885137;1692029;2509824
738680,705;301056;107803;325632;1397370;1397370;1397760;1698426;1505173;1723392;186729;186729;786432;1885155;1691902;2509824
738705,313;301056;110424;325632;1397370;1397370;1397760;1698426;1507794;1723392;186729;186729;786432;1885155;1694523;2509824
738739,067;301056;112152;325632;1397370;1397370;1397760;1698426;1509522;1723392;186729;186729;786432;1885155;1696251;2509824
738763,032;301056;109279;325632;1397370;1397370;1397760;1698426;1506649;1723392;186729;186729;786432;1885155;1693378;2509824
738787,828;301056;108678;325632;1397370;1397370;1397760;1698426;1506048;1723392;186729;186729;786432;1885155;1692777;2509824
738862,063;301056;109573;325632;1397370;1397370;1397760;1698426;1506943;1723392;186729;186729;786432;1885155;1693672;2509824
738891,590;301056;108830;325632;1397370;1397370;1397760;1698426;1506200;1723392;186729;186729;786432;1885155;1692929;2509824
738919,683;301056;109015;325632;1397370;1397370;1397760;1698426;1506385;1723392;186729;186716;786432;1885155;1693101;2509824
738989,253;301056;109836;325632;1397370;1397370;1397760;1698426;1507206;1723392;186716;186716;786432;1885142;1693922;2509824
739005,850;301056;109201;325632;1397370;1397370;1397760;1698426;1506571;1723392;186716;186716;786432;1885142;1693287;2509824
739032,117;301056;109124;325632;1397370;1397370;1397760;1698426;1506494;1723392;186716;186716;786432;1885142;1693210;2509824
739077,156;301056;109223;325632;1397370;1397370;1397760;1698426;1506593;1723392;186716;186716;786432;1885142;1693309;2509824
739146,163;301056;111425;325632;1397370;1397370;1397760;1698426;1508795;1723392;186716;186716;786432;1885142;1695511;2509824
739155,890;301056;109610;325632;1397370;1397370;1397760;1698426;1506980;1723392;186716;186685;786432;1885142;1693665;2509824
739179,899;301056;109826;325632;1397370;1397370;1397760;1698426;1507196;1723392;186685;186685;786432;1885111;1693881;2509824
739202,901;301056;110087;325632;1397370;1397370;1397760;1698426;1507457;1723392;186685;186685;786432;1885111;1694142;2509824
739219,554;301056;112053;325632;1397370;1397370;1397760;1698426;1509423;1723392;186685;186685;786432;1885111;1696108;2509824
739255,312;301056;112123;325632;1397370;1397370;1397760;1698426;1509493;1723392;186685;186685;786432;1885111;1696178;2509824
739276,840;301056;110808;325632;1397370;1397370;1397760;1698426;1508178;1723392;186685;186685;786432;1885111;1694863;2509824
739293,545;301056;109941;325632;1397370;1397370;1397760;1698426;1507311;1723392;186685;186685;786432;1885111;1693996;2509824
739344,243;301056;110982;325632;1397370;1397370;1397760;1698426;1508352;1723392;186685;186685;786432;1885111;1695037;2509824
739377,629;301056;111506;325632;1397370;1397370;1397760;1698426;1508876;1723392;186685;186685;786432;1885111;1695561;2509824
739398,751;301056;110642;325632;1397370;1397370;1397760;1698426;1508012;1723392;186685;186685;786432;1885111;1694697;2509824
739405,724;301056;110757;325632;1397370;1397370;1397760;1698426;1508127;1723392;186685;186685;786432;1885111;1694812;2509824
739428,533;301056;112670;325632;1397370;1397370;1397760;1698426;1510040;1723392;186685;186685;786432;1885111;1696725;2509824
739464,320;301056;112931;325632;1397370;1397370;1397760;1698426;1510301;1723392;186685;186685;786432;1885111;1696986;2509824
739492,975;301056;111351;325632;1397370;1397370;1397760;1698426;1508721;1723392;186685;186685;786432;1885111;1695406;2509824
739514,666;301056;111656;325632;1397370;1397370;1397760;1698426;1509026;1723392;186685;186685;786432;1885111;1695711;2509824
739762,727;301056;111373;325632;1397370;1397370;1397760;1698426;1508743;1723392;186688;186688;786432;1885114;1695431;2509824
740072,327;301056;112173;325632;1397370;1397370;1397760;1698426;1509543;1723392;186688;186688;786432;1885114;1696231;2509824
740167,929;301056;111288;325632;1397370;1397722;1397760;1698426;1509010;1723392;186688;186444;786432;1885114;1695454;2509824
740226,864;301056;111339;325632;1397722;1397721;1397760;1698778;1509060;1723392;186444;186441;786432;1885222;1695501;2509824
740301,558;301056;111172;325632;1397721;1397722;1397760;1698777;1508894;1723392;186447;186447;786432;1885224;1695341;2509824
740319,836;301056;113251;325632;1397721;1397722;1397760;1698777;1510973;1723392;186488;186488;786432;1885265;1697461;2509824
740330,341;301056;113228;325632;1397721;1397721;1397760;1698777;1510949;1723392;186560;186560;786432;1885337;1697509;2509824
740350,140;300904;112692;325632;1397722;1397722;1397760;1698626;1510414;1723392;186560;186560;786432;1885186;1696974;2509824
740357,689;301056;112047;325632;1397721;1397722;1397760;1698777;1509769;1723392;186560;186560;786432;1885337;1696329;2509824
740407,125;301056;111671;325632;1397721;1397721;1397760;1698777;1509392;1723392;186560;186560;786432;1885337;1695952;2509824
740465,544;301056;111984;325632;1397721;1397722;1397760;1698777;1509706;1723392;186560;186560;786432;1885337;1696266;2509824
740510,488;301056;108161;325632;1397721;1397721;1397760;1698777;1505882;1723392;186668;186668;786432;1885445;1692550;2509824
740535,588;301056;108049;325632;1397721;1397721;1397760;1698777;1505770;1723392;186668;186668;786432;1885445;1692438;2509824
740548,937;301056;106870;325632;1397721;1397721;1397760;1698777;1504591;1723392;186668;186668;786432;1885445;1691259;2509824
740559,539;301056;106823;325632;1397721;1397722;1397760;1698777;1504545;1723392;186668;186668;786432;1885445;1691213;2509824
740647,170;301056;106942;325632;1397721;1397722;1397760;1698777;1504664;1723392;186668;186668;786432;1885445;1691332;2509824
740666,898;301056;107087;325632;1397721;1397721;1397760;1698777;1504808;1723392;186668;186668;786432;1885445;1691476;2509824
740688,319;301056;106514;325632;1397721;1397722;1397760;1698777;1504236;1723392;186668;186668;786432;1885445;1690904;2509824
740725,857;301056;107225;325632;1397721;1397721;1397760;1698777;1504946;1723392;186668;186668;786432;1885445;1691614;2509824
740776,808;301056;105894;325632;1397721;1397722;1397760;1698777;1503616;1723392;186668;186668;786432;1885445;1690284;2509824
741018,946;301056;105414;325632;1397721;1397721;1397760;1698777;1503135;1723392;186668;186668;786432;1885445;1689803;2509824
741188,129;301056;106278;325632;1397721;1397722;1397760;1698777;1504000;1723392;186668;186668;786432;1885445;1690668;2509824
741249,977;301056;105171;325632;1397721;1397716;1397760;1698777;1502887;1723392;186668;186483;786432;1885445;1689370;2509824
741392,694;301056;110275;325632;1397715;1397716;1397760;1698771;1507991;1723392;186660;186608;786432;1885431;1694599;2509824
741434,100;301056;106792;325632;1397715;1397715;1397760;1698771;1504507;1723392;186944;186720;786432;1885715;1691227;2509824
741511,812;301056;108611;325632;1397715;1397715;1397760;1698771;1506326;1723392;186720;186720;786432;1885491;1693046;2509824
741784,480;301056;106470;325632;1397715;1397715;1397760;1698771;1504185;1723392;186723;186607;786432;1885494;1690792;2509824
741819,113;301056;106669;325632;1397715;1397716;1397760;1698771;1504385;1723392;186607;186607;786432;1885378;1690992;2509824
742130,413;301056;108570;325632;1397715;1397716;1397760;1698771;1506286;1723392;186624;186624;786432;1885395;1692910;2509824
742189,036;301056;108085;325632;1397715;1397716;1397760;1698771;1505801;1723392;186624;186621;786432;1885395;1692422;2509824
742239,217;301056;109357;325632;1397715;1397716;1397760;1698771;1507073;1723392;186624;186624;786432;1885395;1693697;2509824
742243,702;301056;111651;325632;1397715;1397716;1397760;1698771;1509367;1723392;186627;186627;786432;1885398;1695994;2509824
742265,618;301056;113481;325632;1397715;1397715;1397760;1698771;1511196;1723392;186631;186631;786432;1885402;1697827;2509824
742289,706;301056;110914;325632;1397715;1397715;1397760;1698771;1508629;1723392;186637;186637;786432;1885408;1695266;2509824
742299,831;301056;112967;325632;1397715;1397715;1397760;1698771;1510682;1723392;186663;186663;786432;1885434;1697345;2509824
742342,766;301056;112928;325632;1397715;1397716;1397760;1698771;1510644;1723392;186706;186706;786432;1885477;1697350;2509824
742370,807;301056;110534;325632;1397715;1397716;1397760;1698771;1508250;1723392;186706;186706;786432;1885477;1694956;2509824
742399,527;301056;110073;325632;1397715;1397716;1397760;1698771;1507789;1723392;186706;186706;786432;1885477;1694495;2509824
742492,489;301056;110385;325632;1397715;1397715;1397760;1698771;1508100;1723392;186723;186671;786432;1885494;1694771;2509824
742531,517;301053;115430;325632;1397715;1397715;1397760;1698768;1513145;1723392;186822;186822;786432;1885590;1699967;2509824
742615,203;301056;112046;325632;1397715;1397716;1397760;1698771;1509762;1723392;186822;186706;786432;1885593;1696468;2509824
742689,208;301056;113958;325632;1397715;1397716;1397760;1698771;1511674;1723392;186709;186709;786432;1885480;1698383;2509824
742806,122;301056;111880;325632;1397715;1397716;1397760;1698771;1509596;1723392;186726;186723;786432;1885497;1696319;2509824
742871,004;301056;115478;325632;1397715;1397715;1397760;1698771;1513193;1723392;186890;186839;786432;1885661;1700032;2509824
742901,242;301056;113641;325632;1397715;1397716;1397760;1698771;1511357;1723392;186839;186651;786432;1885610;1698008;2509824
742953,812;301056;112601;325632;1397715;1397715;1397760;1698771;1510316;1723392;186651;186651;786432;1885422;1696967;2509824
742976,921;301056;116750;325632;1397715;1397716;1397760;1698771;1514466;1723392;186651;186651;786432;1885422;1701117;2509824
742991,361;301056;116225;325632;1397715;1397715;1397760;1698771;1513940;1723392;186651;186651;786432;1885422;1700591;2509824
743005,734;301056;115264;325632;1397715;1397715;1397760;1698771;1512979;1723392;186708;186708;786432;1885479;1699687;2509824
743037,647;301056;117003;325632;1397715;1397715;1397760;1698771;1514718;1723392;186708;186708;786432;1885479;1701426;2509824
743079,761;301056;115093;325632;1397715;1397715;1397760;1698771;1512808;1723392;186708;186708;786432;1885479;1699516;2509824
743116,927;300980;115770;325632;1397715;1397715;1397760;1698695;1513485;1723392;186708;186708;786432;1885403;1700193;2509824
743193,570;301055;115569;325632;1397715;1397716;1397760;1698770;1513285;1723392;186708;186708;786432;1885478;1699993;2509824
743440,022;301056;115808;325632;1397715;1397715;1397760;1698771;1513523;1723392;186708;186708;786432;1885479;1700231;2509824
743701,236;301056;115710;325632;1397715;1397715;1397760;1698771;1513425;1723392;186708;186708;786432;1885479;1700133;2509824
743758,541;301056;118600;325632;1397715;1397715;1397760;1698771;1516315;1723392;186708;186642;786432;1885479;1702957;2509824
744118,246;301056;111318;325632;1397715;1397715;1397760;1698771;1509033;1723392;186642;186642;786432;1885413;1695675;2509824
744138,245;301056;110602;325632;1397715;1397715;1397760;1698771;1508317;1723392;186642;186451;786432;1885413;1694768;2509824
744153,690;301056;110620;325632;1397715;1397715;1397760;1698771;1508335;1723392;186451;186451;786432;1885222;1694786;2509824
744296,692;301056;109629;325632;1397715;1397715;1397760;1698771;1507344;1723392;186463;186463;786432;1885234;1693807;2509824
744393,541;301056;111319;325632;1397714;1397714;1397760;1698770;1509033;1723392;186526;186526;786432;1885296;1695559;2509824
744557,780;301056;110244;325632;1397714;1397715;1397760;1698770;1507959;1723392;186634;186634;786432;1885404;1694593;2509824
744943,972;301056;110707;325632;1397714;1397715;1397760;1698770;1508422;1723392;186634;186631;786432;1885404;1695053;2509824
745019,849;301010;114506;325632;1397715;1397715;1397760;1698725;1512221;1723392;186646;186646;786432;1885371;1698867;2509824
745058,052;301056;111055;325632;1397714;1397714;1397760;1698770;1508769;1723392;186646;186646;786432;1885416;1695415;2509824
745073,128;301056;110929;325632;1397714;1397715;1397760;1698770;1508644;1723392;186646;186646;786432;1885416;1695290;2509824
745115,101;301056;115207;325632;1397714;1397714;1397760;1698770;1512921;1723392;186649;186649;786432;1885419;1699570;2509824
745189,762;301056;114499;325632;1397714;1397715;1397760;1698770;1512214;1723392;186684;186684;786432;1885454;1698898;2509824
745248,422;301056;113950;325632;1397714;1397715;1397760;1698770;1511665;1723392;186685;186685;786432;1885455;1698350;2509824
745274,743;301056;113750;325632;1397714;1397714;1397760;1698770;1511464;1723392;186685;186685;786432;1885455;1698149;2509824
745293,551;301056;112996;325632;1397714;1397714;1397760;1698770;1510710;1723392;186685;186685;786432;1885455;1697395;2509824
745356,749;301056;115158;325632;1397714;1397714;1397760;1698770;1512872;1723392;186685;186685;786432;1885455;1699557;2509824
745546,953;301056;114595;325632;1397714;1397714;1397760;1698770;1512309;1723392;186691;186691;786432;1885461;1699000;2509824
745587,519;301056;114467;325632;1397714;1397715;1397760;1698770;1512182;1723392;186691;186691;786432;1885461;1698873;2509824
745788,642;301056;115141;325632;1397714;1397714;1397760;1698770;1512855;1723392;186705;186705;786432;1885475;1699560;2509824
745845,390;301056;112176;325632;1397714;1397715;1397760;1698770;1509891;1723392;186705;186702;786432;1885475;1696593;2509824
745893,900;301056;111081;325632;1397714;1397715;1397760;1698770;1508796;1723392;186702;186702;786432;1885472;1695498;2509824
745952,499;301056;111813;325632;1397714;1397714;1397760;1698770;1509527;1723392;186702;186702;786432;1885472;1696229;2509824
746689,384;301056;110323;325632;1397714;1397714;1397760;1698770;1508037;1723392;186702;186694;786432;1885472;1694731;2509824
746736,498;301056;112240;325632;1397714;1397685;1397760;1698770;1509925;1723392;186696;186586;786432;1885466;1696511;2509824
746770,570;301056;112812;325632;1397685;1397685;1397760;1698741;1510497;1723392;186588;186588;786432;1885329;1697085;2509824
746848,530;301056;116296;325632;1397685;1397685;1397760;1698741;1513981;1723392;186658;186658;786432;1885399;1700639;2509824
746883,913;301056;113035;325632;1397685;1397685;1397760;1698741;1510720;1723392;186658;186658;786432;1885399;1697378;2509824
747006,953;300829;115343;325632;1397685;1397685;1397760;1698514;1513028;1723392;186825;186774;786432;1885339;1699802;2509824
747070,938;301056;114330;325632;1397684;1397685;1397760;1698740;1512015;1723392;186774;186658;786432;1885514;1698673;2509824
747153,585;301056;113631;325632;1397684;1397685;1397760;1698740;1511316;1723392;186676;186676;786432;1885416;1697992;2509824
747427,521;301056;114451;325632;1397684;1397685;1397760;1698740;1512136;1723392;186676;186673;786432;1885416;1698809;2509824
747480,833;301056;113494;325632;1397684;1397685;1397760;1698740;1511179;1723392;186673;186636;786432;1885413;1697815;2509824
747546,009;301056;114152;325632;1397684;1397685;1397760;1698740;1511837;1723392;186636;186633;786432;1885376;1698470;2509824
747751,761;301056;112490;325632;1397684;1397684;1397760;1698740;1510174;1723392;186639;186636;786432;1885379;1696810;2509824
747806,900;301056;113764;325632;1397684;1397685;1397760;1698740;1511449;1723392;186636;186624;786432;1885376;1698073;2509824
748058,392;301056;114308;325632;1397684;1397685;1397760;1698740;1511993;1723392;186627;186627;786432;1885367;1698620;2509824
748088,811;301056;115878;325632;1397684;1397685;1397760;1698740;1513563;1723392;186633;186633;786432;1885373;1700196;2509824
748102,128;301056;116644;325632;1397684;1397685;1397760;1698740;1514329;1723392;186633;186633;786432;1885373;1700962;2509824
748118,462;300975;114503;325632;1397685;1397685;1397760;1698660;1512188;1723392;186636;186636;786432;1885296;1698824;2509824
748437,041;301056;116358;325632;1397684;1397685;1397760;1698740;1514043;1723392;186639;186639;786432;1885379;1700682;2509824
748813,129;301056;113277;325632;1397684;1397685;1397760;1698740;1510962;1723392;186641;186638;786432;1885381;1697600;2509824
748857,368;301056;110836;325632;1397684;1397685;1397760;1698740;1508521;1723392;186638;186635;786432;1885378;1695156;2509824
749322,743;301056;112886;325632;1397684;1397685;1397760;1698740;1510571;1723392;186641;186641;786432;1885381;1697212;2509824
749341,434;301056;112342;325632;1397684;1397685;1397760;1698740;1510027;1723392;186641;186641;786432;1885381;1696668;2509824
749796,273;301056;114478;325632;1397684;1397685;1397760;1698740;1512163;1723392;186644;186644;786432;1885384;1698807;2509824
749814,295;301056;111684;325632;1397684;1397685;1397760;1698740;1509369;1723392;186644;186644;786432;1885384;1696013;2509824
749854,915;301056;114671;325632;1397684;1397685;1397760;1698740;1512356;1723392;186644;186644;786432;1885384;1699000;2509824
749878,830;301056;114241;325632;1397684;1397685;1397760;1698740;1511926;1723392;186644;186644;786432;1885384;1698570;2509824
749888,681;301056;115128;325632;1397684;1397685;1397760;1698740;1512813;1723392;186644;186644;786432;1885384;1699457;2509824
749996,483;301056;116184;325632;1397684;1397685;1397760;1698740;1513869;1723392;186644;186644;786432;1885384;1700513;2509824
750035,263;301056;114539;325632;1397684;1397685;1397760;1698740;1512224;1723392;186644;186597;786432;1885384;1698821;2509824
750241,535;301056;116326;325632;1397684;1397685;1397760;1698740;1514011;1723392;186632;186632;786432;1885372;1700643;2509824
750429,822;301056;116247;325632;1397684;1397685;1397760;1698740;1513932;1723392;186638;186638;786432;1885378;1700570;2509824
750816,361;301056;115649;325632;1397684;1397685;1397760;1698740;1513334;1723392;186638;186638;786432;1885378;1699972;2509824
751044,043;301056;120110;325632;1397684;1397685;1397760;1698740;1517795;1723392;186644;186644;786432;1885384;1704439;2509824
751062,156;301056;117975;325632;1397684;1397685;1397760;1698740;1515660;1723392;186644;186644;786432;1885384;1702304;2509824
751069,017;301053;119366;325632;1397685;1397685;1397760;1698738;1517051;1723392;186644;186644;786432;1885382;1703695;2509824
751092,126;301056;118975;325632;1397684;1397684;1397760;1698740;1516659;1723392;186644;186644;786432;1885384;1703303;2509824
751130,776;301056;116092;325632;1397684;1397685;1397760;1698740;1513777;1723392;186644;186644;786432;1885384;1700421;2509824
751163,958;301056;118451;325632;1397684;1397684;1397760;1698740;1516135;1723392;186644;186644;786432;1885384;1702779;2509824
751269,847;300934;120447;325632;1397685;1397685;1397760;1698619;1518132;1723392;186644;186644;786432;1885263;1704776;2509824
751657,789;301056;116986;325632;1397684;1397685;1397760;1698740;1514671;1723392;186670;186664;786432;1885410;1701335;2509824
751770,194;301056;118566;325632;1397684;1397685;1397760;1698740;1516251;1723392;186664;186664;786432;1885404;1702915;2509824
751838,397;301056;115758;325632;1397684;1397685;1397760;1698740;1513443;1723392;186692;186692;786432;1885432;1700135;2509824
751868,370;301056;116092;325632;1397684;1397684;1397760;1698740;1513776;1723392;186692;186692;786432;1885432;1700468;2509824
751895,782;301056;116393;325632;1397684;1397685;1397760;1698740;1514078;1723392;186692;186666;786432;1885432;1700744;2509824
751996,337;301056;118006;325632;1397684;1397685;1397760;1698740;1515691;1723392;186666;186666;786432;1885406;1702357;2509824
752040,858;301056;118794;325632;1397688;1397685;1397760;1698744;1516479;1723392;186666;186666;786432;1885410;1703145;2509824
752282,274;301056;118972;325632;1397685;1397685;1397760;1698741;1516657;1723392;186686;186686;786432;1885427;1703343;2509824
752337,133;301019;115703;325632;1397685;1397685;1397760;1698704;1513388;1723392;186686;186683;786432;1885390;1700071;2509824
752376,513;301056;116055;325632;1397689;1397686;1397760;1698745;1513741;1723392;186683;186683;786432;1885428;1700424;2509824
752517,392;301056;118641;325632;1397685;1397684;1397760;1698741;1516325;1723392;186683;186683;786432;1885424;1703008;2509824
752536,323;301056;116374;325632;1397684;1397685;1397760;1698740;1514059;1723392;186683;186652;786432;1885423;1700711;2509824
752543,826;301056;116214;325632;1397684;1397685;1397760;1698740;1513899;1723392;186652;186652;786432;1885392;1700551;2509824
752587,954;301056;115473;325632;1397684;1397685;1397760;1698740;1513158;1723392;186658;186658;786432;1885398;1699816;2509824
752644,029;301056;117093;325632;1397684;1397685;1397760;1698740;1514778;1723392;186661;186661;786432;1885401;1701439;2509824
752659,340;301056;115717;325632;1397684;1397684;1397760;1698740;1513401;1723392;186661;186661;786432;1885401;1700062;2509824
752686,285;301056;118407;325632;1397684;1397684;1397760;1698740;1516091;1723392;186678;186678;786432;1885418;1702769;2509824
752731,931;301056;116932;325632;1397684;1397685;1397760;1698740;1514617;1723392;186696;186696;786432;1885436;1701313;2509824
752762,667;301056;122808;325632;1397684;1397685;1397760;1698740;1520493;1723392;186696;186696;786432;1885436;1707189;2509824
752785,240;301056;121894;325632;1397684;1397685;1397760;1698740;1519579;1723392;186699;186699;786432;1885439;1706278;2509824
752806,384;301056;118900;325632;1397684;1397685;1397760;1698740;1516585;1723392;186699;186699;786432;1885439;1703284;2509824
752813,948;301056;120872;325632;1397684;1397685;1397760;1698740;1518557;1723392;186699;186699;786432;1885439;1705256;2509824
752970,748;301056;120909;325632;1397684;1397684;1397760;1698740;1518593;1723392;186699;186699;786432;1885439;1705292;2509824
753006,674;301056;120213;325632;1397684;1397685;1397760;1698740;1517898;1723392;186699;186699;786432;1885439;1704597;2509824
753093,583;301056;119665;325632;1397684;1397685;1397760;1698740;1517350;1723392;186699;186699;786432;1885439;1704049;2509824
753135,147;301056;119150;325632;1397684;1397685;1397760;1698740;1516835;1723392;186699;186699;786432;1885439;1703534;2509824
753172,473;301056;119224;325632;1397684;1397684;1397760;1698740;1516908;1723392;186699;186699;786432;1885439;1703607;2509824
753187,240;301056;122458;325632;1397684;1397685;1397760;1698740;1520143;1723392;186703;186701;786432;1885443;1706844;2509824
753201,814;301056;119488;325632;1397684;1397685;1397760;1698740;1517173;1723392;186701;186701;786432;1885441;1703874;2509824
753221,038;301056;120133;325632;1397684;1397685;1397760;1698740;1517818;1723392;186729;186729;786432;1885469;1704547;2509824
753247,933;300966;121230;325632;1397685;1397685;1397760;1698651;1518915;1723392;186732;186732;786432;1885383;1705647;2509824
753273,882;301056;119495;325632;1397684;1397685;1397760;1698740;1517180;1723392;186735;186735;786432;1885475;1703915;2509824
753280,189;301056;120802;325632;1397684;1397684;1397760;1698740;1518486;1723392;186735;186735;786432;1885475;1705221;2509824
753302,461;301056;124322;325632;1397684;1397685;1397760;1698740;1522007;1723392;186735;186735;786432;1885475;1708742;2509824
753315,105;301056;121151;325632;1397684;1397685;1397760;1698740;1518836;1723392;186735;186735;786432;1885475;1705571;2509824
753323,433;301056;121593;325632;1397684;1397684;1397760;1698740;1519277;1723392;186735;186735;786432;1885475;1706012;2509824
753331,418;301056;121470;325632;1397684;1397685;1397760;1698740;1519155;1723392;186735;186735;786432;1885475;1705890;2509824
753346,729;301056;121229;325632;1397684;1397685;1397760;1698740;1518914;1723392;186735;186735;786432;1885475;1705649;2509824
753430,108;301056;123584;325632;1397684;1397684;1397760;1698740;1521268;1723392;186746;186746;786432;1885486;1708014;2509824
753476,709;301056;123542;325632;1397684;1397685;1397760;1698740;1521227;1723392;186746;186746;786432;1885486;1707973;2509824
753491,473;301056;124703;325632;1397684;1397685;1397760;1698740;1522388;1723392;186746;186746;786432;1885486;1709134;2509824
753531,534;301056;124619;325632;1397684;1397685;1397760;1698740;1522304;1723392;186746;186746;786432;1885486;1709050;2509824
753775,224;301056;125630;325632;1397684;1397685;1397760;1698740;1523315;1723392;186749;186749;786432;1885489;1710064;2509824
753809,828;301056;129321;325632;1397684;1397684;1397760;1698740;1527005;1723392;186749;186749;786432;1885489;1713754;2509824
753829,746;301056;124315;325632;1397684;1397685;1397760;1698740;1522000;1723392;186796;186796;786432;1885536;1708796;2509824
753856,526;301056;126692;325632;1397684;1397685;1397760;1698740;1524377;1723392;186796;186796;786432;1885536;1711173;2509824
753885,528;301056;127003;325632;1397684;1397684;1397760;1698740;1524687;1723392;186796;186796;786432;1885536;1711483;2509824
753918,641;301056;127958;325632;1397684;1397685;1397760;1698740;1525643;1723392;186796;186796;786432;1885536;1712439;2509824
753950,176;301056;126356;325632;1397684;1397685;1397760;1698740;1524041;1723392;186796;186796;786432;1885536;1710837;2509824
753969,605;301056;127702;325632;1397684;1397685;1397760;1698740;1525387;1723392;186796;186796;786432;1885536;1712183;2509824
753978,872;301056;128517;325632;1397684;1397685;1397760;1698740;1526202;1723392;186796;186796;786432;1885536;1712998;2509824
753985,332;301056;127118;325632;1397684;1397684;1397760;1698740;1524802;1723392;186796;186796;786432;1885536;1711598;2509824
753994,251;301056;126910;325632;1397684;1397685;1397760;1698740;1524595;1723392;186796;186796;786432;1885536;1711391;2509824
754001,512;301056;127200;325632;1397684;1397685;1397760;1698740;1524885;1723392;186796;186796;786432;1885536;1711681;2509824
754036,377;301056;127329;325632;1397684;1397685;1397760;1698740;1525014;1723392;186796;186796;786432;1885536;1711810;2509824
754225,870;301044;125962;325632;1397685;1397684;1397760;1698729;1523646;1723392;186796;186796;786432;1885525;1710442;2509824
754255,874;301056;131423;325632;1397684;1397684;1397760;1698740;1529107;1723392;186796;186783;786432;1885536;1715890;2509824
754397,383;301056;128434;325632;1397684;1397685;1397760;1698740;1526119;1723392;186783;186783;786432;1885523;1712902;2509824
754475,784;301056;128250;325632;1397684;1397684;1397760;1698740;1525934;1723392;186783;186783;786432;1885523;1712717;2509824
754572,022;301056;128983;325632;1397684;1397685;1397760;1698740;1526668;1723392;186783;186783;786432;1885523;1713451;2509824
754601,393;301056;129216;325632;1397684;1397684;1397760;1698740;1526900;1723392;186786;186786;786432;1885526;1713686;2509824
754647,128;301056;128981;325632;1397684;1397684;1397760;1698740;1526665;1723392;186786;186786;786432;1885526;1713451;2509824
754661,670;301056;130036;325632;1397684;1397685;1397760;1698740;1527721;1723392;186786;186786;786432;1885526;1714507;2509824
754693,398;301056;129579;325632;1397684;1397684;1397760;1698740;1527263;1723392;186798;186798;786432;1885538;1714061;2509824
754705,911;301056;130462;325632;1397683;1397683;1397760;1698739;1528145;1723392;186798;186798;786432;1885537;1714943;2509824
754725,180;301056;129213;325632;1397683;1397683;1397760;1698739;1526896;1723392;186798;186798;786432;1885537;1713694;2509824
754768,545;301056;130387;325632;1397683;1397683;1397760;1698739;1528070;1723392;186801;186801;786432;1885540;1714871;2509824
754804,173;301056;131837;325632;1397683;1397683;1397760;1698739;1529520;1723392;186801;186801;786432;1885540;1716321;2509824
754828,971;301056;131258;325632;1397683;1397683;1397760;1698739;1528941;1723392;186801;186801;786432;1885540;1715742;2509824
754840,522;301056;133765;325632;1397683;1397684;1397760;1698739;1531449;1723392;186801;186801;786432;1885540;1718250;2509824
754868,965;301056;130291;325632;1397683;1397684;1397760;1698739;1527975;1723392;186801;186801;786432;1885540;1714776;2509824
755200,949;301056;131490;325632;1397683;1397683;1397760;1698739;1529173;1723392;186801;186801;786432;1885540;1715974;2509824
755225,340;301056;129963;325632;1397683;1397683;1397760;1698739;1527646;1723392;186801;186801;786432;1885540;1714447;2509824
755290,197;300924;128731;325632;1397683;1397683;1397760;1698607;1526414;1723392;186801;186801;786432;1885408;1713215;2509824
755327,856;301053;132025;325632;1397683;1397683;1397760;1698736;1529708;1723392;186801;186754;786432;1885537;1716462;2509824
755400,312;301056;132459;325632;1397683;1397683;1397760;1698739;1530142;1723392;186754;186676;786432;1885493;1716818;2509824
755431,919;301056;133178;325632;1397683;1397683;1397760;1698739;1530861;1723392;186676;186676;786432;1885415;1717537;2509824
755456,751;301056;131039;325632;1397683;1397683;1397760;1698739;1528722;1723392;186688;186638;786432;1885427;1715360;2509824
755489,368;301056;133305;325632;1397683;1397684;1397760;1698739;1530989;1723392;186641;186641;786432;1885380;1717630;2509824
755587,292;301056;134250;325632;1397683;1397684;1397760;1698739;1531934;1723392;186731;186731;786432;1885470;1718665;2509824
755625,467;301056;134470;325632;1397683;1397683;1397760;1698739;1532153;1723392;186731;186731;786432;1885470;1718884;2509824
755642,583;301056;132822;325632;1397683;1397683;1397760;1698739;1530505;1723392;186743;186743;786432;1885482;1717248;2509824
755664,843;301056;132674;325632;1397683;1397684;1397760;1698739;1530358;1723392;186743;186743;786432;1885482;1717101;2509824
755684,343;301056;132645;325632;1397683;1397683;1397760;1698739;1530328;1723392;186743;186743;786432;1885482;1717071;2509824
755699,104;301056;133190;325632;1397683;1397683;1397760;1698739;1530873;1723392;186790;186790;786432;1885529;1717663;2509824
756324,213;301056;127477;325632;1397683;1397683;1397760;1698739;1525160;1723392;186796;186796;786432;1885535;1711956;2509824
756362,647;301056;128328;325632;1397683;1397680;1397760;1698739;1526008;1723392;186796;186576;786432;1885535;1712584;2509824
756393,087;301056;127116;325632;1397680;1397680;1397760;1698736;1524796;1723392;186576;186576;786432;1885312;1711372;2509824
756408,931;301056;127222;325632;1397680;1397680;1397760;1698736;1524902;1723392;186612;186612;786432;1885348;1711514;2509824
756434,693;301056;130461;325632;1397680;1397681;1397760;1698736;1528142;1723392;186618;186618;786432;1885354;1714760;2509824
756446,068;301056;130613;325632;1397680;1397681;1397760;1698736;1528294;1723392;186618;186618;786432;1885354;1714912;2509824
756516,272;301056;135351;325632;1397680;1397680;1397760;1698736;1533031;1723392;186670;186670;786432;1885406;1719701;2509824
756555,408;301056;131002;325632;1397680;1397681;1397760;1698736;1528683;1723392;186670;186670;786432;1885406;1715353;2509824
756570,429;301056;130606;325632;1397680;1397681;1397760;1698736;1528287;1723392;186670;186670;786432;1885406;1714957;2509824
756579,421;301056;130709;325632;1397680;1397681;1397760;1698736;1528390;1723392;186670;186670;786432;1885406;1715060;2509824
756599,141;301056;132030;325632;1397680;1397680;1397760;1698736;1529710;1723392;186670;186670;786432;1885406;1716380;2509824
756619,359;154218;135773;325632;1397681;1397680;1397760;1551899;1533453;1723392;186683;186683;786432;1738582;1720136;2509824
756706,631;301056;134656;325632;1397680;1397681;1397760;1698736;1532337;1723392;186688;186688;786432;1885424;1719025;2509824
756800,319;301056;126604;325632;1397680;1397680;1397760;1698736;1524284;1723392;186724;186724;786432;1885460;1711008;2509824
756838,576;301056;128902;325632;1397680;1397680;1397760;1698736;1526582;1723392;186724;186724;786432;1885460;1713306;2509824
756868,848;301056;130134;325632;1397680;1397680;1397760;1698736;1527814;1723392;186729;186729;786432;1885465;1714543;2509824
756902,737;301056;129876;325632;1397680;1397680;1397760;1698736;1527556;1723392;186734;186734;786432;1885470;1714290;2509824
756924,648;301056;125622;325632;1397680;1397680;1397760;1698736;1523302;1723392;186734;186734;786432;1885470;1710036;2509824
756931,969;301056;126561;325632;1397680;1397680;1397760;1698736;1524241;1723392;186734;186734;786432;1885470;1710975;2509824
757063,161;300735;130541;325632;1397680;1397680;1397760;1698415;1528221;1723392;186902;186850;786432;1885317;1715071;2509824
757174,442;300969;127427;325632;1397681;1397680;1397760;1698650;1525107;1723392;186854;186738;786432;1885504;1711845;2509824
757230,745;301056;129188;325632;1397680;1397680;1397760;1698736;1526868;1723392;186738;186734;786432;1885474;1713602;2509824
757403,222;301007;128925;325632;1397680;1397681;1397760;1698687;1526606;1723392;186734;186734;786432;1885421;1713340;2509824
757673,187;301056;127586;325632;1397680;1397680;1397760;1698736;1525266;1723392;186737;186716;786432;1885473;1711982;2509824
757730,622;301056;129526;325632;1397680;1397680;1397760;1698736;1527206;1723392;186716;186716;786432;1885452;1713922;2509824
757751,923;301056;130466;325632;1397680;1397680;1397760;1698736;1528146;1723392;186716;186698;786432;1885452;1714844;2509824
757763,677;301056;128985;325632;1397680;1397680;1397760;1698736;1526665;1723392;186698;186698;786432;1885434;1713363;2509824
757980,866;301056;133986;325632;1397680;1397681;1397760;1698736;1531667;1723392;186701;186701;786432;1885437;1718368;2509824
757995,659;301056;130888;325632;1397680;1397680;1397760;1698736;1528568;1723392;186701;186701;786432;1885437;1715269;2509824
758018,328;301056;130990;325632;1397680;1397680;1397760;1698736;1528670;1723392;186704;186704;786432;1885440;1715374;2509824
758109,192;301056;132188;325632;1397680;1397680;1397760;1698736;1529868;1723392;186704;186704;786432;1885440;1716572;2509824
758283,335;301056;127995;325632;1397680;1397680;1397760;1698736;1525675;1723392;186704;186704;786432;1885440;1712379;2509824
758394,946;301056;128502;325632;1397680;1397680;1397760;1698736;1526182;1723392;186706;186706;786432;1885442;1712888;2509824
758507,346;301056;129899;325632;1397680;1397681;1397760;1698736;1527580;1723392;186759;186756;786432;1885495;1714336;2509824
758663,559;301040;131931;325632;1397680;1397680;1397760;1698720;1529611;1723392;186780;186780;786432;1885500;1716391;2509824
758779,419;301056;131130;325632;1397680;1397680;1397760;1698736;1528810;1723392;186780;186780;786432;1885516;1715590;2509824
758860,038;301056;129825;325632;1397680;1397680;1397760;1698736;1527505;1723392;186780;186780;786432;1885516;1714285;2509824
759196,556;301056;132341;325632;1397680;1397680;1397760;1698736;1530021;1723392;186783;186783;786432;1885519;1716804;2509824
759222,174;301056;129549;325632;1397680;1397680;1397760;1698736;1527229;1723392;186783;186775;786432;1885519;1714004;2509824
759262,635;301056;134642;325632;1397680;1397680;1397760;1698736;1532322;1723392;186775;186678;786432;1885511;1719000;2509824
759299,296;301056;133107;325632;1397680;1397681;1397760;1698736;1530788;1723392;186686;186686;786432;1885422;1717474;2509824
759394,486;301056;130249;325632;1397680;1397680;1397760;1698736;1527929;1723392;186686;186686;786432;1885422;1714615;2509824
759587,831;301056;129842;325632;1397680;1397680;1397760;1698736;1527522;1723392;186686;186686;786432;1885422;1714208;2509824
759760,267;301056;130790;325632;1397680;1397680;1397760;1698736;1528470;1723392;186728;186728;786432;1885464;1715198;2509824
759823,523;301056;128944;325632;1397680;1397680;1397760;1698736;1526624;1723392;186728;186728;786432;1885464;1713352;2509824
759873,893;301056;129773;325632;1397680;1397680;1397760;1698736;1527453;1723392;186733;186733;786432;1885469;1714186;2509824
760004,376;301056;130773;325632;1397680;1397680;1397760;1698736;1528453;1723392;186735;186735;786432;1885471;1715188;2509824
760397,559;301056;131319;325632;1397680;1397680;1397760;1698736;1528999;1723392;186738;186738;786432;1885474;1715737;2509824
760509,787;301056;131374;325632;1397680;1397680;1397760;1698736;1529054;1723392;186741;186729;786432;1885477;1715783;2509824
760551,956;301056;128603;325632;1397680;1397680;1397760;1698736;1526283;1723392;186729;186729;786432;1885465;1713012;2509824
760593,751;301056;128893;325632;1397680;1397680;1397760;1698736;1526573;1723392;186729;186729;786432;1885465;1713302;2509824
760747,526;301056;131925;325632;1397680;1397680;1397760;1698736;1529605;1723392;186729;186729;786432;1885465;1716334;2509824
760772,527;301056;130570;325632;1397680;1397681;1397760;1698736;1528251;1723392;186729;186729;786432;1885465;1714980;2509824
760816,740;301056;131079;325632;1397680;1397680;1397760;1698736;1528759;1723392;186732;186732;786432;1885468;1715491;2509824
760824,711;301056;131541;325632;1397680;1397680;1397760;1698736;1529221;1723392;186732;186732;786432;1885468;1715953;2509824
760852,197;301056;129511;325632;1397680;1397681;1397760;1698736;1527192;1723392;186779;186779;786432;1885515;1713971;2509824
760894,881;301056;131379;325632;1397680;1397680;1397760;1698736;1529059;1723392;186782;186782;786432;1885518;1715841;2509824
761222,353;301056;132110;325632;1397680;1397680;1397760;1698736;1529790;1723392;186795;186795;786432;1885531;1716585;2509824
761332,420;301056;130585;325632;1397680;1397680;1397760;1698736;1528265;1723392;186795;186795;786432;1885531;1715060;2509824
761350,039;301056;134366;325632;1397680;1397680;1397760;1698736;1532046;1723392;186795;186795;786432;1885531;1718841;2509824
761363,956;301056;129739;325632;1397680;1397680;1397760;1698736;1527419;1723392;186798;186798;786432;1885534;1714217;2509824
761370,735;301056;132853;325632;1397680;1397680;1397760;1698736;1530533;1723392;186798;186798;786432;1885534;1717331;2509824
761385,598;301056;130780;325632;1397680;1397680;1397760;1698736;1528460;1723392;186798;186798;786432;1885534;1715258;2509824
761394,033;301056;130888;325632;1397680;1397680;1397760;1698736;1528568;1723392;186798;186798;786432;1885534;1715366;2509824
761463,824;301056;133793;325632;1397680;1397681;1397760;1698736;1531474;1723392;186798;186794;786432;1885534;1718268;2509824
761497,959;301056;134135;325632;1397680;1397680;1397760;1698736;1531815;1723392;186794;186782;786432;1885530;1718597;2509824
761522,536;301056;132301;325632;1397680;1397680;1397760;1698736;1529981;1723392;186782;186782;786432;1885518;1716763;2509824
761557,696;301056;132336;325632;1397680;1397680;1397760;1698736;1530016;1723392;186782;186782;786432;1885518;1716798;2509824
761580,374;301056;132532;325632;1397680;1397680;1397760;1698736;1530212;1723392;186782;186782;786432;1885518;1716994;2509824
761591,136;301056;132619;325632;1397680;1397681;1397760;1698736;1530300;1723392;186782;186782;786432;1885518;1717082;2509824
761615,703;301056;133155;325632;1397680;1397680;1397760;1698736;1530835;1723392;186782;186782;786432;1885518;1717617;2509824
761635,597;301056;134416;325632;1397680;1397680;1397760;1698736;1532096;1723392;186782;186782;786432;1885518;1718878;2509824
762112,881;301056;130182;325632;1397680;1397680;1397760;1698736;1527862;1723392;186782;186782;786432;1885518;1714644;2509824
762174,511;301056;136136;325632;1397680;1397680;1397760;1698736;1533816;1723392;186782;186782;786432;1885518;1720598;2509824
762227,594;300844;134396;325632;1397680;1397681;1397760;1698524;1532077;1723392;186782;186782;786432;1885306;1718859;2509824
762268,812;301056;132290;325632;1397680;1397680;1397760;1698736;1529970;1723392;186782;186720;786432;1885518;1716690;2509824
762307,398;301056;133273;325632;1397680;1397681;1397760;1698736;1530954;1723392;186720;186720;786432;1885456;1717674;2509824
762322,633;301056;134924;325632;1397680;1397680;1397760;1698736;1532604;1723392;186729;186729;786432;1885465;1719333;2509824
762349,492;301056;133210;325632;1397680;1397680;1397760;1698736;1530890;1723392;186740;186740;786432;1885476;1717630;2509824
762445,174;301056;132812;325632;1397680;1397681;1397760;1698736;1530493;1723392;186776;186776;786432;1885512;1717269;2509824
762733,784;301056;132885;325632;1397680;1397680;1397760;1698736;1530565;1723392;186781;186781;786432;1885517;1717346;2509824
762799,808;301056;131635;325632;1397680;1397680;1397760;1698736;1529315;1723392;186781;186781;786432;1885517;1716096;2509824
762833,590;301056;131644;325632;1397680;1397680;1397760;1698736;1529324;1723392;186781;186781;786432;1885517;1716105;2509824
762861,436;301056;137102;325632;1397680;1397680;1397760;1698736;1534782;1723392;186787;186787;786432;1885523;1721569;2509824
762877,514;301056;135358;325632;1397680;1397680;1397760;1698736;1533038;1723392;186787;186787;786432;1885523;1719825;2509824
762898,241;301056;130863;325632;1397680;1397680;1397760;1698736;1528543;1723392;186787;186787;786432;1885523;1715330;2509824
762909,220;301056;132546;325632;1397680;1397680;1397760;1698736;1530226;1723392;186787;186787;786432;1885523;1717013;2509824
763033,746;301056;134121;325632;1397680;1397680;1397760;1698736;1531801;1723392;186787;186787;786432;1885523;1718588;2509824
763179,209;301056;134225;325632;1397680;1397680;1397760;1698736;1531905;1723392;186787;186787;786432;1885523;1718692;2509824
763432,113;301056;136601;325632;1397680;1397680;1397760;1698736;1534281;1723392;186787;186787;786432;1885523;1721068;2509824
763531,609;301056;133415;325632;1397680;1397680;1397760;1698736;1531095;1723392;186787;186787;786432;1885523;1717882;2509824
763567,072;301056;134126;325632;1397680;1397680;1397760;1698736;1531806;1723392;186787;186787;786432;1885523;1718593;2509824
763621,048;301056;137032;325632;1397680;1397680;1397760;1698736;1534712;1723392;186787;186787;786432;1885523;1721499;2509824
763640,867;301056;138610;325632;1397680;1397680;1397760;1698736;1536290;1723392;186796;186796;786432;1885532;1723086;2509824
763653,322;301048;137127;325632;1397680;1397680;1397760;1698728;1534807;1723392;186796;186796;786432;1885524;1721603;2509824
763669,902;301056;135617;325632;1397680;1397680;1397760;1698736;1533297;1723392;186796;186796;786432;1885532;1720093;2509824
763681,068;301056;133882;325632;1397680;1397680;1397760;1698736;1531562;1723392;186796;186796;786432;1885532;1718358;2509824
763693,517;301056;137026;325632;1397680;1397680;1397760;1698736;1534706;1723392;186796;186796;786432;1885532;1721502;2509824
763723,152;301056;134901;325632;1397680;1397680;1397760;1698736;1532581;1723392;186809;186809;786432;1885545;1719390;2509824
763743,359;301056;137132;325632;1397680;1397680;1397760;1698736;1534812;1723392;186809;186809;786432;1885545;1721621;2509824
763760,893;301056;137555;325632;1397680;1397680;1397760;1698736;1535235;1723392;186809;186809;786432;1885545;1722044;2509824
763789,984;301056;137122;325632;1397680;1397681;1397760;1698736;1534803;1723392;186809;186809;786432;1885545;1721612;2509824
763837,784;301056;136948;325632;1397680;1397680;1397760;1698736;1534628;1723392;186809;186809;786432;1885545;1721437;2509824
763934,956;301056;141058;325632;1397680;1397680;1397760;1698736;1538738;1723392;186809;186809;786432;1885545;1725547;2509824
764053,439;301056;141404;325632;1397680;1397680;1397760;1698736;1539084;1723392;186809;186809;786432;1885545;1725893;2509824
764083,897;300777;138879;325632;1397681;1397680;1397760;1698458;1536559;1723392;186809;186809;786432;1885267;1723368;2509824
764216,007;301056;140674;325632;1397680;1397680;1397760;1698736;1538354;1723392;186976;186925;786432;1885712;1725279;2509824
764369,707;301056;142833;325632;1397680;1397680;1397760;1698736;1540513;1723392;186925;186809;786432;1885661;1727322;2509824
764446,894;301056;141572;325632;1397680;1397680;1397760;1698736;1539252;1723392;186809;186809;786432;1885545;1726061;2509824
764462,145;301000;141045;325632;1397680;1397680;1397760;1698680;1538725;1723392;186809;186791;786432;1885489;1725516;2509824
764471,775;301056;140035;325632;1397680;1397680;1397760;1698736;1537715;1723392;186791;186791;786432;1885527;1724506;2509824
764492,072;301056;141731;325632;1397680;1397680;1397760;1698736;1539411;1723392;186791;186791;786432;1885527;1726202;2509824
764524,335;301056;140743;325632;1397680;1397680;1397760;1698736;1538423;1723392;186797;186797;786432;1885533;1725220;2509824
764555,042;300971;143039;325632;1397681;1397680;1397760;1698652;1540719;1723392;186797;186797;786432;1885449;1727516;2509824
764584,662;301056;144932;325632;1397680;1397680;1397760;1698736;1542612;1723392;186797;186797;786432;1885533;1729409;2509824
764600,979;301056;144763;325632;1397679;1397680;1397760;1698735;1542443;1723392;186797;186797;786432;1885532;1729240;2509824
764628,757;301056;143984;325632;1397679;1397680;1397760;1698735;1541664;1723392;186815;186815;786432;1885550;1728479;2509824
764681,906;301056;141997;325632;1397679;1397680;1397760;1698735;1539677;1723392;186815;186815;786432;1885550;1726492;2509824
764750,926;301056;144727;325632;1397679;1397680;1397760;1698735;1542407;1723392;186815;186815;786432;1885550;1729222;2509824
764811,738;301056;144171;325632;1397679;1397680;1397760;1698735;1541851;1723392;186815;186815;786432;1885550;1728666;2509824
764846,703;301056;143262;325632;1397679;1397680;1397760;1698735;1540942;1723392;186815;186815;786432;1885550;1727757;2509824
765368,779;301056;140314;325632;1397679;1397680;1397760;1698735;1537994;1723392;186815;186815;786432;1885550;1724809;2509824
765444,557;301056;141340;325632;1397679;1397680;1397760;1698735;1539020;1723392;186815;186804;786432;1885550;1725824;2509824
765730,516;301056;138881;325632;1397679;1397680;1397760;1698735;1536561;1723392;186804;186787;786432;1885539;1723348;2509824
765961,620;301056;139429;325632;1397679;1397680;1397760;1698735;1537109;1723392;186787;186787;786432;1885522;1723896;2509824
765981,859;301056;140217;325632;1397679;1397679;1397760;1698735;1537896;1723392;186787;186768;786432;1885522;1724664;2509824
766480,391;301056;137000;325632;1397679;1397680;1397760;1698735;1534680;1723392;186780;186780;786432;1885515;1721460;2509824
766517,289;301056;138287;325632;1397679;1397680;1397760;1698735;1535967;1723392;186780;186757;786432;1885515;1722724;2509824
766558,680;301056;139529;325632;1397679;1397680;1397760;1698735;1537209;1723392;186757;186757;786432;1885492;1723966;2509824
766604,832;301056;135504;325632;1397679;1397680;1397760;1698735;1533184;1723392;186757;186745;786432;1885492;1719929;2509824
766611,525;301056;136202;325632;1397679;1397679;1397760;1698735;1533881;1723392;186745;186745;786432;1885480;1720626;2509824
768060,767;301056;132791;325632;1397679;1397680;1397760;1698735;1530471;1723392;186754;186754;786432;1885489;1717225;2509824
768781,326;301056;135721;325632;1397679;1397635;1397760;1698735;1533356;1723392;186770;185568;786432;1885505;1718924;2509824
768822,912;301056;135926;325632;1397635;1397615;1397760;1698691;1533541;1723392;185794;185683;786432;1884485;1719224;2509824
768872,907;301056;137650;325632;1397615;1397616;1397760;1698671;1535266;1723392;185881;185881;786432;1884552;1721147;2509824
769893,610;301056;134602;325632;1397615;1397615;1397760;1698671;1532217;1723392;186073;186073;786432;1884744;1718290;2509824
770406,125;301056;135521;325632;1397615;1397615;1397760;1698671;1533136;1723392;186079;185559;786432;1884750;1718695;2509824
770618,312;301047;135416;325632;1397615;1397615;1397760;1698662;1533031;1723392;185817;185817;786432;1884479;1718848;2509824
770858,486;301056;133750;325632;1397615;1397615;1397760;1698671;1531365;1723392;186244;186212;786432;1884915;1717577;2509824
770861,680;301056;133675;325632;1397615;1397615;1397760;1698671;1531290;1723392;186263;186263;786432;1884934;1717553;2509824
771993,606;301056;133631;325632;1397615;1397615;1397760;1698671;1531246;1723392;186272;186272;786432;1884943;1717518;2509824
773465,820;301056;133010;325632;1397615;1397614;1397760;1698671;1530624;1723392;186272;185337;786432;1884943;1715961;2509824
775047,377;301056;132088;325632;1397614;1397610;1397760;1698670;1529698;1723392;185343;185327;786432;1884013;1715025;2509824
775427,186;301056;136215;325632;1397610;1397611;1397760;1698666;1533826;1723392;185413;185413;786432;1884079;1719239;2509824
775471,513;301056;134174;325632;1397610;1397610;1397760;1698666;1531784;1723392;185795;185795;786432;1884461;1717579;2509824
775506,770;301056;134178;325632;1397610;1397610;1397760;1698666;1531788;1723392;185858;185858;786432;1884524;1717646;2509824
776629,942;301056;134125;325632;1397610;1397611;1397760;1698666;1531736;1723392;185896;185896;786432;1884562;1717632;2509824
778151,008;301056;132297;325632;1397610;1397610;1397760;1698666;1529907;1723392;185896;185340;786432;1884562;1715247;2509824
779412,881;301056;133575;325632;1397610;1397610;1397760;1698666;1531185;1723392;185342;185339;786432;1884008;1716524;2509824
780993,592;301056;132137;325632;1397610;1397610;1397760;1698666;1529747;1723392;185342;185330;786432;1884008;1715077;2509824
782444,722;301056;133033;325632;1397610;1397611;1397760;1698666;1530644;1723392;185335;185335;786432;1884001;1715979;2509824
783993,622;301056;132639;325632;1397610;1397610;1397760;1698666;1530249;1723392;185340;185335;786432;1884006;1715584;2509824
785547,908;301056;132503;325632;1397610;1397610;1397760;1698666;1530113;1723392;185340;185336;786432;1884006;1715449;2509824
787214,043;301056;132426;325632;1397610;1397610;1397760;1698666;1530036;1723392;185337;185334;786432;1884003;1715370;2509824
787574,719;301056;135809;325632;1397610;1397610;1397760;1698666;1533419;1723392;185475;185475;786432;1884141;1718894;2509824
787764,303;301056;134003;325632;1397610;1397610;1397760;1698666;1531613;1723392;185842;185842;786432;1884508;1717455;2509824
787811,356;301056;134333;325632;1397610;1397611;1397760;1698666;1531944;1723392;185860;185860;786432;1884526;1717804;2509824
788719,626;301056;137305;325632;1397610;1397610;1397760;1698666;1534915;1723392;186177;186113;786432;1884843;1721028;2509824
789518,307;301027;133889;325632;1397610;1397611;1397760;1698637;1531500;1723392;186148;185804;786432;1884785;1717304;2509824
791193,609;301056;132397;325632;1397610;1397611;1397760;1698666;1530008;1723392;185805;185340;786432;1884471;1715348;2509824
792774,940;301056;132529;325632;1397610;1397611;1397760;1698666;1530140;1723392;185340;185338;786432;1884006;1715478;2509824
793327,897;301056;135543;325632;1397610;1397610;1397760;1698666;1533153;1723392;185469;185469;786432;1884135;1718622;2509824
793978,132;301056;133852;325632;1397610;1397610;1397760;1698666;1531462;1723392;185655;185586;786432;1884321;1717048;2509824
795611,677;301056;132518;325632;1397610;1397611;1397760;1698666;1530129;1723392;185589;185340;786432;1884255;1715469;2509824
797193,641;301056;132517;325632;1397610;1397610;1397760;1698666;1530127;1723392;185340;185335;786432;1884006;1715462;2509824
798518,292;301023;133947;325632;1397610;1397610;1397760;1698633;1531557;1723392;185346;185346;786432;1883979;1716903;2509824
799794,647;301056;133237;325632;1397610;1397610;1397760;1698666;1530847;1723392;185358;185358;786432;1884024;1716205;2509824
799851,534;301056;135303;325632;1397610;1397611;1397760;1698666;1532914;1723392;185574;185484;786432;1884240;1718398;2509824
801411,172;300977;133444;325632;1397610;1397610;1397760;1698587;1531054;1723392;185543;185540;786432;1884130;1716594;2509824
803113,031;301056;132902;325632;1397610;1397610;1397760;1698666;1530512;1723392;185556;185331;786432;1884222;1715843;2509824
803253,725;301056;136856;325632;1397610;1397610;1397760;1698666;1534466;1723392;185562;185549;786432;1884228;1720015;2509824
803324,824;301056;134410;325632;1397610;1397610;1397760;1698666;1532020;1723392;185788;185788;786432;1884454;1717808;2509824
803365,618;301056;137954;325632;1397610;1397610;1397760;1698666;1535564;1723392;186153;186102;786432;1884819;1721666;2509824
803772,202;300814;140477;325632;1397610;1397610;1397760;1698424;1538087;1723392;186109;185993;786432;1884533;1724080;2509824
803870,859;301056;135417;325632;1397610;1397611;1397760;1698666;1533028;1723392;186061;186055;786432;1884727;1719083;2509824
803979,160;301056;136049;325632;1397610;1397610;1397760;1698666;1533659;1723392;186228;186176;786432;1884894;1719835;2509824
804188,343;301056;137110;325632;1397610;1397610;1397760;1698666;1534720;1723392;186210;186095;786432;1884876;1720815;2509824
805242,317;301056;135616;325632;1397610;1397610;1397760;1698666;1533226;1723392;186141;186141;786432;1884807;1719367;2509824
805363,150;301056;136743;325632;1397610;1397610;1397760;1698666;1534353;1723392;186402;186301;786432;1885068;1720654;2509824
805613,940;301056;137994;325632;1397610;1397610;1397760;1698666;1535604;1723392;186342;186226;786432;1885008;1721830;2509824
805684,722;301056;136643;325632;1397610;1397610;1397760;1698666;1534253;1723392;186464;186464;786432;1885130;1720717;2509824
805890,939;301056;141780;325632;1397610;1397610;1397760;1698666;1539390;1723392;186645;186594;786432;1885311;1725984;2509824
806383,877;301056;137056;325632;1397610;1397610;1397760;1698666;1534666;1723392;186594;186478;786432;1885260;1721144;2509824
806441,862;301056;139575;325632;1397610;1397610;1397760;1698666;1537185;1723392;186658;186569;786432;1885324;1723754;2509824
806864,069;301056;138793;325632;1397610;1397610;1397760;1698666;1536403;1723392;186703;186587;786432;1885369;1722990;2509824
806949,556;301056;138215;325632;1397610;1397610;1397760;1698666;1535825;1723392;186587;186587;786432;1885253;1722412;2509824
807093,599;301056;140061;325632;1397610;1397610;1397760;1698666;1537671;1723392;186758;186707;786432;1885424;1724378;2509824
807182,942;301056;138299;325632;1397610;1397610;1397760;1698666;1535909;1723392;186707;186588;786432;1885373;1722497;2509824
807437,979;301056;140470;325632;1397610;1397611;1397760;1698666;1538081;1723392;186599;186599;786432;1885265;1724680;2509824
807502,372;301056;138930;325632;1397610;1397610;1397760;1698666;1536540;1723392;186599;186599;786432;1885265;1723139;2509824
807538,369;301056;141138;325632;1397610;1397610;1397760;1698666;1538748;1723392;186766;186714;786432;1885432;1725462;2509824
807601,967;301056;139833;325632;1397610;1397610;1397760;1698666;1537443;1723392;186717;186602;786432;1885383;1724045;2509824
807661,148;301056;140731;325632;1397610;1397610;1397760;1698666;1538341;1723392;186602;186602;786432;1885268;1724943;2509824
808139,332;301056;139403;325632;1397610;1397610;1397760;1698666;1537013;1723392;186602;186602;786432;1885268;1723615;2509824
808208,755;300856;140238;325632;1397610;1397610;1397760;1698466;1537848;1723392;186771;186719;786432;1885237;1724567;2509824
808368,973;301056;141141;325632;1397610;1397610;1397760;1698666;1538751;1723392;186766;186648;786432;1885432;1725399;2509824
808496,126;301056;139730;325632;1397610;1397610;1397760;1698666;1537340;1723392;186656;186656;786432;1885322;1723996;2509824
808800,416;301056;139683;325632;1397610;1397610;1397760;1698666;1537293;1723392;186656;186656;786432;1885322;1723949;2509824
808893,511;301037;140615;325632;1397610;1397610;1397760;1698647;1538225;1723392;186824;186772;786432;1885471;1724997;2509824
809148,235;301056;141128;325632;1397610;1397610;1397760;1698666;1538738;1723392;186778;186663;786432;1885444;1725401;2509824
809412,939;301056;140688;325632;1397610;1397610;1397760;1698666;1538298;1723392;186666;186666;786432;1885332;1724964;2509824
809451,814;301056;142460;325632;1397610;1397610;1397760;1698666;1540070;1723392;186833;186781;786432;1885499;1726851;2509824
809654,501;300660;142044;325632;1397610;1397610;1397760;1698270;1539654;1723392;186794;186679;786432;1885064;1726333;2509824
809791,860;301056;140112;325632;1397610;1397610;1397760;1698666;1537722;1723392;186679;186679;786432;1885345;1724401;2509824
809839,955;301056;142980;325632;1397610;1397611;1397760;1698666;1540591;1723392;186851;186793;786432;1885517;1727384;2509824
809959,106;301056;140744;325632;1397610;1397610;1397760;1698666;1538354;1723392;186793;186626;786432;1885459;1724980;2509824
810025,309;301056;143087;325632;1397610;1397610;1397760;1698666;1540697;1723392;186793;186793;786432;1885459;1727490;2509824
810188,529;301056;143744;325632;1397610;1397610;1397760;1698666;1541354;1723392;186805;186689;786432;1885471;1728043;2509824
810236,634;301056;144485;325632;1397610;1397610;1397760;1698666;1542095;1723392;186694;186694;786432;1885360;1728789;2509824
810286,020;301056;145835;325632;1397610;1397610;1397760;1698666;1543445;1723392;186750;186750;786432;1885416;1730195;2509824
810316,674;301056;142090;325632;1397610;1397610;1397760;1698666;1539700;1723392;186750;186750;786432;1885416;1726450;2509824
810326,014;301056;142718;325632;1397610;1397610;1397760;1698666;1540328;1723392;186755;186755;786432;1885421;1727083;2509824
810345,144;301056;143802;325632;1397610;1397610;1397760;1698666;1541412;1723392;186755;186755;786432;1885421;1728167;2509824
810354,568;301056;143059;325632;1397610;1397611;1397760;1698666;1540670;1723392;186758;186758;786432;1885424;1727428;2509824
810375,766;301056;144373;325632;1397610;1397610;1397760;1698666;1541983;1723392;186758;186758;786432;1885424;1728741;2509824
810410,287;301056;144835;325632;1397610;1397610;1397760;1698666;1542445;1723392;186758;186758;786432;1885424;1729203;2509824
810455,560;301056;146153;325632;1397610;1397610;1397760;1698666;1543763;1723392;186925;186874;786432;1885591;1730637;2509824
810490,751;301056;143826;325632;1397610;1397610;1397760;1698666;1541436;1723392;186874;186758;786432;1885540;1728194;2509824
810528,842;301056;143690;325632;1397610;1397611;1397760;1698666;1541301;1723392;186758;186758;786432;1885424;1728059;2509824
810566,005;301056;146254;325632;1397610;1397610;1397760;1698666;1543864;1723392;186926;186874;786432;1885592;1730738;2509824
810599,984;301056;143879;325632;1397610;1397610;1397760;1698666;1541489;1723392;186874;186758;786432;1885540;1728247;2509824
810662,905;301056;144599;325632;1397610;1397610;1397760;1698666;1542209;1723392;186926;186874;786432;1885592;1729083;2509824
810880,306;301056;147893;325632;1397610;1397610;1397760;1698666;1545503;1723392;186874;186758;786432;1885540;1732261;2509824
811063,135;301056;145910;325632;1397610;1397610;1397760;1698666;1543520;1723392;186758;186712;786432;1885424;1730232;2509824
811118,312;300998;143980;325632;1397610;1397610;1397760;1698608;1541590;1723392;186712;186706;786432;1885320;1728296;2509824
811198,936;301056;147591;325632;1397610;1397610;1397760;1698666;1545201;1723392;186878;186826;786432;1885544;1732027;2509824
811785,317;300996;145410;325632;1397610;1397610;1397760;1698606;1543020;1723392;186838;186719;786432;1885444;1729739;2509824
811831,621;301056;142408;325632;1397610;1397600;1397760;1698666;1540008;1723392;186719;186410;786432;1885385;1726418;2509824
811897,462;301056;146139;325632;1397599;1397600;1397760;1698655;1543739;1723392;186622;186570;786432;1885277;1730309;2509824
811951,312;301056;145257;325632;1397599;1397599;1397760;1698655;1542856;1723392;186651;186535;786432;1885306;1729391;2509824
811977,400;301056;145899;325632;1397599;1397600;1397760;1698655;1543499;1723392;186661;186661;786432;1885316;1730160;2509824
812026,307;301056;148774;325632;1397599;1397599;1397760;1698655;1546373;1723392;186661;186660;786432;1885316;1733033;2509824
812207,362;301056;144592;325632;1397599;1397599;1397760;1698655;1542191;1723392;186678;186678;786432;1885333;1728869;2509824
812685,703;301056;143278;325632;1397599;1397600;1397760;1698655;1540878;1723392;186678;186675;786432;1885333;1727553;2509824
813596,600;301056;145472;325632;1397599;1397600;1397760;1698655;1543072;1723392;186683;186477;786432;1885338;1729549;2509824
813671,974;301056;143952;325632;1397599;1397600;1397760;1698655;1541552;1723392;186477;186263;786432;1885132;1727815;2509824
813709,597;301056;148136;325632;1397599;1397600;1397760;1698655;1545736;1723392;186541;186489;786432;1885196;1732225;2509824
813982,732;301056;145250;325632;1397599;1397599;1397760;1698655;1542849;1723392;186524;186408;786432;1885179;1729257;2509824
814052,883;301056;143644;325632;1397599;1397599;1397760;1698655;1541243;1723392;186700;186649;786432;1885355;1727892;2509824
814101,368;301056;146120;325632;1397599;1397600;1397760;1698655;1543720;1723392;186652;186652;786432;1885307;1730372;2509824
814156,647;301056;143525;325632;1397599;1397600;1397760;1698655;1541125;1723392;186652;186484;786432;1885307;1727609;2509824
814263,768;301056;145604;325632;1397599;1397599;1397760;1698655;1543203;1723392;186668;186668;786432;1885323;1729871;2509824
814457,500;301056;143569;325632;1397599;1397599;1397760;1698655;1541168;1723392;186683;186558;786432;1885338;1727726;2509824
814497,926;301056;146507;325632;1397599;1397599;1397760;1698655;1544106;1723392;186728;186677;786432;1885383;1730783;2509824
814548,587;301056;145238;325632;1397599;1397599;1397760;1698655;1542837;1723392;186677;186561;786432;1885332;1729398;2509824
814613,234;301056;143731;325632;1397599;1397599;1397760;1698655;1541330;1723392;186561;186509;786432;1885216;1727839;2509824
814716,364;301056;145800;325632;1397599;1397600;1397760;1698655;1543400;1723392;186677;186677;786432;1885332;1730077;2509824
814927,314;301056;144078;325632;1397599;1397600;1397760;1698655;1541678;1723392;186677;186561;786432;1885332;1728239;2509824
814961,832;301056;146608;325632;1397599;1397599;1397760;1698655;1544207;1723392;186771;186720;786432;1885426;1730927;2509824
815222,521;301056;143998;325632;1397599;1397600;1397760;1698655;1541598;1723392;186722;186606;786432;1885377;1728204;2509824
815320,757;301056;143960;325632;1397599;1397600;1397760;1698655;1541560;1723392;186606;186606;786432;1885261;1728166;2509824
815355,235;301056;149829;325632;1397599;1397599;1397760;1698655;1547428;1723392;186776;186725;786432;1885431;1734153;2509824
815556,949;301056;144196;325632;1397599;1397599;1397760;1698655;1541795;1723392;186725;186609;786432;1885380;1728404;2509824
815592,838;301056;146780;325632;1397599;1397600;1397760;1698655;1544380;1723392;186784;186733;786432;1885439;1731113;2509824
815648,824;301056;144196;325632;1397599;1397600;1397760;1698655;1541796;1723392;186780;186664;786432;1885435;1728460;2509824
815717,103;301056;145288;325632;1397599;1397599;1397760;1698655;1542887;1723392;186831;186780;786432;1885486;1729667;2509824
815759,680;301056;144535;325632;1397599;1397600;1397760;1698655;1542135;1723392;186780;186664;786432;1885435;1728799;2509824
815844,787;301056;145341;325632;1397599;1397600;1397760;1698655;1542941;1723392;186837;186786;786432;1885492;1729727;2509824
815918,244;301056;146253;325632;1397599;1397599;1397760;1698655;1543852;1723392;186786;186670;786432;1885441;1730522;2509824
815959,255;301056;144547;325632;1397599;1397599;1397760;1698655;1542146;1723392;186670;186618;786432;1885325;1728764;2509824
816014,808;301056;147059;325632;1397599;1397600;1397760;1698655;1544659;1723392;186786;186786;786432;1885441;1731445;2509824
816071,199;301056;145281;325632;1397599;1397600;1397760;1698655;1542881;1723392;186786;186670;786432;1885441;1729551;2509824
816112,772;301056;149077;325632;1397599;1397599;1397760;1698655;1546676;1723392;186838;186786;786432;1885493;1733462;2509824
816170,346;301056;144596;325632;1397599;1397599;1397760;1698655;1542195;1723392;186786;186670;786432;1885441;1728865;2509824
816206,588;301056;147034;325632;1397599;1397600;1397760;1698655;1544634;1723392;186838;186786;786432;1885493;1731420;2509824
816243,613;301056;144894;325632;1397599;1397600;1397760;1698655;1542494;1723392;186786;186670;786432;1885441;1729164;2509824
816420,888;301056;145102;325632;1397599;1397599;1397760;1698655;1542701;1723392;186670;186618;786432;1885325;1729319;2509824
816469,065;301056;147561;325632;1397599;1397599;1397760;1698655;1545160;1723392;186786;186786;786432;1885441;1731946;2509824
816514,223;301056;145359;325632;1397599;1397599;1397760;1698655;1542958;1723392;186786;186670;786432;1885441;1729628;2509824
816550,933;300798;148183;325632;1397600;1397599;1397760;1698398;1545782;1723392;186838;186786;786432;1885236;1732568;2509824
817593,610;301056;145488;325632;1397599;1397599;1397760;1698655;1543087;1723392;186789;186673;786432;1885444;1729760;2509824
818811,213;300951;141171;325632;1397600;1397600;1397760;1698551;1538771;1723392;186687;185702;786432;1885238;1724473;2509824
819217,556;301056;143862;325632;1397599;1397599;1397760;1698655;1541461;1723392;185720;185677;786432;1884375;1727138;2509824
819316,337;301056;145059;325632;1397599;1397600;1397760;1698655;1542659;1723392;185949;185949;786432;1884604;1728608;2509824
819540,409;301056;142002;325632;1397599;1397599;1397760;1698655;1539601;1723392;186034;186034;786432;1884689;1725635;2509824
819582,030;301056;143106;325632;1397599;1397600;1397760;1698655;1540706;1723392;186288;186088;786432;1884943;1726794;2509824
820053,995;301056;141844;325632;1397599;1397599;1397760;1698655;1539443;1723392;186178;186178;786432;1884833;1725621;2509824
820366,119;301056;145654;325632;1397599;1397600;1397760;1698655;1543254;1723392;186256;186256;786432;1884911;1729510;2509824
820570,584;301056;144701;325632;1397599;1397599;1397760;1698655;1542300;1723392;186398;186398;786432;1885053;1728698;2509824
820613,420;301056;143896;325632;1397599;1397600;1397760;1698655;1541496;1723392;186408;186408;786432;1885063;1727904;2509824
820645,543;301056;149105;325632;1397599;1397600;1397760;1698655;1546705;1723392;186425;186422;786432;1885080;1733127;2509824
821183,104;301056;144269;325632;1397599;1397599;1397760;1698655;1541868;1723392;186570;186570;786432;1885225;1728438;2509824
822693,679;301056;141455;325632;1397599;1397600;1397760;1698655;1539055;1723392;186574;186371;786432;1885229;1725426;2509824
823064,745;301056;144883;325632;1397599;1397599;1397760;1698655;1542482;1723392;186452;185938;786432;1885107;1728420;2509824
823669,582;301056;144503;325632;1397599;1397600;1397760;1698655;1542103;1723392;186061;186061;786432;1884716;1728164;2509824
823797,565;301056;144696;325632;1397599;1397599;1397760;1698655;1542295;1723392;186166;186088;786432;1884821;1728383;2509824
823829,431;301056;145122;325632;1397599;1397599;1397760;1698655;1542721;1723392;186097;186097;786432;1884752;1728818;2509824
823893,657;301056;144166;325632;1397599;1397600;1397760;1698655;1541766;1723392;186222;186222;786432;1884877;1727988;2509824
824059,074;301056;148182;325632;1397599;1397599;1397760;1698655;1545781;1723392;186239;186239;786432;1884894;1732020;2509824
824129,210;301056;144891;325632;1397599;1397599;1397760;1698655;1542490;1723392;186277;186225;786432;1884932;1728715;2509824
824379,105;301056;150833;325632;1397599;1397599;1397760;1698655;1548432;1723392;186515;186515;786432;1885170;1734947;2509824
824563,647;301056;148342;325632;1397599;1397599;1397760;1698655;1545941;1723392;186515;186396;786432;1885170;1732337;2509824
824622,679;301056;146665;325632;1397599;1397599;1397760;1698655;1544264;1723392;186452;186452;786432;1885107;1730716;2509824
824637,394;301056;149344;325632;1397599;1397600;1397760;1698655;1546944;1723392;186461;186461;786432;1885116;1733405;2509824
824645,722;301056;146321;325632;1397599;1397600;1397760;1698655;1543921;1723392;186514;186514;786432;1885169;1730435;2509824
824744,511;301056;146328;325632;1397599;1397600;1397760;1698655;1543928;1723392;186531;186531;786432;1885186;1730459;2509824
824825,697;301056;147495;325632;1397599;1397599;1397760;1698655;1545094;1723392;186744;186692;786432;1885399;1731786;2509824
824842,339;301056;148193;325632;1397599;1397599;1397760;1698655;1545792;1723392;186884;186716;786432;1885539;1732508;2509824
824876,380;301056;149250;325632;1397599;1397599;1397760;1698655;1546849;1723392;186719;186603;786432;1885374;1733452;2509824
824906,103;301056;147320;325632;1397599;1397599;1397760;1698655;1544919;1723392;186603;186603;786432;1885258;1731522;2509824
824941,309;301056;148909;325632;1397599;1397600;1397760;1698655;1546509;1723392;186603;186603;786432;1885258;1733112;2509824
824955,697;301056;148127;325632;1397599;1397599;1397760;1698655;1545726;1723392;186726;186674;786432;1885381;1732400;2509824
824966,114;301056;148683;325632;1397599;1397600;1397760;1698655;1546283;1723392;186747;186747;786432;1885402;1733030;2509824
825021,622;301056;148394;325632;1397599;1397600;1397760;1698655;1545994;1723392;186749;186633;786432;1885404;1732627;2509824
825065,762;301056;148894;325632;1397599;1397600;1397760;1698655;1546494;1723392;186633;186633;786432;1885288;1733127;2509824
825774,345;301056;146750;325632;1397599;1397599;1397760;1698655;1544349;1723392;186633;186630;786432;1885288;1730979;2509824
825993,611;301055;149182;325632;1397600;1397600;1397760;1698655;1546782;1723392;186638;186436;786432;1885293;1733218;2509824
826239,699;301034;149578;325632;1397599;1397599;1397760;1698633;1547177;1723392;186442;186442;786432;1885075;1733619;2509824
826252,225;301056;146495;325632;1397599;1397599;1397760;1698655;1544094;1723392;186459;186459;786432;1885114;1730553;2509824
826274,760;301056;146570;325632;1397599;1397599;1397760;1698655;1544169;1723392;186471;186471;786432;1885126;1730640;2509824
826311,236;301056;145607;325632;1397599;1397600;1397760;1698655;1543207;1723392;186490;186490;786432;1885145;1729697;2509824
826682,802;301056;150252;325632;1397599;1397599;1397760;1698655;1547851;1723392;186698;186647;786432;1885353;1734498;2509824
826768,243;301056;146044;325632;1397599;1397600;1397760;1698655;1543644;1723392;186647;186461;786432;1885302;1730105;2509824
826998,345;301056;146700;325632;1397599;1397600;1397760;1698655;1544300;1723392;186628;186577;786432;1885283;1730877;2509824
827048,236;301056;148992;325632;1397599;1397600;1397760;1698655;1546592;1723392;186587;186460;786432;1885242;1733052;2509824
827068,768;301056;150669;325632;1397599;1397599;1397760;1698655;1548268;1723392;186460;186460;786432;1885115;1734728;2509824
827102,458;300685;148476;325632;1397600;1397599;1397760;1698285;1546075;1723392;186515;186515;786432;1884800;1732590;2509824
827128,533;301056;149475;325632;1397599;1397599;1397760;1698655;1547074;1723392;186613;186613;786432;1885268;1733687;2509824
827222,344;301056;148224;325632;1397599;1397600;1397760;1698655;1545824;1723392;186613;186613;786432;1885268;1732437;2509824
827479,191;301056;150337;325632;1397599;1397599;1397760;1698655;1547936;1723392;186616;186616;786432;1885271;1734552;2509824
828027,990;301056;148537;325632;1397599;1397599;1397760;1698655;1546136;1723392;186616;186616;786432;1885271;1732752;2509824
829028,276;301056;144835;325632;1397599;1397600;1397760;1698655;1542435;1723392;186631;185560;786432;1885286;1727995;2509824
829072,611;301056;146885;325632;1397599;1397599;1397760;1698655;1544484;1723392;185950;185844;786432;1884605;1730328;2509824
829133,300;301056;147233;325632;1397599;1397600;1397760;1698655;1544833;1723392;185863;185863;786432;1884518;1730696;2509824
829457,670;301056;146255;325632;1397599;1397599;1397760;1698655;1543854;1723392;186021;186021;786432;1884676;1729875;2509824
829532,292;301051;148518;325632;1397600;1397600;1397760;1698651;1546118;1723392;186051;186051;786432;1884702;1732169;2509824
829587,102;301056;150933;325632;1397599;1397600;1397760;1698655;1548533;1723392;186247;186247;786432;1884902;1734780;2509824
830010,948;301056;149860;325632;1397599;1397599;1397760;1698655;1547459;1723392;186301;186301;786432;1884956;1733760;2509824
830030,799;301056;148572;325632;1397599;1397600;1397760;1698655;1546172;1723392;186396;186396;786432;1885051;1732568;2509824
830331,230;301056;153051;325632;1397599;1397600;1397760;1698655;1550651;1723392;186402;186402;786432;1885057;1737053;2509824
830434,876;301056;150543;325632;1397599;1397599;1397760;1698655;1548142;1723392;186411;186411;786432;1885066;1734553;2509824
830554,705;301056;148427;325632;1397599;1397599;1397760;1698655;1546026;1723392;186413;186413;786432;1885068;1732439;2509824
831251,270;301056;147757;325632;1397599;1397599;1397760;1698655;1545356;1723392;186418;186418;786432;1885073;1731774;2509824
831358,956;301056;146871;325632;1397599;1397599;1397760;1698655;1544470;1723392;186522;186275;786432;1885177;1730745;2509824
831541,017;301056;146985;325632;1397599;1397600;1397760;1698655;1544585;1723392;186353;186353;786432;1885008;1730938;2509824
831584,996;301056;147687;325632;1397599;1397600;1397760;1698655;1545287;1723392;186356;186356;786432;1885011;1731643;2509824
831696,484;301056;149275;325632;1397599;1397599;1397760;1698655;1546874;1723392;186454;186454;786432;1885109;1733328;2509824
831721,606;300764;151166;325632;1397600;1397600;1397760;1698364;1548766;1723392;186565;186565;786432;1884929;1735331;2509824
831738,096;301056;153614;325632;1397599;1397599;1397760;1698655;1551213;1723392;186580;186580;786432;1885235;1737793;2509824
831775,699;301056;149665;325632;1397599;1397599;1397760;1698655;1547264;1723392;186581;186581;786432;1885236;1733845;2509824
832012,722;301056;149965;325632;1397599;1397599;1397760;1698655;1547564;1723392;186581;186581;786432;1885236;1734145;2509824
832085,585;301056;152995;325632;1397599;1397600;1397760;1698655;1550595;1723392;186591;186591;786432;1885246;1737186;2509824
832273,612;301056;151173;325632;1397599;1397599;1397760;1698655;1548772;1723392;186591;186591;786432;1885246;1735363;2509824
832324,209;301056;152106;325632;1397599;1397599;1397760;1698655;1549705;1723392;186602;186602;786432;1885257;1736307;2509824
832442,239;301056;152974;325632;1397599;1397599;1397760;1698655;1550573;1723392;186605;186605;786432;1885260;1737178;2509824
832480,250;301032;152365;325632;1397599;1397599;1397760;1698631;1549964;1723392;186608;186608;786432;1885239;1736572;2509824
832527,065;301056;152921;325632;1397599;1397599;1397760;1698655;1550520;1723392;186608;186608;786432;1885263;1737128;2509824
832682,881;301056;153721;325632;1397599;1397600;1397760;1698655;1551321;1723392;186609;186609;786432;1885264;1737930;2509824
832843,679;301056;152954;325632;1397599;1397599;1397760;1698655;1550553;1723392;186609;186597;786432;1885264;1737150;2509824
833055,539;301056;152744;325632;1397599;1397599;1397760;1698655;1550343;1723392;186599;186596;786432;1885254;1736939;2509824
833114,777;301056;153652;325632;1397599;1397600;1397760;1698655;1551252;1723392;186596;186596;786432;1885251;1737848;2509824
833158,005;301056;151798;325632;1397599;1397599;1397760;1698655;1549397;1723392;186596;186596;786432;1885251;1735993;2509824
833233,872;301056;153836;325632;1397599;1397600;1397760;1698655;1551436;1723392;186599;186599;786432;1885254;1738035;2509824
833493,278;301056;154869;325632;1397599;1397599;1397760;1698655;1552468;1723392;186599;186590;786432;1885254;1739058;2509824
833613,393;301056;152748;325632;1397599;1397600;1397760;1698655;1550348;1723392;186605;186605;786432;1885260;1736953;2509824
833651,241;301056;154403;325632;1397599;1397599;1397760;1698655;1552002;1723392;186605;186605;786432;1885260;1738607;2509824
833666,598;301056;154996;325632;1397599;1397599;1397760;1698655;1552595;1723392;186605;186605;786432;1885260;1739200;2509824
833684,308;301056;158497;325632;1397599;1397599;1397760;1698655;1556096;1723392;186807;186755;786432;1885462;1742851;2509824
834040,998;301056;155782;325632;1397599;1397599;1397760;1698655;1553381;1723392;186755;186639;786432;1885410;1740020;2509824
834638,749;301056;155722;325632;1397599;1397599;1397760;1698655;1553321;1723392;186645;186642;786432;1885300;1739963;2509824
834678,883;301056;153808;325632;1397599;1397599;1397760;1698655;1551407;1723392;186642;186320;786432;1885297;1737727;2509824
835178,638;300985;151418;325632;1397599;1397600;1397760;1698584;1549018;1723392;186395;186395;786432;1884979;1735413;2509824
835242,253;301056;151362;325632;1397599;1397599;1397760;1698655;1548961;1723392;186458;186458;786432;1885113;1735419;2509824
835327,018;301056;152997;325632;1397599;1397599;1397760;1698655;1550596;1723392;186563;186557;786432;1885218;1737153;2509824
835510,069;301056;151687;325632;1397599;1397599;1397760;1698655;1549286;1723392;186557;186557;786432;1885212;1735843;2509824
835910,172;300981;156434;325632;1397760;1397759;1397760;1698741;1554193;1723392;186742;186688;786432;1885483;1740881;2509824
836227,993;301056;154401;325632;1397759;1397600;1397760;1698815;1552001;1723392;186716;186517;786432;1885531;1738518;2509824
836256,205;301056;154705;325632;1397600;1397600;1397760;1698656;1552305;1723392;186517;186517;786432;1885173;1738822;2509824
836593,608;301056;154558;325632;1397599;1397599;1397760;1698655;1552157;1723392;186533;186533;786432;1885188;1738690;2509824
836671,534;301056;156246;325632;1397599;1397600;1397760;1698655;1553846;1723392;186611;186608;786432;1885266;1740454;2509824
837125,436;301029;152945;325632;1397600;1397600;1397760;1698629;1550545;1723392;186614;186608;786432;1885243;1737153;2509824
837140,264;301056;157663;325632;1397599;1397599;1397760;1698655;1555262;1723392;186612;186412;786432;1885267;1741674;2509824
837215,928;301056;152448;325632;1397599;1397599;1397760;1698655;1550047;1723392;186490;186472;786432;1885145;1736519;2509824
837307,152;301056;158115;325632;1397599;1397600;1397760;1698655;1555715;1723392;186649;186515;786432;1885304;1742230;2509824
837363,591;301056;156056;325632;1397599;1397600;1397760;1698655;1553656;1723392;186530;186414;786432;1885185;1740070;2509824
837384,947;301056;159544;325632;1397599;1397599;1397760;1698655;1557143;1723392;186414;186414;786432;1885069;1743557;2509824
837410,525;301056;155439;325632;1397599;1397598;1397760;1698655;1553037;1723392;186453;186453;786432;1885108;1739490;2509824
837431,839;301056;155859;325632;1397598;1397596;1397760;1698654;1553455;1723392;186498;186498;786432;1885152;1739953;2509824
837444,935;301056;158301;325632;1397596;1397596;1397760;1698652;1555897;1723392;186508;186508;786432;1885160;1742405;2509824
837453,896;301056;157500;325632;1397596;1397596;1397760;1698652;1555096;1723392;186560;186560;786432;1885212;1741656;2509824
837475,532;301030;161612;325632;1397597;1397597;1397760;1698627;1559209;1723392;186607;186607;786432;1885234;1745816;2509824
837487,374;301056;159560;325632;1397596;1397597;1397760;1698652;1557157;1723392;186613;186613;786432;1885265;1743770;2509824
837576,176;301056;157415;325632;1397596;1397596;1397760;1698652;1555011;1723392;186613;186613;786432;1885265;1741624;2509824
837744,014;301056;157371;325632;1397596;1397596;1397760;1698652;1554967;1723392;186686;186686;786432;1885338;1741653;2509824
837757,360;301056;160950;325632;1397596;1397597;1397760;1698652;1558547;1723392;186686;186686;786432;1885338;1745233;2509824
837779,922;301056;158350;325632;1397596;1397596;1397760;1698652;1555946;1723392;186693;186693;786432;1885345;1742639;2509824
837805,998;301056;160197;325632;1397596;1397596;1397760;1698652;1557793;1723392;186693;186693;786432;1885345;1744486;2509824
837849,052;301056;160715;325632;1397596;1397596;1397760;1698652;1558311;1723392;186693;186693;786432;1885345;1745004;2509824
837871,898;301056;159468;325632;1397596;1397596;1397760;1698652;1557064;1723392;186698;186698;786432;1885350;1743762;2509824
837994,690;301056;160341;325632;1397596;1397596;1397760;1698652;1557937;1723392;186698;186698;786432;1885350;1744635;2509824
838474,785;301056;159932;325632;1397596;1397596;1397760;1698652;1557528;1723392;186715;186706;786432;1885367;1744234;2509824
838825,444;301056;160761;325632;1397596;1397596;1397760;1698652;1558357;1723392;186719;186719;786432;1885371;1745076;2509824
838865,377;301056;157961;325632;1397596;1397596;1397760;1698652;1555557;1723392;186719;186649;786432;1885371;1742206;2509824
838929,579;301056;161499;325632;1397596;1397597;1397760;1698652;1559096;1723392;186819;186768;786432;1885471;1745864;2509824
839018,355;301028;156962;325632;1397596;1397596;1397760;1698624;1554558;1723392;186771;186655;786432;1885395;1741213;2509824
839054,611;301056;160083;325632;1397596;1397596;1397760;1698652;1557679;1723392;186661;186652;786432;1885313;1744331;2509824
839099,211;301056;158738;325632;1397596;1397596;1397760;1698652;1556334;1723392;186823;186823;786432;1885475;1743157;2509824
839153,159;301056;156986;325632;1397596;1397596;1397760;1698652;1554582;1723392;186833;186717;786432;1885485;1741299;2509824
839279,352;301056;155737;325632;1397596;1397597;1397760;1698652;1553334;1723392;186717;186717;786432;1885369;1740051;2509824
839320,103;301056;158781;325632;1397596;1397596;1397760;1698652;1556377;1723392;186887;186835;786432;1885539;1743212;2509824
839471,601;301056;155585;325632;1397596;1397596;1397760;1698652;1553181;1723392;186835;186719;786432;1885487;1739900;2509824
839504,367;301056;157123;325632;1397596;1397596;1397760;1698652;1554719;1723392;186893;186893;786432;1885545;1741612;2509824
839619,830;301056;156786;325632;1397596;1397596;1397760;1698652;1554382;1723392;186946;186830;786432;1885598;1741212;2509824
839812,178;301056;157191;325632;1397596;1397596;1397760;1698652;1554787;1723392;186998;186928;786432;1885650;1741715;2509824
839852,470;301056;159756;325632;1397596;1397596;1397760;1698652;1557352;1723392;186946;186830;786432;1885598;1744182;2509824
839890,776;301024;159445;325632;1397596;1397596;1397760;1698620;1557041;1723392;186830;186830;786432;1885450;1743871;2509824
840060,458;301056;157789;325632;1397596;1397596;1397760;1698652;1555385;1723392;186830;186830;786432;1885482;1742215;2509824
840155,043;301056;158858;325632;1397596;1397596;1397760;1698652;1556454;1723392;186997;186946;786432;1885649;1743400;2509824
840344,082;301056;160963;325632;1397596;1397596;1397760;1698652;1558559;1723392;186953;186837;786432;1885605;1745396;2509824
840392,831;301056;161582;325632;1397595;1397596;1397760;1698651;1559178;1723392;186840;186840;786432;1885491;1746018;2509824
840536,950;301056;160857;325632;1397595;1397596;1397760;1698651;1558453;1723392;186847;186847;786432;1885498;1745300;2509824
840555,099;301056;160935;325632;1397595;1397596;1397760;1698651;1558531;1723392;186850;186850;786432;1885501;1745381;2509824
840565,230;301056;160896;325632;1397595;1397596;1397760;1698651;1558492;1723392;186850;186850;786432;1885501;1745342;2509824
840580,057;301056;159536;325632;1397595;1397595;1397760;1698651;1557131;1723392;186850;186850;786432;1885501;1743981;2509824
840694,319;301056;162486;325632;1397595;1397596;1397760;1698651;1560082;1723392;186850;186850;786432;1885501;1746932;2509824
840729,997;301056;161746;325632;1397595;1397596;1397760;1698651;1559342;1723392;186881;186881;786432;1885532;1746223;2509824
840800,049;301056;161203;325632;1397595;1397596;1397760;1698651;1558799;1723392;186881;186881;786432;1885532;1745680;2509824
840807,612;301056;161333;325632;1397595;1397595;1397760;1698651;1558928;1723392;186881;186881;786432;1885532;1745809;2509824
840898,232;301056;163641;325632;1397595;1397595;1397760;1698651;1561236;1723392;186886;186883;786432;1885537;1748119;2509824
840925,879;301056;162019;325632;1397595;1397596;1397760;1698651;1559615;1723392;186883;186883;786432;1885534;1746498;2509824
841013,946;301056;162001;325632;1397595;1397595;1397760;1698651;1559596;1723392;186883;186883;786432;1885534;1746479;2509824
841180,611;301056;164712;325632;1397595;1397595;1397760;1698651;1562307;1723392;186883;186883;786432;1885534;1749190;2509824
841218,332;300865;164317;325632;1397595;1397596;1397760;1698460;1561913;1723392;186883;186883;786432;1885343;1748796;2509824
841310,563;301056;165940;325632;1397595;1397595;1397760;1698651;1563535;1723392;186883;186872;786432;1885534;1750407;2509824
841337,839;301056;165167;325632;1397595;1397595;1397760;1698651;1562762;1723392;186872;186872;786432;1885523;1749634;2509824
841352,878;301056;161373;325632;1397594;1397593;1397760;1698650;1558966;1723392;186872;186872;786432;1885522;1745838;2509824
841408,132;301056;163655;325632;1397593;1397593;1397760;1698649;1561248;1723392;186872;186872;786432;1885521;1748120;2509824
841722,095;301056;161991;325632;1397593;1397594;1397760;1698649;1559585;1723392;186872;186872;786432;1885521;1746457;2509824
841762,303;301056;164422;325632;1397593;1397594;1397760;1698649;1562016;1723392;186872;186869;786432;1885521;1748885;2509824
842059,495;301056;163597;325632;1397593;1397593;1397760;1698649;1561190;1723392;186872;186872;786432;1885521;1748062;2509824
842086,040;301056;163555;325632;1397593;1397594;1397760;1698649;1561149;1723392;186872;186862;786432;1885521;1748011;2509824
842243,402;301052;161737;325632;1397594;1397594;1397760;1698646;1559331;1723392;186872;186872;786432;1885518;1746203;2509824
842286,515;301056;163982;325632;1397593;1397594;1397760;1698649;1561576;1723392;186875;186875;786432;1885524;1748451;2509824
842293,966;301056;163941;325632;1397593;1397594;1397760;1698649;1561535;1723392;186878;186758;786432;1885527;1748293;2509824
842327,513;301056;166379;325632;1397593;1397593;1397760;1698649;1563972;1723392;186758;186758;786432;1885407;1750730;2509824
842388,907;301056;162657;325632;1397593;1397593;1397760;1698649;1560250;1723392;186758;186755;786432;1885407;1747005;2509824
842637,707;301056;165160;325632;1397593;1397594;1397760;1698649;1562754;1723392;186755;186755;786432;1885404;1749509;2509824
842662,303;301056;164004;325632;1397593;1397593;1397760;1698649;1561597;1723392;186761;186761;786432;1885410;1748358;2509824
842684,118;301056;164485;325632;1397593;1397592;1397760;1698649;1562077;1723392;186764;186764;786432;1885413;1748841;2509824
842793,660;301056;162922;325632;1397591;1397592;1397760;1698647;1560514;1723392;186764;186764;786432;1885411;1747278;2509824
842930,600;301056;164917;325632;1397591;1397591;1397760;1698647;1562508;1723392;186780;186780;786432;1885427;1749288;2509824
842971,675;301056;163677;325632;1397591;1397592;1397760;1698647;1561269;1723392;186780;186768;786432;1885427;1748037;2509824
843113,909;301056;163553;325632;1397591;1397592;1397760;1698647;1561145;1723392;186768;186768;786432;1885415;1747913;2509824
843145,145;301056;165663;325632;1397591;1397592;1397760;1698647;1563255;1723392;186776;186776;786432;1885423;1750031;2509824
843266,491;301056;165378;325632;1397591;1397592;1397760;1698647;1562970;1723392;186779;186779;786432;1885426;1749749;2509824
843299,309;301056;167543;325632;1397591;1397592;1397760;1698647;1565135;1723392;186779;186779;786432;1885426;1751914;2509824
843348,782;301056;165086;325632;1397591;1397592;1397760;1698647;1562678;1723392;186779;186779;786432;1885426;1749457;2509824
843477,432;301056;166623;325632;1397591;1397592;1397760;1698647;1564215;1723392;186782;186782;786432;1885429;1750997;2509824
843509,448;301056;167340;325632;1397591;1397592;1397760;1698647;1564932;1723392;186782;186782;786432;1885429;1751714;2509824
843552,105;301056;164722;325632;1397591;1397592;1397760;1698647;1562314;1723392;186787;186787;786432;1885434;1749101;2509824
843595,265;301056;165120;325632;1397591;1397592;1397760;1698647;1562712;1723392;186787;186787;786432;1885434;1749499;2509824
844029,193;301056;167725;325632;1397591;1397592;1397760;1698647;1565317;1723392;186956;186905;786432;1885603;1752222;2509824
844152,388;301056;166926;325632;1397591;1397592;1397760;1698647;1564518;1723392;186907;186792;786432;1885554;1751310;2509824
844166,296;301056;166345;325632;1397591;1397592;1397760;1698647;1563937;1723392;186792;186733;786432;1885439;1750670;2509824
844177,286;301056;164717;325632;1397591;1397592;1397760;1698647;1562309;1723392;186738;186738;786432;1885385;1749047;2509824
844190,342;301056;165110;325632;1397591;1397592;1397760;1698647;1562702;1723392;186738;186738;786432;1885385;1749440;2509824
844208,641;301056;165659;325632;1397591;1397592;1397760;1698647;1563251;1723392;186738;186738;786432;1885385;1749989;2509824
844221,020;301056;165790;325632;1397591;1397592;1397760;1698647;1563382;1723392;186747;186747;786432;1885394;1750129;2509824
844233,591;301056;166846;325632;1397591;1397592;1397760;1698647;1564438;1723392;186747;186747;786432;1885394;1751185;2509824
844247,895;301056;167947;325632;1397591;1397592;1397760;1698647;1565539;1723392;186747;186747;786432;1885394;1752286;2509824
844266,061;300982;168953;325632;1397592;1397592;1397760;1698574;1566545;1723392;186747;186747;786432;1885321;1753292;2509824
844299,427;300610;172057;325632;1397592;1397592;1397760;1698202;1569649;1723392;186782;186782;786432;1884984;1756431;2509824
844373,582;300786;169899;325632;1397592;1397592;1397760;1698378;1567491;1723392;186782;186782;786432;1885160;1754273;2509824
844412,333;301056;168581;325632;1397591;1397591;1397760;1698647;1566172;1723392;186785;186785;786432;1885432;1752957;2509824
844418,740;301056;168562;325632;1397591;1397592;1397760;1698647;1566154;1723392;186785;186785;786432;1885432;1752939;2509824
844447,448;301056;168605;325632;1397591;1397592;1397760;1698647;1566197;1723392;186814;186814;786432;1885461;1753011;2509824
844457,277;301056;169349;325632;1397591;1397592;1397760;1698647;1566941;1723392;186814;186814;786432;1885461;1753755;2509824
844506,888;301056;168419;325632;1397591;1397592;1397760;1698647;1566011;1723392;186814;186814;786432;1885461;1752825;2509824
844531,895;301056;168511;325632;1397591;1397592;1397760;1698647;1566103;1723392;186873;186873;786432;1885520;1752976;2509824
845021,683;301056;167262;325632;1397591;1397592;1397760;1698647;1564854;1723392;186879;186879;786432;1885526;1751733;2509824
845182,663;301056;169762;325632;1397591;1397591;1397760;1698647;1567353;1723392;186879;186871;786432;1885526;1754224;2509824
845214,201;301056;168112;325632;1397591;1397591;1397760;1698647;1565703;1723392;186891;186883;786432;1885538;1752586;2509824
845254,674;301056;169538;325632;1397591;1397591;1397760;1698647;1567129;1723392;186883;186883;786432;1885530;1754012;2509824
845313,172;301042;167551;325632;1397591;1397591;1397760;1698633;1565142;1723392;186883;186883;786432;1885516;1752025;2509824
845372,402;301056;169365;325632;1397591;1397591;1397760;1698647;1566956;1723392;186883;186883;786432;1885530;1753839;2509824
845420,948;301056;169070;325632;1397591;1397591;1397760;1698647;1566661;1723392;186883;186883;786432;1885530;1753544;2509824
845481,339;301056;173644;325632;1397591;1397592;1397760;1698647;1571236;1723392;187051;186999;786432;1885698;1758235;2509824
845499,149;301056;173225;325632;1397591;1397591;1397760;1698647;1570816;1723392;186999;186883;786432;1885646;1757699;2509824
845530,925;301056;166808;325632;1397591;1397592;1397760;1698647;1564400;1723392;186883;186883;786432;1885530;1751283;2509824
845571,801;301056;166793;325632;1397591;1397592;1397760;1698647;1564385;1723392;186883;186883;786432;1885530;1751268;2509824
845576,652;301056;173716;325632;1397591;1397592;1397760;1698647;1571308;1723392;186883;186883;786432;1885530;1758191;2509824
845731,704;301056;169310;325632;1397591;1397591;1397760;1698647;1566901;1723392;186883;186883;786432;1885530;1753784;2509824
846655,915;301036;165863;325632;1397591;1397591;1397760;1698627;1563454;1723392;186889;186875;786432;1885516;1750329;2509824
846763,745;301056;167089;325632;1397590;1397591;1397760;1698646;1564680;1723392;186875;186723;786432;1885521;1751403;2509824
846812,881;301056;163877;325632;1397590;1397591;1397760;1698646;1561468;1723392;186723;186723;786432;1885369;1748191;2509824
846893,315;301056;166579;325632;1397590;1397591;1397760;1698646;1564170;1723392;186729;186729;786432;1885375;1750899;2509824
846902,220;301056;164007;325632;1397590;1397591;1397760;1698646;1561598;1723392;186732;186732;786432;1885378;1748330;2509824
846915,582;301056;164058;325632;1397590;1397591;1397760;1698646;1561649;1723392;186732;186732;786432;1885378;1748381;2509824
846935,796;301056;166587;325632;1397590;1397591;1397760;1698646;1564178;1723392;186776;186776;786432;1885422;1750954;2509824
846961,537;301048;166334;325632;1397591;1397591;1397760;1698639;1563925;1723392;186779;186779;786432;1885418;1750704;2509824
847049,867;301056;167501;325632;1397590;1397591;1397760;1698646;1565092;1723392;186785;186785;786432;1885431;1751877;2509824
847099,315;301051;167372;325632;1397591;1397591;1397760;1698642;1564963;1723392;186790;186790;786432;1885432;1751753;2509824
847140,150;301056;167665;325632;1397590;1397591;1397760;1698646;1565256;1723392;186790;186790;786432;1885436;1752046;2509824
847184,049;301056;169716;325632;1397590;1397591;1397760;1698646;1567307;1723392;186830;186830;786432;1885476;1754137;2509824
847215,761;301056;170181;325632;1397590;1397591;1397760;1698646;1567772;1723392;186838;186838;786432;1885484;1754610;2509824
847262,809;301056;172114;325632;1397590;1397591;1397760;1698646;1569705;1723392;186838;186838;786432;1885484;1756543;2509824
847293,695;301056;167759;325632;1397590;1397591;1397760;1698646;1565350;1723392;186838;186838;786432;1885484;1752188;2509824
847378,703;301051;168820;325632;1397591;1397591;1397760;1698642;1566411;1723392;186838;186838;786432;1885480;1753249;2509824
847420,082;301056;167955;325632;1397590;1397591;1397760;1698646;1565546;1723392;186838;186838;786432;1885484;1752384;2509824
847492,874;301056;169278;325632;1397590;1397591;1397760;1698646;1566869;1723392;186851;186851;786432;1885497;1753720;2509824
847643,353;301056;168092;325632;1397590;1397591;1397760;1698646;1565683;1723392;186851;186848;786432;1885497;1752531;2509824
847678,595;301056;168977;325632;1397590;1397591;1397760;1698646;1566568;1723392;186853;186853;786432;1885499;1753421;2509824
847802,885;301056;168594;325632;1397590;1397590;1397760;1698646;1566184;1723392;186853;186853;786432;1885499;1753037;2509824
848184,554;300954;168815;325632;1397591;1397591;1397760;1698545;1566406;1723392;186856;186622;786432;1885401;1753028;2509824
848211,175;301056;169747;325632;1397590;1397591;1397760;1698646;1567338;1723392;186686;186680;786432;1885332;1754018;2509824
848234,338;301056;168035;325632;1397590;1397591;1397760;1698646;1565626;1723392;186680;186680;786432;1885326;1752306;2509824
848251,101;301056;169745;325632;1397590;1397591;1397760;1698646;1567336;1723392;186785;186785;786432;1885431;1754121;2509824
848283,855;301056;168745;325632;1397590;1397591;1397760;1698646;1566336;1723392;186785;186785;786432;1885431;1753121;2509824
848301,156;301056;170564;325632;1397590;1397591;1397760;1698646;1568155;1723392;186800;186800;786432;1885446;1754955;2509824
848361,043;301056;172443;325632;1397590;1397591;1397760;1698646;1570034;1723392;186800;186800;786432;1885446;1756834;2509824
848397,857;301056;170715;325632;1397590;1397591;1397760;1698646;1568306;1723392;186800;186779;786432;1885446;1755085;2509824
848470,806;301056;167854;325632;1397590;1397591;1397760;1698646;1565445;1723392;186788;186788;786432;1885434;1752233;2509824
848545,320;301056;169805;325632;1397590;1397591;1397760;1698646;1567396;1723392;186788;186788;786432;1885434;1754184;2509824
848602,492;301056;170444;325632;1397590;1397591;1397760;1698646;1568035;1723392;186788;186788;786432;1885434;1754823;2509824
848651,132;301056;168467;325632;1397590;1397591;1397760;1698646;1566058;1723392;186789;186789;786432;1885435;1752847;2509824
849128,251;301056;168156;325632;1397590;1397591;1397760;1698646;1565747;1723392;186792;186789;786432;1885438;1752536;2509824
849670,420;301056;168240;325632;1397590;1397591;1397760;1698646;1565831;1723392;186792;186565;786432;1885438;1752396;2509824
849675,767;301056;170637;325632;1397590;1397590;1397760;1698646;1568227;1723392;186762;186090;786432;1885408;1754317;2509824
849680,626;301056;173434;325632;1397589;1397590;1397760;1698645;1571024;1723392;186105;186105;786432;1884750;1757129;2509824
849731,209;301056;168547;325632;1397589;1397590;1397760;1698645;1566137;1723392;186244;186244;786432;1884889;1752381;2509824
849748,261;301056;170871;325632;1397589;1397589;1397760;1698645;1568460;1723392;186259;186259;786432;1884904;1754719;2509824
849761,803;300898;170259;325632;1397590;1397590;1397760;1698488;1567849;1723392;186321;186321;786432;1884809;1754170;2509824
849776,257;301056;173975;325632;1397589;1397589;1397760;1698645;1571564;1723392;186326;186326;786432;1884971;1757890;2509824
849795,433;301056;168986;325632;1397589;1397589;1397760;1698645;1566575;1723392;186342;186342;786432;1884987;1752917;2509824
850087,712;301056;170637;325632;1397589;1397590;1397760;1698645;1568227;1723392;186389;186389;786432;1885034;1754616;2509824
850135,206;301056;171392;325632;1397589;1397589;1397760;1698645;1568981;1723392;186504;186504;786432;1885149;1755485;2509824
850179,792;301056;173345;325632;1397589;1397590;1397760;1698645;1570935;1723392;186563;186563;786432;1885208;1757498;2509824
850190,319;301056;170471;325632;1397589;1397589;1397760;1698645;1568060;1723392;186614;186614;786432;1885259;1754674;2509824
850202,015;301056;171395;325632;1397589;1397589;1397760;1698645;1568984;1723392;186614;186614;786432;1885259;1755598;2509824
850222,247;301056;177724;325632;1397589;1397589;1397760;1698645;1575313;1723392;186785;186733;786432;1885430;1762046;2509824
850258,142;301056;172249;325632;1397589;1397589;1397760;1698645;1569838;1723392;186736;186620;786432;1885381;1756458;2509824
850279,831;301056;170895;325632;1397589;1397590;1397760;1698645;1568485;1723392;186631;186631;786432;1885276;1755116;2509824
850287,776;301056;171307;325632;1397589;1397589;1397760;1698645;1568896;1723392;186725;186725;786432;1885370;1755621;2509824
850307,299;301056;172681;325632;1397589;1397590;1397760;1698645;1570271;1723392;186757;186757;786432;1885402;1757028;2509824
850321,861;301056;171836;325632;1397589;1397590;1397760;1698645;1569426;1723392;186762;186762;786432;1885407;1756188;2509824
850348,999;301056;171757;325632;1397589;1397590;1397760;1698645;1569347;1723392;186762;186762;786432;1885407;1756109;2509824
850372,246;301056;172074;325632;1397589;1397589;1397760;1698645;1569663;1723392;186767;186767;786432;1885412;1756430;2509824
850396,723;301056;172426;325632;1397589;1397590;1397760;1698645;1570016;1723392;186767;186767;786432;1885412;1756783;2509824
850402,261;301056;173925;325632;1397589;1397589;1397760;1698645;1571514;1723392;186770;186770;786432;1885415;1758284;2509824
850428,851;301056;172880;325632;1397589;1397589;1397760;1698645;1570469;1723392;186780;186780;786432;1885425;1757249;2509824
850509,267;301056;175443;325632;1397589;1397590;1397760;1698645;1573033;1723392;186789;186789;786432;1885434;1759822;2509824
850551,126;301056;174078;325632;1397589;1397589;1397760;1698645;1571667;1723392;186956;186904;786432;1885601;1758571;2509824
850565,392;301056;173829;325632;1397589;1397589;1397760;1698645;1571418;1723392;186951;186835;786432;1885596;1758253;2509824
850601,711;301056;174532;325632;1397589;1397590;1397760;1698645;1572122;1723392;186836;186836;786432;1885481;1758958;2509824
850605,150;206652;179479;325632;1397589;1397585;1397760;1604241;1577064;1723392;186836;186833;786432;1791077;1763897;2509824
850665,365;301056;174404;325632;1397584;1397584;1397760;1698640;1571988;1723392;186835;186835;786432;1885475;1758823;2509824
850684,744;301056;174044;325632;1397584;1397585;1397760;1698640;1571629;1723392;186835;186835;786432;1885475;1758464;2509824
850821,635;301056;176384;325632;1397584;1397584;1397760;1698640;1573968;1723392;186839;186839;786432;1885479;1760807;2509824
850869,638;301056;177639;325632;1397584;1397585;1397760;1698640;1575224;1723392;186840;186840;786432;1885480;1762064;2509824
850956,672;301056;176921;325632;1397584;1397585;1397760;1698640;1574506;1723392;186840;186840;786432;1885480;1761346;2509824
850988,397;301056;177288;325632;1397584;1397585;1397760;1698640;1574873;1723392;186853;186853;786432;1885493;1761726;2509824
851374,383;301056;175614;325632;1397584;1397584;1397760;1698640;1573198;1723392;186857;186857;786432;1885497;1760055;2509824
851952,909;300990;172381;325632;1397585;1397585;1397760;1698575;1569966;1723392;186863;186835;786432;1885438;1756801;2509824
852053,790;301056;175766;325632;1397584;1397585;1397760;1698640;1573351;1723392;186843;186713;786432;1885483;1760064;2509824
852068,571;301019;175645;325632;1397584;1397585;1397760;1698603;1573230;1723392;186713;186713;786432;1885316;1759943;2509824
852081,494;301056;172938;325632;1397584;1397584;1397760;1698640;1570522;1723392;186713;186713;786432;1885353;1757235;2509824
852088,466;301056;172304;325632;1397584;1397584;1397760;1698640;1569888;1723392;186713;186713;786432;1885353;1756601;2509824
852097,017;301056;173055;325632;1397584;1397585;1397760;1698640;1570640;1723392;186748;186748;786432;1885388;1757388;2509824
852104,012;301056;172838;325632;1397584;1397584;1397760;1698640;1570422;1723392;186748;186748;786432;1885388;1757170;2509824
852118,587;301056;174953;325632;1397584;1397584;1397760;1698640;1572537;1723392;186748;186748;786432;1885388;1759285;2509824
852125,417;301056;175153;325632;1397584;1397585;1397760;1698640;1572738;1723392;186748;186748;786432;1885388;1759486;2509824
852135,398;301056;173531;325632;1397584;1397584;1397760;1698640;1571115;1723392;186748;186748;786432;1885388;1757863;2509824
852149,816;301056;174147;325632;1397584;1397585;1397760;1698640;1571732;1723392;186748;186748;786432;1885388;1758480;2509824
852161,512;301056;174334;325632;1397584;1397584;1397760;1698640;1571918;1723392;186748;186748;786432;1885388;1758666;2509824
852183,442;301056;174855;325632;1397584;1397585;1397760;1698640;1572440;1723392;186758;186758;786432;1885398;1759198;2509824
852208,153;301056;179578;325632;1397584;1397585;1397760;1698640;1577163;1723392;186926;186874;786432;1885566;1764037;2509824
852269,527;301056;175016;325632;1397584;1397584;1397760;1698640;1572600;1723392;186877;186761;786432;1885517;1759361;2509824
852426,556;301047;175722;325632;1397585;1397584;1397760;1698632;1573306;1723392;186767;186767;786432;1885399;1760073;2509824
852485,595;301056;175484;325632;1397584;1397585;1397760;1698640;1573069;1723392;186767;186767;786432;1885407;1759836;2509824
852500,001;301056;175277;325632;1397584;1397585;1397760;1698640;1572862;1723392;186767;186767;786432;1885407;1759629;2509824
853075,588;301056;173676;325632;1397584;1397316;1397760;1698640;1570992;1723392;186934;186883;786432;1885574;1757875;2509824
853093,465;301056;175957;325632;1397315;1397315;1397760;1698371;1573272;1723392;186886;186591;786432;1885257;1759863;2509824
853202,242;301056;173120;325632;1397315;1397316;1397760;1698371;1570436;1723392;186594;186594;786432;1884965;1757030;2509824
853446,611;301056;174081;325632;1397315;1397316;1397760;1698371;1571397;1723392;186639;186639;786432;1885010;1758036;2509824
854213,803;301056;172269;325632;1397315;1397316;1397760;1698371;1569585;1723392;186657;186657;786432;1885028;1756242;2509824
854573,898;301056;172378;325632;1397315;1397316;1397760;1698371;1569694;1723392;186663;186199;786432;1885034;1755893;2509824
854710,186;301056;173339;325632;1397315;1397316;1397760;1698371;1570655;1723392;186207;186207;786432;1884578;1756862;2509824
854801,687;301056;172591;325632;1397315;1397316;1397760;1698371;1569907;1723392;186230;186230;786432;1884601;1756137;2509824
854912,890;301056;173052;325632;1397315;1397315;1397760;1698371;1570367;1723392;186311;186306;786432;1884682;1756673;2509824
855466,999;301056;173136;325632;1397315;1397316;1397760;1698371;1570452;1723392;186312;186309;786432;1884683;1756761;2509824
855553,984;301056;174614;325632;1397315;1397315;1397760;1698371;1571929;1723392;186326;186196;786432;1884697;1758125;2509824
855993,691;301056;171878;325632;1397315;1397315;1397760;1698371;1569193;1723392;186289;186289;786432;1884660;1755482;2509824
856159,027;301056;173898;325632;1397315;1397316;1397760;1698371;1571214;1723392;186325;186325;786432;1884696;1757539;2509824
856233,294;301056;171403;325632;1397315;1397315;1397760;1698371;1568718;1723392;186355;186355;786432;1884726;1755073;2509824
856270,781;301056;173809;325632;1397315;1397316;1397760;1698371;1571125;1723392;186368;186368;786432;1884739;1757493;2509824
856288,239;301056;172566;325632;1397315;1397315;1397760;1698371;1569881;1723392;186464;186464;786432;1884835;1756345;2509824
856298,622;301056;172468;325632;1397315;1397316;1397760;1698371;1569784;1723392;186485;186485;786432;1884856;1756269;2509824
856425,326;301056;172385;325632;1397315;1397315;1397760;1698371;1569700;1723392;186516;186516;786432;1884887;1756216;2509824
856569,311;301056;175919;325632;1397315;1397315;1397760;1698371;1573234;1723392;186522;186522;786432;1884893;1759756;2509824
856581,869;301056;175345;325632;1397315;1397316;1397760;1698371;1572661;1723392;186525;186525;786432;1884896;1759186;2509824
856625,606;301056;174139;325632;1397315;1397316;1397760;1698371;1571455;1723392;186561;186561;786432;1884932;1758016;2509824
856646,679;301056;173934;325632;1397315;1397316;1397760;1698371;1571250;1723392;186677;186677;786432;1885048;1757927;2509824
856669,769;301056;174358;325632;1397315;1397316;1397760;1698371;1571674;1723392;186729;186729;786432;1885100;1758403;2509824
856785,342;301056;176481;325632;1397315;1397316;1397760;1698371;1573797;1723392;186729;186729;786432;1885100;1760526;2509824
856984,028;300718;176858;325632;1397316;1397316;1397760;1698034;1574174;1723392;186730;186730;786432;1884764;1760904;2509824
857140,038;301056;176648;325632;1397315;1397315;1397760;1698371;1573963;1723392;186730;186730;786432;1885101;1760693;2509824
857235,753;301056;179951;325632;1397315;1397316;1397760;1698371;1577267;1723392;186747;186747;786432;1885118;1764014;2509824
857480,605;301056;176297;325632;1397315;1397315;1397760;1698371;1573612;1723392;186747;186747;786432;1885118;1760359;2509824
857567,991;301056;178470;325632;1397315;1397316;1397760;1698371;1575786;1723392;186797;186797;786432;1885168;1762583;2509824
857710,546;301056;179232;325632;1397315;1397316;1397760;1698371;1576548;1723392;186803;186699;786432;1885174;1763247;2509824
857770,972;239751;181578;325632;1397315;1397301;1397760;1637066;1578879;1723392;186702;186702;786432;1823768;1765581;2509824
857849,258;301056;177072;325632;1397301;1397301;1397760;1698357;1574373;1723392;186708;186708;786432;1885065;1761081;2509824
857915,140;301056;176589;325632;1397301;1397302;1397760;1698357;1573891;1723392;186713;186713;786432;1885070;1760604;2509824
857923,651;300697;179267;325632;1397302;1397301;1397760;1697999;1576568;1723392;186713;186713;786432;1884712;1763281;2509824
857961,507;301056;177472;325632;1397301;1397302;1397760;1698357;1574774;1723392;186713;186713;786432;1885070;1761487;2509824
857982,539;301056;177214;325632;1397301;1397302;1397760;1698357;1574516;1723392;186720;186720;786432;1885077;1761236;2509824
858008,850;301056;175432;325632;1397301;1397302;1397760;1698357;1572734;1723392;186769;186769;786432;1885126;1759503;2509824
858041,540;301056;175767;325632;1397301;1397302;1397760;1698357;1573069;1723392;186772;186772;786432;1885129;1759841;2509824
858053,633;301028;178489;325632;1397301;1397302;1397760;1698329;1575791;1723392;186772;186772;786432;1885101;1762563;2509824
858068,462;301056;178635;325632;1397301;1397302;1397760;1698357;1575937;1723392;186790;186790;786432;1885147;1762727;2509824
858087,553;301056;177029;325632;1397301;1397301;1397760;1698357;1574330;1723392;186790;186790;786432;1885147;1761120;2509824
858102,556;301046;178190;325632;1397301;1397302;1397760;1698347;1575492;1723392;186791;186791;786432;1885138;1762283;2509824
858121,849;301056;179179;325632;1397301;1397301;1397760;1698357;1576480;1723392;186836;186836;786432;1885193;1763316;2509824
858154,307;301056;177687;325632;1397301;1397301;1397760;1698357;1574988;1723392;186836;186836;786432;1885193;1761824;2509824
858197,287;301056;178674;325632;1397301;1397301;1397760;1698357;1575975;1723392;186836;186836;786432;1885193;1762811;2509824
858221,351;301056;180333;325632;1397301;1397301;1397760;1698357;1577634;1723392;186854;186854;786432;1885211;1764488;2509824
858237,988;301056;178322;325632;1397301;1397301;1397760;1698357;1575623;1723392;186854;186854;786432;1885211;1762477;2509824
858268,763;301056;177833;325632;1397301;1397302;1397760;1698357;1575135;1723392;186854;186854;786432;1885211;1761989;2509824
858393,703;301056;179433;325632;1397301;1397301;1397760;1698357;1576734;1723392;186854;186854;786432;1885211;1763588;2509824
858742,959;301056;180266;325632;1397301;1397301;1397760;1698357;1577567;1723392;186860;186860;786432;1885217;1764427;2509824
858753,031;301056;178460;325632;1397301;1397301;1397760;1698357;1575761;1723392;186876;186815;786432;1885233;1762576;2509824
858777,042;301056;178752;325632;1397301;1397302;1397760;1698357;1576054;1723392;186815;186815;786432;1885172;1762869;2509824
858794,919;301056;184467;325632;1397301;1397302;1397760;1698357;1581769;1723392;186989;186937;786432;1885346;1768706;2509824
858823,181;301056;181689;325632;1397301;1397300;1397760;1698357;1578989;1723392;186948;186832;786432;1885305;1765821;2509824
858857,184;301056;183054;325632;1397299;1397300;1397760;1698355;1580354;1723392;186864;186864;786432;1885219;1767218;2509824
858878,254;301056;181416;325632;1397299;1397300;1397760;1698355;1578716;1723392;186879;186879;786432;1885234;1765595;2509824
858894,700;301056;181070;325632;1397299;1397300;1397760;1698355;1578370;1723392;187049;186997;786432;1885404;1765367;2509824
858903,991;301056;180601;325632;1397299;1397300;1397760;1698355;1577901;1723392;186997;186881;786432;1885352;1764782;2509824
858932,161;301056;182755;325632;1397299;1397300;1397760;1698355;1580055;1723392;186881;186834;786432;1885236;1766889;2509824
858973,527;301056;182146;325632;1397299;1397300;1397760;1698355;1579446;1723392;186836;186836;786432;1885191;1766282;2509824
859311,997;301056;182533;325632;1397299;1397299;1397760;1698355;1579832;1723392;186878;186878;786432;1885233;1766710;2509824
859328,553;301056;184244;325632;1397299;1397300;1397760;1698355;1581544;1723392;186881;186881;786432;1885236;1768425;2509824
859362,876;301056;184919;325632;1397299;1397300;1397760;1698355;1582219;1723392;186884;186884;786432;1885239;1769103;2509824
859378,744;301056;181760;325632;1397299;1397300;1397760;1698355;1579060;1723392;186884;186848;786432;1885239;1765908;2509824
859388,415;301056;182059;325632;1397299;1397300;1397760;1698355;1579359;1723392;186848;186848;786432;1885203;1766207;2509824
859394,839;301056;181778;325632;1397299;1397299;1397760;1698355;1579077;1723392;186848;186848;786432;1885203;1765925;2509824
859398,537;301056;181590;325632;1397299;1397300;1397760;1698355;1578890;1723392;186849;186849;786432;1885204;1765739;2509824
859407,007;301056;183291;325632;1397299;1397300;1397760;1698355;1580591;1723392;186849;186849;786432;1885204;1767440;2509824
859414,277;301056;182066;325632;1397299;1397300;1397760;1698355;1579366;1723392;186850;186850;786432;1885205;1766216;2509824
859438,328;301056;182357;325632;1397299;1397299;1397760;1698355;1579656;1723392;186856;186856;786432;1885211;1766512;2509824
859452,389;301056;182693;325632;1397299;1397299;1397760;1698355;1579992;1723392;186856;186856;786432;1885211;1766848;2509824
859477,994;301056;185058;325632;1397299;1397300;1397760;1698355;1582358;1723392;186861;186861;786432;1885216;1769219;2509824
859492,546;301056;183075;325632;1397299;1397300;1397760;1698355;1580375;1723392;186861;186811;786432;1885216;1767186;2509824
859517,042;301056;180478;325632;1397299;1397300;1397760;1698355;1577778;1723392;186811;186811;786432;1885166;1764589;2509824
860166,708;301056;182810;325632;1397299;1397299;1397760;1698355;1580109;1723392;187028;186977;786432;1885383;1767086;2509824
860387,416;301056;180360;325632;1397299;1397299;1397760;1698355;1577659;1723392;187146;186625;786432;1885501;1764284;2509824
860433,575;301056;177901;325632;1397299;1397299;1397760;1698355;1575200;1723392;186635;186519;786432;1884990;1761719;2509824
860443,807;301056;178154;325632;1397299;1397299;1397760;1698355;1575453;1723392;186537;186537;786432;1884892;1761990;2509824
860447,532;301056;178375;325632;1397299;1397299;1397760;1698355;1575674;1723392;186598;186598;786432;1884953;1762272;2509824
860457,546;301056;179614;325632;1397496;1397462;1397760;1698552;1577076;1723392;186605;186605;786432;1885157;1763681;2509824
860485,326;301056;183846;325632;1397463;1397302;1397760;1698519;1581148;1723392;186773;186721;786432;1885292;1767869;2509824
860528,661;301056;180277;325632;1397301;1397300;1397760;1698357;1577577;1723392;186732;186616;786432;1885089;1764193;2509824
860604,139;301056;180289;325632;1397299;1397300;1397760;1698355;1577589;1723392;186667;186667;786432;1885022;1764256;2509824
860763,875;301037;181730;325632;1397299;1397299;1397760;1698336;1579029;1723392;186679;186679;786432;1885015;1765708;2509824
860815,981;301056;182650;325632;1397299;1397300;1397760;1698355;1579950;1723392;186710;186710;786432;1885065;1766660;2509824
860919,014;301031;179519;325632;1397299;1397300;1397760;1698330;1576819;1723392;186712;186712;786432;1885042;1763531;2509824
860969,201;301056;180614;325632;1397299;1397299;1397760;1698355;1577913;1723392;186761;186761;786432;1885116;1764674;2509824
861021,267;301056;180014;325632;1397299;1397299;1397760;1698355;1577313;1723392;186840;186749;786432;1885195;1764062;2509824
861085,255;301056;180492;325632;1397299;1397299;1397760;1698355;1577791;1723392;186755;186755;786432;1885110;1764546;2509824
861095,447;301056;179716;325632;1397299;1397299;1397760;1698355;1577015;1723392;186765;186765;786432;1885120;1763780;2509824
861197,013;301056;179928;325632;1397299;1397299;1397760;1698355;1577227;1723392;186768;186768;786432;1885123;1763995;2509824
861296,756;301056;181024;325632;1397299;1397299;1397760;1698355;1578323;1723392;186796;186796;786432;1885151;1765119;2509824
861452,504;301056;180181;325632;1397299;1397299;1397760;1698355;1577480;1723392;186799;186579;786432;1885154;1764059;2509824
861466,204;301056;179708;325632;1397299;1397299;1397760;1698355;1577007;1723392;186585;186585;786432;1884940;1763592;2509824
861474,009;301056;180127;325632;1397299;1397300;1397760;1698355;1577427;1723392;186585;186585;786432;1884940;1764012;2509824
861499,834;301056;182260;325632;1397299;1397299;1397760;1698355;1579559;1723392;186657;186657;786432;1885012;1766216;2509824
861716,385;300745;181915;325632;1397299;1397299;1397760;1698044;1579214;1723392;186669;186669;786432;1884713;1765883;2509824
861749,947;301056;180574;325632;1397299;1397299;1397760;1698355;1577873;1723392;186774;186774;786432;1885129;1764647;2509824
861781,045;301056;180242;325632;1397299;1397300;1397760;1698355;1577542;1723392;186776;186776;786432;1885131;1764318;2509824
861850,482;301056;179994;325632;1397299;1397299;1397760;1698355;1577293;1723392;186779;186779;786432;1885134;1764072;2509824
861926,532;301056;182452;325632;1397299;1397299;1397760;1698355;1579751;1723392;186840;186823;786432;1885195;1766574;2509824
861980,132;301056;181814;325632;1397299;1397299;1397760;1698355;1579113;1723392;186824;186824;786432;1885179;1765937;2509824
862004,744;301056;180785;325632;1397299;1397299;1397760;1698355;1578084;1723392;186824;186824;786432;1885179;1764908;2509824
862039,255;301056;180630;325632;1397299;1397299;1397760;1698355;1577929;1723392;186824;186824;786432;1885179;1764753;2509824
862143,485;301056;180964;325632;1397299;1397299;1397760;1698355;1578263;1723392;186824;186824;786432;1885179;1765087;2509824
862155,300;301056;183393;325632;1397299;1397299;1397760;1698355;1580692;1723392;186830;186830;786432;1885185;1767522;2509824
862187,580;301056;183421;325632;1397299;1397299;1397760;1698355;1580720;1723392;186832;186832;786432;1885187;1767552;2509824
862210,497;301056;182002;325632;1397298;1397298;1397760;1698354;1579300;1723392;186832;186832;786432;1885186;1766132;2509824
862227,535;301056;184095;325632;1397298;1397299;1397760;1698354;1581394;1723392;186832;186832;786432;1885186;1768226;2509824
862263,905;301056;186449;325632;1397298;1397299;1397760;1698354;1583748;1723392;186832;186832;786432;1885186;1770580;2509824
862276,295;301056;187028;325632;1397298;1397299;1397760;1698354;1584327;1723392;186837;186837;786432;1885191;1771164;2509824
862292,454;301056;185405;325632;1397298;1397298;1397760;1698354;1582703;1723392;186837;186837;786432;1885191;1769540;2509824
862367,794;301056;187423;325632;1397298;1397299;1397760;1698354;1584722;1723392;186837;186837;786432;1885191;1771559;2509824
862391,965;301056;184669;325632;1397298;1397299;1397760;1698354;1581968;1723392;186837;186837;786432;1885191;1768805;2509824
862408,574;301056;185963;325632;1397298;1397299;1397760;1698354;1583262;1723392;186837;186837;786432;1885191;1770099;2509824
862472,731;300973;187529;325632;1397299;1397299;1397760;1698272;1584828;1723392;186854;186802;786432;1885126;1771630;2509824
862579,737;301056;189857;325632;1397298;1397299;1397760;1698354;1587156;1723392;186956;186956;786432;1885310;1774112;2509824
862597,986;301056;186831;325632;1397298;1397299;1397760;1698354;1584130;1723392;186956;186840;786432;1885310;1770970;2509824
862621,184;301056;185814;325632;1397298;1397299;1397760;1698354;1583113;1723392;186840;186840;786432;1885194;1769953;2509824
862650,135;301056;188251;325632;1397298;1397299;1397760;1698354;1585550;1723392;186840;186840;786432;1885194;1772390;2509824
862674,658;301056;186408;325632;1397298;1397299;1397760;1698354;1583707;1723392;186840;186840;786432;1885194;1770547;2509824
862684,433;301056;186453;325632;1397298;1397299;1397760;1698354;1583752;1723392;186840;186840;786432;1885194;1770592;2509824
862724,321;301056;187746;325632;1397298;1397299;1397760;1698354;1585045;1723392;186858;186858;786432;1885212;1771903;2509824
862821,535;301056;188678;325632;1397298;1397299;1397760;1698354;1585977;1723392;186858;186858;786432;1885212;1772835;2509824
862893,734;301056;187159;325632;1397298;1397299;1397760;1698354;1584458;1723392;186861;186858;786432;1885215;1771316;2509824
863042,880;301056;186962;325632;1397298;1397299;1397760;1698354;1584261;1723392;186858;186858;786432;1885212;1771119;2509824
863981,668;301056;180298;325632;1397298;1397299;1397760;1698354;1577597;1723392;186873;186833;786432;1885227;1764430;2509824
864420,943;301056;179753;325632;1397298;1397299;1397760;1698354;1577052;1723392;186836;185671;786432;1885190;1762723;2509824
864528,681;301056;180850;325632;1397298;1397299;1397760;1698354;1578149;1723392;185865;185865;786432;1884219;1764014;2509824
864549,616;301056;179591;325632;1397298;1397299;1397760;1698354;1576890;1723392;186104;186011;786432;1884458;1762901;2509824
864601,119;301056;181839;325632;1397298;1397299;1397760;1698354;1579138;1723392;186089;186089;786432;1884443;1765227;2509824
864692,768;301056;179666;325632;1397298;1397299;1397760;1698354;1576965;1723392;186116;186116;786432;1884470;1763081;2509824
864706,527;301056;180784;325632;1397298;1397298;1397760;1698354;1578082;1723392;186283;186283;786432;1884637;1764365;2509824
865049,487;301056;184909;325632;1397298;1397299;1397760;1698354;1582208;1723392;186474;186423;786432;1884828;1768631;2509824
865113,422;301056;184735;325632;1397298;1397299;1397760;1698354;1582034;1723392;186478;186359;786432;1884832;1768393;2509824
865165,761;301056;184555;325632;1397298;1397299;1397760;1698354;1581854;1723392;186370;186370;786432;1884724;1768224;2509824
865178,227;301056;182427;325632;1397298;1397299;1397760;1698354;1579726;1723392;186519;186519;786432;1884873;1766245;2509824
865191,145;301056;182276;325632;1397298;1397299;1397760;1698354;1579575;1723392;186519;186519;786432;1884873;1766094;2509824
865203,365;301056;182367;325632;1397298;1397298;1397760;1698354;1579665;1723392;186572;186572;786432;1884926;1766237;2509824
865741,952;301056;182585;325632;1397298;1397298;1397760;1698354;1579883;1723392;186624;186624;786432;1884978;1766507;2509824
865808,941;301056;185034;325632;1397298;1397299;1397760;1698354;1582333;1723392;186700;186408;786432;1885054;1768741;2509824
865973,381;301056;182734;325632;1397298;1397299;1397760;1698354;1580033;1723392;186455;186455;786432;1884809;1766488;2509824
866056,279;301056;185401;325632;1397298;1397298;1397760;1698354;1582699;1723392;186462;186462;786432;1884816;1769161;2509824
866084,942;301056;187675;325632;1397298;1397299;1397760;1698354;1584974;1723392;186673;186621;786432;1885027;1771595;2509824
866105,845;301056;184311;325632;1397298;1397299;1397760;1698354;1581610;1723392;186649;186534;786432;1885003;1768144;2509824
866126,355;301056;183857;325632;1397298;1397299;1397760;1698354;1581156;1723392;186544;186544;786432;1884898;1767700;2509824
866139,838;301056;184897;325632;1397298;1397299;1397760;1698354;1582196;1723392;186719;186667;786432;1885073;1768863;2509824
866205,730;301056;187559;325632;1397298;1397299;1397760;1698354;1584858;1723392;186699;186699;786432;1885053;1771557;2509824
866227,270;301056;188216;325632;1397298;1397299;1397760;1698354;1585515;1723392;186721;186605;786432;1885075;1772120;2509824
866248,036;301056;185762;325632;1397298;1397299;1397760;1698354;1583061;1723392;186631;186631;786432;1884985;1769692;2509824
866256,872;301056;187922;325632;1397298;1397299;1397760;1698354;1585221;1723392;186631;186614;786432;1884985;1771835;2509824
866264,666;301056;186301;325632;1397298;1397299;1397760;1698354;1583600;1723392;186620;186620;786432;1884974;1770220;2509824
866305,802;301056;186015;325632;1397298;1397298;1397760;1698354;1583313;1723392;186623;186623;786432;1884977;1769936;2509824
866328,539;301056;187108;325632;1397298;1397299;1397760;1698354;1584407;1723392;186623;186623;786432;1884977;1771030;2509824
866348,150;301056;184625;325632;1397298;1397299;1397760;1698354;1581924;1723392;186694;186694;786432;1885048;1768618;2509824
866358,792;301056;184565;325632;1397298;1397298;1397760;1698354;1581863;1723392;186749;186749;786432;1885103;1768612;2509824
866395,007;301056;184588;325632;1397298;1397298;1397760;1698354;1581886;1723392;186749;186749;786432;1885103;1768635;2509824
866409,646;301056;184861;325632;1397298;1397299;1397760;1698354;1582160;1723392;186750;186750;786432;1885104;1768910;2509824
866430,412;301056;184953;325632;1397298;1397299;1397760;1698354;1582252;1723392;186750;186750;786432;1885104;1769002;2509824
866446,043;301056;184937;325632;1397298;1397299;1397760;1698354;1582236;1723392;186751;186751;786432;1885105;1768987;2509824
866504,969;301056;186752;325632;1397298;1397542;1397760;1698354;1584294;1723392;186926;186874;786432;1885280;1771168;2509824
866530,114;301056;185255;325632;1397542;1397543;1397760;1698598;1582798;1723392;186874;186759;786432;1885472;1769557;2509824
866556,870;301056;184831;325632;1397542;1397542;1397760;1698598;1582373;1723392;186759;186759;786432;1885357;1769132;2509824
866568,863;301056;185648;325632;1397542;1397543;1397760;1698598;1583191;1723392;186926;186874;786432;1885524;1770065;2509824
866578,628;301056;185164;325632;1397542;1397542;1397760;1698598;1582706;1723392;186888;186772;786432;1885486;1769478;2509824
866584,640;301056;185312;325632;1397542;1397543;1397760;1698598;1582855;1723392;186772;186772;786432;1885370;1769627;2509824
866589,007;301056;187654;325632;1397542;1397543;1397760;1698598;1585197;1723392;186772;186772;786432;1885370;1771969;2509824
866629,203;301056;185556;325632;1397542;1397542;1397760;1698598;1583098;1723392;186772;186772;786432;1885370;1769870;2509824
866662,328;301056;185832;325632;1397542;1397543;1397760;1698598;1583375;1723392;186772;186720;786432;1885370;1770095;2509824
866861,485;301056;188874;325632;1397542;1397543;1397760;1698598;1586417;1723392;187055;187055;786432;1885653;1773472;2509824
866873,460;301056;189356;325632;1397542;1397543;1397760;1698598;1586899;1723392;187103;186820;786432;1885701;1773719;2509824
866894,741;301056;186426;325632;1397542;1397543;1397760;1698598;1583969;1723392;186820;186820;786432;1885418;1770789;2509824
866912,880;301056;187023;325632;1397542;1397543;1397760;1698598;1584566;1723392;186987;186936;786432;1885585;1771502;2509824
867614,149;301056;186584;325632;1397542;1397543;1397760;1698598;1584127;1723392;186939;186823;786432;1885537;1770950;2509824
867665,650;301056;188972;325632;1397542;1397542;1397760;1698598;1586514;1723392;186830;186507;786432;1885428;1773021;2509824
867901,977;301056;188125;325632;1397542;1397542;1397760;1698598;1585667;1723392;186543;186543;786432;1885141;1772210;2509824
867933,528;301056;185552;325632;1397542;1397542;1397760;1698598;1583094;1723392;186547;186547;786432;1885145;1769641;2509824
867962,695;301056;185753;325632;1397542;1397542;1397760;1698598;1583295;1723392;186573;186573;786432;1885171;1769868;2509824
867978,589;301056;187543;325632;1397542;1397542;1397760;1698598;1585085;1723392;186626;186626;786432;1885224;1771711;2509824
867981,370;201827;191170;325632;1397542;1397543;1397760;1599369;1588713;1723392;186626;186626;786432;1785995;1775339;2509824
867991,731;301051;186473;325632;1397542;1397543;1397760;1698593;1584016;1723392;186632;186580;786432;1885225;1770596;2509824
868038,283;301056;189165;325632;1397542;1397543;1397760;1698598;1586708;1723392;186791;186791;786432;1885389;1773499;2509824
868062,728;301056;186498;325632;1397542;1397542;1397760;1698598;1584040;1723392;186806;186691;786432;1885404;1770731;2509824
868718,343;301031;184550;325632;1397543;1397542;1397760;1698574;1582092;1723392;186858;186806;786432;1885432;1768898;2509824
869470,584;300863;181934;325632;1397542;1397542;1397760;1698405;1579476;1723392;186808;185513;786432;1885213;1764989;2509824
869522,701;301056;184223;325632;1397542;1397542;1397760;1698598;1581765;1723392;185663;185608;786432;1884261;1767373;2509824
869663,527;301056;183872;325632;1397542;1397543;1397760;1698598;1581415;1723392;185696;185696;786432;1884294;1767111;2509824
869689,299;301056;185106;325632;1397542;1397542;1397760;1698598;1582648;1723392;186049;186049;786432;1884647;1768697;2509824
869725,339;301056;182900;325632;1397542;1397543;1397760;1698598;1580443;1723392;186101;186101;786432;1884699;1766544;2509824
869760,921;301056;188068;325632;1397542;1397543;1397760;1698598;1585611;1723392;186330;186330;786432;1884928;1771941;2509824
869815,595;301056;184197;325632;1397542;1397542;1397760;1698598;1581739;1723392;186402;186286;786432;1885000;1768025;2509824
869845,926;301056;184486;325632;1397542;1397542;1397760;1698598;1582028;1723392;186335;186335;786432;1884933;1768363;2509824
869888,489;301056;187936;325632;1397542;1397543;1397760;1698598;1585479;1723392;186510;186458;786432;1885108;1771937;2509824
869906,683;301056;185728;325632;1397542;1397542;1397760;1698598;1583270;1723392;186668;186552;786432;1885266;1769822;2509824
869957,143;301056;185603;325632;1397542;1397542;1397760;1698598;1583145;1723392;186600;186549;786432;1885198;1769694;2509824
869996,865;301056;188287;325632;1397542;1397542;1397760;1698598;1585829;1723392;186716;186716;786432;1885314;1772545;2509824
870047,635;301056;185677;325632;1397542;1397542;1397760;1698598;1583219;1723392;186811;186695;786432;1885409;1769914;2509824
870073,127;301056;188617;325632;1397542;1397542;1397760;1698598;1586159;1723392;186874;186823;786432;1885472;1772982;2509824
870098,594;301056;186219;325632;1397542;1397542;1397760;1698598;1583761;1723392;186825;186709;786432;1885423;1770470;2509824
870131,478;301056;186633;325632;1397542;1397543;1397760;1698598;1584176;1723392;186766;186766;786432;1885364;1770942;2509824
870148,316;301056;188643;325632;1397542;1397542;1397760;1698598;1586185;1723392;186988;186937;786432;1885586;1773122;2509824
870165,243;301056;190793;325632;1397542;1397542;1397760;1698598;1588335;1723392;186937;186821;786432;1885535;1775156;2509824
870177,666;301056;187726;325632;1397542;1397542;1397760;1698598;1585268;1723392;186821;186821;786432;1885419;1772089;2509824
870190,580;301056;189521;325632;1397542;1397542;1397760;1698598;1587063;1723392;186821;186821;786432;1885419;1773884;2509824
870206,563;301056;188244;325632;1397542;1397542;1397760;1698598;1585786;1723392;186822;186822;786432;1885420;1772608;2509824
870210,644;301056;188238;325632;1397542;1397542;1397760;1698598;1585780;1723392;186837;186837;786432;1885435;1772617;2509824
870239,050;301056;188303;325632;1397542;1397542;1397760;1698598;1585845;1723392;186846;186794;786432;1885444;1772639;2509824
870267,957;301056;188806;325632;1397542;1397543;1397760;1698598;1586349;1723392;186956;186956;786432;1885554;1773305;2509824
870297,082;301056;190729;325632;1397542;1397543;1397760;1698598;1588272;1723392;186963;186847;786432;1885561;1775119;2509824
870405,075;301056;188812;325632;1397542;1397543;1397760;1698598;1586355;1723392;186894;186894;786432;1885492;1773249;2509824
870455,546;301056;189077;325632;1397542;1397542;1397760;1698598;1586619;1723392;187065;187014;786432;1885663;1773633;2509824
870710,824;301056;191021;325632;1397542;1397543;1397760;1698598;1588564;1723392;187017;186901;786432;1885615;1775465;2509824
870738,795;301056;189020;325632;1397542;1397542;1397760;1698598;1586562;1723392;186901;186901;786432;1885499;1773463;2509824
870777,791;301056;189397;325632;1397542;1397542;1397760;1698598;1586939;1723392;186901;186849;786432;1885499;1773788;2509824
870808,654;301056;194347;325632;1397542;1397542;1397760;1698598;1591889;1723392;187017;187017;786432;1885615;1778906;2509824
870837,120;301056;192284;325632;1397542;1397543;1397760;1698598;1589827;1723392;187018;186807;786432;1885616;1776634;2509824
870893,968;301056;190234;325632;1397542;1397543;1397760;1698598;1587777;1723392;186807;186807;786432;1885405;1774584;2509824
870913,381;301056;191077;325632;1397542;1397542;1397760;1698598;1588619;1723392;186807;186807;786432;1885405;1775426;2509824
870935,484;300666;192049;325632;1397543;1397542;1397760;1698209;1589591;1723392;186974;186923;786432;1885183;1776514;2509824
870947,057;301056;194295;325632;1397542;1397543;1397760;1698598;1591838;1723392;186931;186815;786432;1885529;1778653;2509824
870965,898;301056;191639;325632;1397542;1397543;1397760;1698598;1589182;1723392;186815;186815;786432;1885413;1775997;2509824
870970,955;300962;192123;325632;1397542;1397543;1397760;1698504;1589666;1723392;186815;186768;786432;1885319;1776434;2509824
870985,210;301056;194994;325632;1397544;1397542;1397760;1698600;1592536;1723392;186768;186768;786432;1885368;1779304;2509824
870999,177;301056;192283;325632;1397542;1397543;1397760;1698598;1589826;1723392;186803;186803;786432;1885401;1776629;2509824
871025,250;301056;192962;325632;1397542;1397543;1397760;1698598;1590505;1723392;186971;186919;786432;1885569;1777424;2509824
871038,352;301056;193748;325632;1397542;1397543;1397760;1698598;1591291;1723392;186919;186803;786432;1885517;1778094;2509824
871050,608;301056;194849;325632;1397542;1397543;1397760;1698598;1592392;1723392;186971;186919;786432;1885569;1779311;2509824
871114,473;301056;194720;325632;1397542;1397543;1397760;1698598;1592263;1723392;187087;186919;786432;1885685;1779182;2509824
871128,184;301056;194300;325632;1397542;1397543;1397760;1698598;1591843;1723392;186919;186803;786432;1885517;1778646;2509824
871140,028;301056;193292;325632;1397542;1397542;1397760;1698598;1590834;1723392;186808;186757;786432;1885406;1777591;2509824
871161,373;301056;194046;325632;1397542;1397542;1397760;1698598;1591588;1723392;186924;186924;786432;1885522;1778512;2509824
871173,719;301056;192970;325632;1397542;1397542;1397760;1698598;1590512;1723392;186924;186808;786432;1885522;1777320;2509824
871188,615;301056;193655;325632;1397542;1397543;1397760;1698598;1591198;1723392;186817;186817;786432;1885415;1778015;2509824
871222,569;301056;194993;325632;1397542;1397543;1397760;1698598;1592536;1723392;186984;186932;786432;1885582;1779468;2509824
871232,583;301056;193724;325632;1397542;1397543;1397760;1698598;1591267;1723392;186934;186767;786432;1885532;1778034;2509824
871259,624;301056;195839;325632;1397542;1397542;1397760;1698598;1593381;1723392;186938;186938;786432;1885536;1780319;2509824
871321,998;301056;198462;325632;1397542;1397543;1397760;1698598;1596005;1723392;187116;186948;786432;1885714;1782953;2509824
871337,231;301056;196158;325632;1397542;1397542;1397760;1698598;1593700;1723392;186951;186832;786432;1885549;1780532;2509824
871344,228;301056;194294;325632;1397542;1397542;1397760;1698598;1591836;1723392;186832;186832;786432;1885430;1778668;2509824
871376,881;301056;194571;325632;1397542;1397542;1397760;1698598;1592113;1723392;186832;186832;786432;1885430;1778945;2509824
871384,709;301056;196686;325632;1397542;1397543;1397760;1698598;1594229;1723392;186932;186881;786432;1885530;1781110;2509824
871459,197;301056;198829;325632;1397542;1397543;1397760;1698598;1596372;1723392;186950;186950;786432;1885548;1783322;2509824
871474,399;301056;196572;325632;1397542;1397543;1397760;1698598;1594115;1723392;186950;186797;786432;1885548;1780912;2509824
871494,219;301056;196938;325632;1397542;1397543;1397760;1698598;1594481;1723392;186797;186797;786432;1885395;1781278;2509824
871499,917;301056;196261;325632;1397542;1397542;1397760;1698598;1593803;1723392;186797;186797;786432;1885395;1780600;2509824
871513,524;301056;197419;325632;1397542;1397543;1397760;1698598;1594962;1723392;186797;186797;786432;1885395;1781759;2509824
871531,020;301056;199895;325632;1397542;1397542;1397760;1698598;1597437;1723392;186797;186797;786432;1885395;1784234;2509824
871534,959;301056;199028;325632;1397542;1397543;1397760;1698598;1596571;1723392;186797;186797;786432;1885395;1783368;2509824
871556,926;301056;195014;325632;1397542;1397543;1397760;1698598;1592557;1723392;186797;186797;786432;1885395;1779354;2509824
871613,440;301056;197434;325632;1397542;1397542;1397760;1698598;1594976;1723392;186965;186910;786432;1885563;1781886;2509824
871806,734;301056;196997;325632;1397542;1397543;1397760;1698598;1594540;1723392;186924;186808;786432;1885522;1781348;2509824
871823,917;301056;198792;325632;1397542;1397543;1397760;1698598;1596335;1723392;186825;186825;786432;1885423;1783160;2509824
871831,331;301005;199868;325632;1397542;1397543;1397760;1698547;1597411;1723392;186825;186825;786432;1885372;1784236;2509824
871860,643;301056;199155;325632;1397542;1397543;1397760;1698598;1596698;1723392;186828;186812;786432;1885426;1783510;2509824
871868,934;301056;199902;325632;1397542;1397542;1397760;1698598;1597444;1723392;186840;186840;786432;1885438;1784284;2509824
871886,282;301056;197418;325632;1397542;1397542;1397760;1698598;1594960;1723392;186840;186838;786432;1885438;1781798;2509824
871894,550;301056;198903;325632;1397542;1397540;1397760;1698598;1596443;1723392;186838;186838;786432;1885436;1783281;2509824
871903,686;301056;197831;325632;1397540;1397541;1397760;1698596;1595372;1723392;186838;186838;786432;1885434;1782210;2509824
871919,523;301056;197878;325632;1397540;1397540;1397760;1698596;1595418;1723392;186838;186838;786432;1885434;1782256;2509824
871926,653;301056;198307;325632;1397540;1397541;1397760;1698596;1595848;1723392;186838;186838;786432;1885434;1782686;2509824
871930,547;301056;201243;325632;1397540;1397541;1397760;1698596;1598784;1723392;186838;186838;786432;1885434;1785622;2509824
871941,479;301056;198191;325632;1397540;1397541;1397760;1698596;1595732;1723392;186838;186838;786432;1885434;1782570;2509824
871946,904;301056;198260;325632;1397540;1397541;1397760;1698596;1595801;1723392;186838;186838;786432;1885434;1782639;2509824
871950,502;301056;199594;325632;1397540;1397541;1397760;1698596;1597135;1723392;186838;186838;786432;1885434;1783973;2509824
871956,935;301056;199519;325632;1397540;1397541;1397760;1698596;1597060;1723392;186843;186843;786432;1885439;1783903;2509824
871966,655;301056;198802;325632;1397540;1397541;1397760;1698596;1596343;1723392;186843;186843;786432;1885439;1783186;2509824
871974,489;301056;198989;325632;1397540;1397541;1397760;1698596;1596530;1723392;186844;186844;786432;1885440;1783374;2509824
871983,178;301056;199272;325632;1397540;1397541;1397760;1698596;1596813;1723392;186844;186844;786432;1885440;1783657;2509824
871986,433;301056;199699;325632;1397540;1397541;1397760;1698596;1597240;1723392;186844;186844;786432;1885440;1784084;2509824
871997,276;301056;201042;325632;1397540;1397540;1397760;1698596;1598582;1723392;187012;186960;786432;1885608;1785542;2509824
872002,248;301056;201851;325632;1397540;1397540;1397760;1698596;1599391;1723392;186960;186844;786432;1885556;1786235;2509824
872012,898;301056;201579;325632;1397540;1397540;1397760;1698596;1599119;1723392;186845;186845;786432;1885441;1785964;2509824
872027,176;301056;200617;325632;1397540;1397540;1397760;1698596;1598157;1723392;186845;186845;786432;1885441;1785002;2509824
872039,238;301056;201244;325632;1397540;1397541;1397760;1698596;1598785;1723392;186845;186845;786432;1885441;1785630;2509824
872051,691;301056;202738;325632;1397540;1397540;1397760;1698596;1600278;1723392;186845;186845;786432;1885441;1787123;2509824
872059,677;301056;201943;325632;1397540;1397541;1397760;1698596;1599484;1723392;186845;186845;786432;1885441;1786329;2509824
872076,285;301056;204434;325632;1397540;1397540;1397760;1698596;1601974;1723392;186845;186845;786432;1885441;1788819;2509824
872092,876;301056;201822;325632;1397540;1397541;1397760;1698596;1599363;1723392;186845;186845;786432;1885441;1786208;2509824
872101,858;301056;201947;325632;1397540;1397541;1397760;1698596;1599488;1723392;186845;186845;786432;1885441;1786333;2509824
872116,674;301056;202068;325632;1397540;1397541;1397760;1698596;1599609;1723392;186845;186845;786432;1885441;1786454;2509824
872133,249;301056;202697;325632;1397540;1397540;1397760;1698596;1600237;1723392;187012;186961;786432;1885608;1787198;2509824
872366,030;301056;201553;325632;1397540;1397540;1397760;1698596;1599093;1723392;186961;186845;786432;1885557;1785938;2509824
872385,754;301056;201702;325632;1397540;1397540;1397760;1698596;1599242;1723392;186845;186845;786432;1885441;1786087;2509824
872490,887;301052;202042;325632;1397541;1397541;1397760;1698593;1599583;1723392;186845;186814;786432;1885438;1786397;2509824
872522,130;301056;202939;325632;1397540;1397540;1397760;1698596;1600479;1723392;186814;186814;786432;1885410;1787293;2509824
872565,714;301056;202645;325632;1397540;1397541;1397760;1698596;1600186;1723392;186814;186814;786432;1885410;1787000;2509824
872626,778;301056;201017;325632;1397540;1397540;1397760;1698596;1598557;1723392;186814;186814;786432;1885410;1785371;2509824
872638,824;301056;201498;325632;1397540;1397541;1397760;1698596;1599039;1723392;186814;186811;786432;1885410;1785850;2509824
872665,568;301056;202472;325632;1397540;1397541;1397760;1698596;1600013;1723392;186814;186814;786432;1885410;1786827;2509824
872716,732;301056;201676;325632;1397540;1397540;1397760;1698596;1599216;1723392;186817;186817;786432;1885413;1786033;2509824
872745,331;301056;204207;325632;1397540;1397541;1397760;1698596;1601748;1723392;186817;186817;786432;1885413;1788565;2509824
872793,680;301056;199230;325632;1397540;1397540;1397760;1698596;1596770;1723392;186817;186817;786432;1885413;1783587;2509824
872853,204;301056;199292;325632;1397540;1397540;1397760;1698596;1596832;1723392;186817;186817;786432;1885413;1783649;2509824
872906,319;301056;201139;325632;1397540;1397540;1397760;1698596;1598679;1723392;186817;186817;786432;1885413;1785496;2509824
872931,963;301056;199242;325632;1397540;1397540;1397760;1698596;1596782;1723392;186817;186817;786432;1885413;1783599;2509824
872960,932;301056;199766;325632;1397540;1397540;1397760;1698596;1597306;1723392;186817;186817;786432;1885413;1784123;2509824
872986,738;301056;200692;325632;1397540;1397541;1397760;1698596;1598233;1723392;186845;186845;786432;1885441;1785078;2509824
873070,061;301056;200245;325632;1397540;1397540;1397760;1698596;1597785;1723392;186845;186845;786432;1885441;1784630;2509824
873103,780;301056;202514;325632;1397540;1397541;1397760;1698596;1600055;1723392;186851;186851;786432;1885447;1786906;2509824
873127,146;301056;200712;325632;1397540;1397540;1397760;1698596;1598252;1723392;186851;186851;786432;1885447;1785103;2509824
873211,457;301056;201044;325632;1397540;1397541;1397760;1698596;1598585;1723392;186851;186851;786432;1885447;1785436;2509824
873242,561;301056;202210;325632;1397540;1397540;1397760;1698596;1599750;1723392;186851;186851;786432;1885447;1786601;2509824
873275,567;301056;200223;325632;1397540;1397541;1397760;1698596;1597764;1723392;186851;186851;786432;1885447;1784615;2509824
873330,946;301056;201215;325632;1397540;1397540;1397760;1698596;1598755;1723392;186851;186851;786432;1885447;1785606;2509824
873371,848;301056;201687;325632;1397540;1397540;1397760;1698596;1599227;1723392;186851;186820;786432;1885447;1786047;2509824
873385,472;301056;203591;325632;1397540;1397540;1397760;1698596;1601131;1723392;186823;186823;786432;1885419;1787954;2509824
873390,085;301056;202099;325632;1397540;1397541;1397760;1698596;1599640;1723392;186823;186823;786432;1885419;1786463;2509824
873412,154;301056;200803;325632;1397540;1397540;1397760;1698596;1598343;1723392;186823;186823;786432;1885419;1785166;2509824
873486,358;301056;200063;325632;1397540;1397541;1397760;1698596;1597604;1723392;186841;186841;786432;1885437;1784445;2509824
873512,752;301056;201850;325632;1397540;1397541;1397760;1698596;1599391;1723392;186841;186841;786432;1885437;1786232;2509824
873524,219;301056;202463;325632;1397540;1397540;1397760;1698596;1600003;1723392;186841;186841;786432;1885437;1786844;2509824
873545,939;301056;203702;325632;1397540;1397540;1397760;1698596;1601242;1723392;186844;186844;786432;1885440;1788086;2509824
873549,874;301056;205220;325632;1397540;1397541;1397760;1698596;1602761;1723392;186844;186844;786432;1885440;1789605;2509824
873554,170;301056;203047;325632;1397540;1397540;1397760;1698596;1600587;1723392;186844;186844;786432;1885440;1787431;2509824
873557,487;301056;206445;325632;1397540;1397540;1397760;1698596;1603985;1723392;186844;186844;786432;1885440;1790829;2509824
873564,097;301056;203856;325632;1397540;1397541;1397760;1698596;1601397;1723392;186844;186844;786432;1885440;1788241;2509824
873621,221;301056;202778;325632;1397540;1397541;1397760;1698596;1600319;1723392;186859;186859;786432;1885455;1787178;2509824
873647,205;301056;203116;325632;1397540;1397541;1397760;1698596;1600657;1723392;186859;186859;786432;1885455;1787516;2509824
873689,786;301056;206532;325632;1397540;1397541;1397760;1698596;1604073;1723392;187030;186978;786432;1885626;1791051;2509824
873701,889;301056;206254;325632;1397540;1397541;1397760;1698596;1603795;1723392;186978;186862;786432;1885574;1790657;2509824
873718,468;301056;204898;325632;1397540;1397540;1397760;1698596;1602438;1723392;186862;186862;786432;1885458;1789300;2509824
873728,659;301056;203841;325632;1397540;1397540;1397760;1698596;1601381;1723392;186862;186862;786432;1885458;1788243;2509824
873733,024;301056;208079;325632;1397540;1397541;1397760;1698596;1605620;1723392;186862;186862;786432;1885458;1792482;2509824
873751,247;301056;206638;325632;1397540;1397541;1397760;1698596;1604179;1723392;186862;186862;786432;1885458;1791041;2509824
873758,797;301056;206825;325632;1397544;1397540;1397760;1698600;1604365;1723392;186862;186862;786432;1885462;1791227;2509824
873770,497;301056;205616;325632;1397540;1397540;1397760;1698596;1603156;1723392;186865;186865;786432;1885461;1790021;2509824
873778,662;301056;205791;325632;1397540;1397541;1397760;1698596;1603332;1723392;186865;186865;786432;1885461;1790197;2509824
873785,779;301056;206701;325632;1397540;1397540;1397760;1698596;1604241;1723392;187033;186981;786432;1885629;1791222;2509824
873812,243;301056;207140;325632;1397540;1397540;1397760;1698596;1604680;1723392;187148;186981;786432;1885744;1791661;2509824
873819,458;301056;207665;325632;1397540;1397541;1397760;1698596;1605206;1723392;186981;186865;786432;1885577;1792071;2509824
873834,122;301056;206637;325632;1397540;1397540;1397760;1698596;1604177;1723392;186865;186865;786432;1885461;1791042;2509824
873839,576;301056;208064;325632;1397540;1397540;1397760;1698596;1605604;1723392;186865;186865;786432;1885461;1792469;2509824
873873,981;301056;206946;325632;1397540;1397541;1397760;1698596;1604487;1723392;186865;186865;786432;1885461;1791352;2509824
873883,676;301056;207735;325632;1397540;1397541;1397760;1698596;1605276;1723392;186865;186865;786432;1885461;1792141;2509824
873891,804;301056;208702;325632;1397540;1397540;1397760;1698596;1606242;1723392;186865;186865;786432;1885461;1793107;2509824
873900,204;301056;209715;325632;1397540;1397540;1397760;1698596;1607255;1723392;186865;186837;786432;1885461;1794092;2509824
873908,324;301056;208157;325632;1397540;1397540;1397760;1698596;1605697;1723392;186839;186839;786432;1885435;1792536;2509824
873912,814;301056;209411;325632;1397540;1397540;1397760;1698596;1606951;1723392;186839;186839;786432;1885435;1793790;2509824
873920,040;301056;209370;325632;1397540;1397540;1397760;1698596;1606910;1723392;187006;186955;786432;1885602;1793865;2509824
873935,585;301056;208108;325632;1397540;1397540;1397760;1698596;1605648;1723392;186955;186839;786432;1885551;1792487;2509824
873946,589;301056;207668;325632;1397540;1397541;1397760;1698596;1605209;1723392;186841;186841;786432;1885437;1792050;2509824
873957,379;301056;207941;325632;1397540;1397541;1397760;1698596;1605482;1723392;186841;186841;786432;1885437;1792323;2509824
873969,236;301056;208084;325632;1397540;1397540;1397760;1698596;1605624;1723392;186857;186806;786432;1885453;1792430;2509824
873977,179;301056;209652;325632;1397540;1397540;1397760;1698596;1607192;1723392;186956;186956;786432;1885552;1794148;2509824
874050,907;301056;208527;325632;1397540;1397540;1397760;1698596;1606067;1723392;187124;186956;786432;1885720;1793023;2509824
874065,332;301056;210252;325632;1397540;1397540;1397760;1698596;1607792;1723392;186956;186841;786432;1885552;1794633;2509824
874080,776;301056;210357;325632;1397540;1397540;1397760;1698596;1607897;1723392;186841;186841;786432;1885437;1794738;2509824
874088,928;301056;210063;325632;1397540;1397541;1397760;1698596;1607604;1723392;186841;186841;786432;1885437;1794445;2509824
874096,090;301056;210692;325632;1397540;1397541;1397760;1698596;1608233;1723392;186841;186841;786432;1885437;1795074;2509824
874100,165;301056;210498;325632;1397540;1397540;1397760;1698596;1608038;1723392;186841;186841;786432;1885437;1794879;2509824
874110,804;301056;209760;325632;1397540;1397541;1397760;1698596;1607301;1723392;186841;186841;786432;1885437;1794142;2509824
874132,790;301056;210424;325632;1397540;1397541;1397760;1698596;1607965;1723392;186841;186841;786432;1885437;1794806;2509824
874135,959;301056;212998;325632;1397540;1397540;1397760;1698596;1610538;1723392;186841;186814;786432;1885437;1797352;2509824
874139,349;301056;214131;325632;1397540;1397541;1397760;1698596;1611672;1723392;186814;186814;786432;1885410;1798486;2509824
874143,111;301056;212062;325632;1397540;1397540;1397760;1698596;1609602;1723392;186814;186814;786432;1885410;1796416;2509824
874162,306;301056;212496;325632;1397540;1397540;1397760;1698596;1610036;1723392;186814;186814;786432;1885410;1796850;2509824
874170,510;301056;214985;325632;1397540;1397541;1397760;1698596;1612526;1723392;186814;186814;786432;1885410;1799340;2509824
874175,830;301056;215084;325632;1397540;1397540;1397760;1698596;1612624;1723392;186814;186814;786432;1885410;1799438;2509824
874218,498;301056;211918;325632;1397540;1397540;1397760;1698596;1609458;1723392;186815;186815;786432;1885411;1796273;2509824
874261,767;301056;209634;325632;1397540;1397541;1397760;1698596;1607175;1723392;186815;186815;786432;1885411;1793990;2509824
874275,970;301056;210096;325632;1397540;1397541;1397760;1698596;1607637;1723392;186959;186907;786432;1885555;1794544;2509824
874285,894;301056;210464;325632;1397540;1397540;1397760;1698596;1608004;1723392;186931;186931;786432;1885527;1794935;2509824
874333,114;301056;210319;325632;1397540;1397540;1397760;1698596;1607859;1723392;186931;186815;786432;1885527;1794674;2509824
874349,181;301056;213277;325632;1397540;1397541;1397760;1698596;1610818;1723392;186830;186830;786432;1885426;1797648;2509824
874357,437;300729;212689;325632;1397540;1397541;1397760;1698269;1610230;1723392;186830;186827;786432;1885099;1797057;2509824
874374,629;301056;207402;325632;1397540;1397541;1397760;1698596;1604943;1723392;186827;186827;786432;1885423;1791770;2509824
874380,227;301056;208676;325632;1397540;1397540;1397760;1698596;1606216;1723392;186827;186827;786432;1885423;1793043;2509824
874383,633;301043;212490;325632;1397540;1397540;1397760;1698583;1610030;1723392;186827;186827;786432;1885410;1796857;2509824
874390,821;301056;207204;325632;1397540;1397540;1397760;1698596;1604744;1723392;186827;186827;786432;1885423;1791571;2509824
874402,803;301056;209708;325632;1397540;1397541;1397760;1698596;1607249;1723392;186827;186827;786432;1885423;1794076;2509824
874419,050;301056;208241;325632;1397540;1397540;1397760;1698596;1605781;1723392;186827;186827;786432;1885423;1792608;2509824
874430,219;301056;208046;325632;1397540;1397540;1397760;1698596;1605586;1723392;186827;186811;786432;1885423;1792397;2509824
874450,320;301056;209478;325632;1397540;1397540;1397760;1698596;1607018;1723392;186979;186927;786432;1885575;1793945;2509824
874461,678;301056;209872;325632;1397540;1397540;1397760;1698596;1607412;1723392;186930;186814;786432;1885526;1794226;2509824
874470,719;301056;209109;325632;1397540;1397541;1397760;1698596;1606650;1723392;186814;186814;786432;1885410;1793464;2509824
874479,586;301056;210061;325632;1397540;1397540;1397760;1698596;1607601;1723392;186814;186814;786432;1885410;1794415;2509824
874486,908;301056;209084;325632;1397540;1397541;1397760;1698596;1606625;1723392;186814;186814;786432;1885410;1793439;2509824
874493,645;301056;209721;325632;1397540;1397540;1397760;1698596;1607261;1723392;186875;186823;786432;1885471;1794084;2509824
874505,637;301056;210557;325632;1397540;1397540;1397760;1698596;1608097;1723392;186930;186930;786432;1885526;1795027;2509824
874524,383;301056;211570;325632;1397540;1397540;1397760;1698596;1609110;1723392;187097;186930;786432;1885693;1796040;2509824
874594,214;301056;211749;325632;1397540;1397540;1397760;1698596;1609289;1723392;186954;186838;786432;1885550;1796127;2509824
874726,440;301056;208142;325632;1397540;1397540;1397760;1698596;1605682;1723392;186866;186866;786432;1885462;1792548;2509824
874805,124;301056;206849;325632;1397540;1397540;1397760;1698596;1604389;1723392;186866;186866;786432;1885462;1791255;2509824
874821,724;301056;207900;325632;1397540;1397540;1397760;1698596;1605440;1723392;186890;186890;786432;1885486;1792330;2509824
874867,236;301056;206952;325632;1397540;1397541;1397760;1698596;1604493;1723392;186890;186890;786432;1885486;1791383;2509824
874900,832;301056;210076;325632;1397540;1397541;1397760;1698596;1607617;1723392;186893;186893;786432;1885489;1794510;2509824
874919,063;301056;209636;325632;1397540;1397540;1397760;1698596;1607176;1723392;186893;186893;786432;1885489;1794069;2509824
875059,688;301056;209036;325632;1397540;1397541;1397760;1698596;1606577;1723392;186893;186893;786432;1885489;1793470;2509824
875102,507;301056;209487;325632;1397540;1397540;1397760;1698596;1607027;1723392;186893;186893;786432;1885489;1793920;2509824
875143,573;301056;209331;325632;1397540;1397540;1397760;1698596;1606871;1723392;186893;186893;786432;1885489;1793764;2509824
875170,271;301045;208498;325632;1397541;1397540;1397760;1698586;1606038;1723392;186893;186893;786432;1885479;1792931;2509824
875176,105;301056;208472;325632;1397540;1397541;1397760;1698596;1606013;1723392;186893;186893;786432;1885489;1792906;2509824
875187,075;301056;208841;325632;1397540;1397541;1397760;1698596;1606382;1723392;186893;186893;786432;1885489;1793275;2509824
875198,062;301056;208476;325632;1397540;1397540;1397760;1698596;1606016;1723392;186893;186893;786432;1885489;1792909;2509824
875203,518;301056;208257;325632;1397540;1397540;1397760;1698596;1605797;1723392;186893;186893;786432;1885489;1792690;2509824
875232,972;301056;212259;325632;1397540;1397540;1397760;1698596;1609799;1723392;187228;187124;786432;1885824;1796923;2509824
875243,649;301056;209956;325632;1397540;1397540;1397760;1698596;1607496;1723392;187124;186893;786432;1885720;1794389;2509824
875295,365;300938;209786;325632;1397541;1397540;1397760;1698479;1607326;1723392;186893;186893;786432;1885372;1794219;2509824
875403,982;300851;210421;325632;1397540;1397541;1397760;1698391;1607962;1723392;186893;186881;786432;1885284;1794843;2509824
875511,207;301056;210746;325632;1397543;1397542;1397760;1698599;1608288;1723392;186890;186890;786432;1885489;1795178;2509824
875817,554;300947;206145;325632;1397541;1397540;1397760;1698488;1603685;1723392;186890;186890;786432;1885378;1790575;2509824
875831,775;300998;207454;325632;1397541;1397540;1397760;1698539;1604994;1723392;186890;186724;786432;1885429;1791718;2509824
875850,457;301056;206928;325632;1397540;1397541;1397760;1698596;1604469;1723392;186724;186724;786432;1885320;1791193;2509824
875854,648;301056;208138;325632;1397540;1397540;1397760;1698596;1605678;1723392;186755;186755;786432;1885351;1792433;2509824
875868,710;301056;205340;325632;1397540;1397540;1397760;1698596;1602880;1723392;186755;186755;786432;1885351;1789635;2509824
875886,733;301056;206122;325632;1397540;1397541;1397760;1698596;1603663;1723392;186758;186758;786432;1885354;1790421;2509824
875893,032;301056;206541;325632;1397540;1397540;1397760;1698596;1604081;1723392;186758;186706;786432;1885354;1790787;2509824
875897,359;301056;211173;325632;1397540;1397541;1397760;1698596;1608714;1723392;186745;186745;786432;1885341;1795459;2509824
875907,059;301056;208061;325632;1397540;1397540;1397760;1698596;1605601;1723392;187049;186997;786432;1885645;1792598;2509824
875914,031;301056;206512;325632;1397540;1397540;1397760;1698596;1604052;1723392;186997;186765;786432;1885593;1790817;2509824
875925,206;301056;208026;325632;1397540;1397540;1397760;1698596;1605566;1723392;186765;186765;786432;1885361;1792331;2509824
875931,368;301056;207529;325632;1397540;1397540;1397760;1698596;1605069;1723392;186765;186765;786432;1885361;1791834;2509824
875955,651;301056;207197;325632;1397540;1397540;1397760;1698596;1604737;1723392;186765;186765;786432;1885361;1791502;2509824
875988,042;301056;207306;325632;1397540;1397541;1397760;1698596;1604847;1723392;186768;186768;786432;1885364;1791615;2509824
876011,952;301056;208960;325632;1397540;1397541;1397760;1698596;1606501;1723392;186985;186933;786432;1885581;1793434;2509824
876015,704;301056;211131;325632;1397540;1397541;1397760;1698596;1608672;1723392;186933;186756;786432;1885529;1795428;2509824
876027,219;301056;209528;325632;1397540;1397540;1397760;1698596;1607068;1723392;186765;186765;786432;1885361;1793833;2509824
876034,090;301056;208747;325632;1397540;1397540;1397760;1698596;1606287;1723392;186765;186765;786432;1885361;1793052;2509824
876040,191;301056;210308;325632;1397540;1397540;1397760;1698596;1607848;1723392;186765;186765;786432;1885361;1794613;2509824
876072,545;301056;209094;325632;1397540;1397541;1397760;1698596;1606635;1723392;186769;186769;786432;1885365;1793404;2509824
876080,246;301056;209351;325632;1397540;1397541;1397760;1698596;1606892;1723392;186769;186769;786432;1885365;1793661;2509824
876088,255;301056;210421;325632;1397540;1397272;1397760;1698596;1607693;1723392;186937;186885;786432;1885533;1794578;2509824
876104,657;301056;209691;325632;1397271;1397271;1397760;1698327;1606962;1723392;187088;186920;786432;1885415;1793882;2509824
876113,159;301056;212381;325632;1397271;1397272;1397760;1698327;1609653;1723392;186920;186805;786432;1885247;1796458;2509824
876132,316;301056;209697;325632;1397271;1397272;1397760;1698327;1606969;1723392;186805;186805;786432;1885132;1793774;2509824
876137,103;301056;210418;325632;1397271;1397272;1397760;1698327;1607690;1723392;186805;186805;786432;1885132;1794495;2509824
876147,325;301056;211633;325632;1397271;1397271;1397760;1698327;1608904;1723392;186805;186805;786432;1885132;1795709;2509824
876160,368;301056;209704;325632;1397271;1397271;1397760;1698327;1606975;1723392;186805;186805;786432;1885132;1793780;2509824
876163,809;301056;210594;325632;1397271;1397272;1397760;1698327;1607866;1723392;186805;186805;786432;1885132;1794671;2509824
876176,972;301056;210802;325632;1397271;1397271;1397760;1698327;1608073;1723392;186805;186805;786432;1885132;1794878;2509824
876195,455;301052;209090;325632;1397272;1397271;1397760;1698324;1606361;1723392;186850;186850;786432;1885174;1793211;2509824
876208,451;301056;209490;325632;1397271;1397272;1397760;1698327;1606762;1723392;187017;186966;786432;1885344;1793728;2509824
876216,450;300669;209427;325632;1397271;1397272;1397760;1697940;1606699;1723392;186966;186850;786432;1884906;1793549;2509824
876227,075;301056;209953;325632;1397271;1397271;1397760;1698327;1607224;1723392;187017;186966;786432;1885344;1794190;2509824
876246,257;301056;210529;325632;1397271;1397272;1397760;1698327;1607801;1723392;186966;186850;786432;1885293;1794651;2509824
876266,654;301056;209778;325632;1397271;1397272;1397760;1698327;1607050;1723392;186850;186850;786432;1885177;1793900;2509824
876298,068;301056;210332;325632;1397271;1397271;1397760;1698327;1607603;1723392;186850;186850;786432;1885177;1794453;2509824
876316,662;301056;211614;325632;1397271;1397271;1397760;1698327;1608885;1723392;187017;186966;786432;1885344;1795851;2509824
876321,057;301056;212688;325632;1397271;1397272;1397760;1698327;1609960;1723392;186966;186850;786432;1885293;1796810;2509824
876346,647;301056;211461;325632;1397271;1397271;1397760;1698327;1608732;1723392;186850;186850;786432;1885177;1795582;2509824
876360,397;301056;212173;325632;1397271;1397272;1397760;1698327;1609445;1723392;186864;186864;786432;1885191;1796309;2509824
876366,059;301056;210853;325632;1397271;1397271;1397760;1698327;1608124;1723392;186864;186864;786432;1885191;1794988;2509824
876377,533;301056;210666;325632;1397271;1397272;1397760;1698327;1607938;1723392;186864;186864;786432;1885191;1794802;2509824
876386,698;301056;213069;325632;1397271;1397271;1397760;1698327;1610340;1723392;186864;186864;786432;1885191;1797204;2509824
876394,292;301056;213046;325632;1397271;1397271;1397760;1698327;1610317;1723392;186870;186870;786432;1885197;1797187;2509824
876404,256;301056;213456;325632;1397271;1397271;1397760;1698327;1610727;1723392;186870;186870;786432;1885197;1797597;2509824
876412,225;301056;213580;325632;1397271;1397272;1397760;1698327;1610852;1723392;187038;186986;786432;1885365;1797838;2509824
876419,134;301056;215248;325632;1397271;1397271;1397760;1698327;1612519;1723392;186992;186876;786432;1885319;1799395;2509824
876424,966;301056;214647;325632;1397271;1397272;1397760;1698327;1611919;1723392;186876;186876;786432;1885203;1798795;2509824
876430,620;301056;213315;325632;1397271;1397271;1397760;1698327;1610586;1723392;186876;186876;786432;1885203;1797462;2509824
876434,086;301056;214717;325632;1397271;1397271;1397760;1698327;1611988;1723392;186876;186876;786432;1885203;1798864;2509824
876437,377;301056;213552;325632;1397271;1397272;1397760;1698327;1610824;1723392;186876;186876;786432;1885203;1797700;2509824
876441,675;301056;213634;325632;1397271;1397272;1397760;1698327;1610906;1723392;186881;186881;786432;1885208;1797787;2509824
876447,467;301056;214611;325632;1397271;1397271;1397760;1698327;1611882;1723392;186881;186881;786432;1885208;1798763;2509824
876453,256;301056;214770;325632;1397271;1397271;1397760;1698327;1612041;1723392;186884;186884;786432;1885211;1798925;2509824
876467,153;301056;213867;325632;1397271;1397272;1397760;1698327;1611139;1723392;186884;186884;786432;1885211;1798023;2509824
876470,577;301056;215359;325632;1397271;1397271;1397760;1698327;1612630;1723392;186884;186884;786432;1885211;1799514;2509824
876475,656;301056;214826;325632;1397271;1397272;1397760;1698327;1612098;1723392;186887;186887;786432;1885214;1798985;2509824
876482,017;301056;215213;325632;1397271;1397271;1397760;1698327;1612484;1723392;186887;186887;786432;1885214;1799371;2509824
876486,585;301056;216698;325632;1397271;1397271;1397760;1698327;1613969;1723392;187055;187003;786432;1885382;1800972;2509824
876491,081;301056;215210;325632;1397271;1397271;1397760;1698327;1612481;1723392;187117;186950;786432;1885444;1799431;2509824
876500,859;301056;213528;325632;1397271;1397272;1397760;1698327;1610800;1723392;187006;187006;786432;1885333;1797806;2509824
876509,847;301056;214936;325632;1397271;1397272;1397760;1698327;1612208;1723392;187006;186890;786432;1885333;1799098;2509824
876516,067;301056;214645;325632;1397271;1397272;1397760;1698327;1611917;1723392;186890;186890;786432;1885217;1798807;2509824
876524,510;301056;215401;325632;1397271;1397272;1397760;1698327;1612673;1723392;187058;187007;786432;1885385;1799680;2509824
876534,633;301056;214173;325632;1397271;1397271;1397760;1698327;1611444;1723392;187007;186891;786432;1885334;1798335;2509824
876541,519;301042;214271;325632;1397271;1397271;1397760;1698313;1611542;1723392;186891;186839;786432;1885204;1798381;2509824
876566,361;301056;214904;325632;1397271;1397271;1397760;1698327;1612175;1723392;187007;187007;786432;1885334;1799182;2509824
876582,880;301056;215327;325632;1397271;1397271;1397760;1698327;1612598;1723392;187007;186891;786432;1885334;1799489;2509824
876600,127;301056;216227;325632;1397271;1397271;1397760;1698327;1613498;1723392;186891;186891;786432;1885218;1800389;2509824
876617,243;301056;214721;325632;1397271;1397272;1397760;1698327;1611993;1723392;186891;186891;786432;1885218;1798884;2509824
876624,276;301056;216485;325632;1397271;1397271;1397760;1698327;1613756;1723392;186893;186893;786432;1885220;1800649;2509824
876631,886;301056;215091;325632;1397271;1397272;1397760;1698327;1612363;1723392;186893;186893;786432;1885220;1799256;2509824
876658,620;301056;215105;325632;1397271;1397271;1397760;1698327;1612376;1723392;186893;186893;786432;1885220;1799269;2509824
876664,038;300714;215553;325632;1397271;1397272;1397760;1697985;1612825;1723392;186893;186893;786432;1884878;1799718;2509824
876668,975;301056;215646;325632;1397271;1397271;1397760;1698327;1612917;1723392;187060;187008;786432;1885387;1799925;2509824
876682,330;301056;215788;325632;1397271;1397271;1397760;1698327;1613059;1723392;187176;187008;786432;1885503;1800067;2509824
876692,247;301056;215297;325632;1397271;1397272;1397760;1698327;1612569;1723392;187008;186893;786432;1885335;1799462;2509824
876696,159;301045;217030;325632;1397271;1397271;1397760;1698316;1614301;1723392;186893;186893;786432;1885209;1801194;2509824
876709,352;301056;216350;325632;1397271;1397272;1397760;1698327;1613622;1723392;187065;187013;786432;1885392;1800635;2509824
876713,096;301056;215337;325632;1397271;1397272;1397760;1698327;1612609;1723392;187013;186897;786432;1885340;1799506;2509824
876721,592;301056;217476;325632;1397271;1397271;1397760;1698327;1614747;1723392;186897;186897;786432;1885224;1801644;2509824
876728,509;301056;216634;325632;1397271;1397271;1397760;1698327;1613905;1723392;186944;186944;786432;1885271;1800849;2509824
876734,408;301056;216318;325632;1397271;1397272;1397760;1698327;1613590;1723392;186944;186944;786432;1885271;1800534;2509824
876737,450;301056;217761;325632;1397271;1397272;1397760;1698327;1615033;1723392;186944;186893;786432;1885271;1801926;2509824
876741,162;301056;219543;325632;1397271;1397271;1397760;1698327;1616814;1723392;187060;187060;786432;1885387;1803874;2509824
876746,793;301056;218326;325632;1397271;1397271;1397760;1698327;1615597;1723392;187060;186944;786432;1885387;1802541;2509824
876751,161;301056;219924;325632;1397271;1397271;1397760;1698327;1617195;1723392;186944;186944;786432;1885271;1804139;2509824
876766,949;301056;218443;325632;1397271;1397271;1397760;1698327;1615714;1723392;186944;186944;786432;1885271;1802658;2509824
876773,079;301050;217665;325632;1397272;1397272;1397760;1698322;1614937;1723392;186944;186893;786432;1885266;1801830;2509824
876792,636;300803;220112;325632;1397271;1397272;1397760;1698074;1617384;1723392;187060;187060;786432;1885134;1804444;2509824
876805,556;301056;219834;325632;1397271;1397272;1397760;1698327;1617106;1723392;187060;186944;786432;1885387;1804050;2509824
876815,059;301056;218370;325632;1397271;1397272;1397760;1698327;1615642;1723392;186944;186944;786432;1885271;1802586;2509824
876826,622;301056;218641;325632;1397271;1397271;1397760;1698327;1615912;1723392;186944;186944;786432;1885271;1802856;2509824
876846,850;301056;219901;325632;1397271;1397504;1397760;1698327;1617405;1723392;187112;187060;786432;1885439;1804465;2509824
876860,305;301056;218662;325632;1397503;1397503;1397760;1698559;1616165;1723392;187060;186944;786432;1885619;1803109;2509824
876896,765;301056;220533;325632;1397503;1397504;1397760;1698559;1618037;1723392;187112;187060;786432;1885671;1805097;2509824
876967,326;301056;219166;325632;1397503;1397503;1397760;1698559;1616669;1723392;187060;186944;786432;1885619;1803613;2509824
876973,553;301056;220148;325632;1397503;1397503;1397760;1698559;1617651;1723392;186944;186944;786432;1885503;1804595;2509824
877015,877;301056;218759;325632;1397503;1397503;1397760;1698559;1616262;1723392;186944;186944;786432;1885503;1803206;2509824
877030,134;301056;219471;325632;1397503;1397504;1397760;1698559;1616975;1723392;186944;186927;786432;1885503;1803902;2509824
877094,514;301056;218860;325632;1397503;1397504;1397760;1698559;1616364;1723392;186927;186927;786432;1885486;1803291;2509824
877100,101;301056;219720;325632;1397503;1397503;1397760;1698559;1617223;1723392;186927;186927;786432;1885486;1804150;2509824
877111,191;301056;220314;325632;1397503;1397503;1397760;1698559;1617817;1723392;187103;187051;786432;1885662;1804868;2509824
877120,767;301056;219063;325632;1397503;1397503;1397760;1698559;1616566;1723392;187051;186936;786432;1885610;1803502;2509824
877124,612;301056;218631;325632;1397503;1397503;1397760;1698559;1616134;1723392;186936;186936;786432;1885495;1803070;2509824
877130,533;301056;220001;325632;1397503;1397504;1397760;1698559;1617505;1723392;186936;186936;786432;1885495;1804441;2509824
877135,074;301056;221071;325632;1397503;1397503;1397760;1698559;1618574;1723392;187103;187051;786432;1885662;1805625;2509824
877153,412;301056;221799;325632;1397503;1397504;1397760;1698559;1619303;1723392;187051;186936;786432;1885610;1806239;2509824
877168,073;301056;220164;325632;1397503;1397503;1397760;1698559;1617667;1723392;186936;186936;786432;1885495;1804603;2509824
877173,267;301056;220019;325632;1397503;1397504;1397760;1698559;1617523;1723392;186948;186948;786432;1885507;1804471;2509824
877180,352;301056;220687;325632;1397503;1397503;1397760;1698559;1618190;1723392;186948;186948;786432;1885507;1805138;2509824
877183,871;301056;222694;325632;1397503;1397503;1397760;1698559;1620197;1723392;186948;186948;786432;1885507;1807145;2509824
877189,657;301056;221649;325632;1397503;1397504;1397760;1698559;1619153;1723392;186948;186948;786432;1885507;1806101;2509824
877195,299;301056;220559;325632;1397503;1397504;1397760;1698559;1618063;1723392;186964;186964;786432;1885523;1805027;2509824
877200,649;301056;220656;325632;1397503;1397503;1397760;1698559;1618159;1723392;186964;186964;786432;1885523;1805123;2509824
877204,315;301056;222036;325632;1397503;1397504;1397760;1698559;1619540;1723392;186964;186964;786432;1885523;1806504;2509824
877223,317;301056;221814;325632;1397503;1397504;1397760;1698559;1619318;1723392;187131;187080;786432;1885690;1806398;2509824
877228,562;301056;222609;325632;1397503;1397504;1397760;1698559;1620113;1723392;187080;186964;786432;1885639;1807077;2509824
877243,764;301056;220981;325632;1397503;1397503;1397760;1698559;1618484;1723392;186964;186964;786432;1885523;1805448;2509824
877257,205;301056;220915;325632;1397503;1397503;1397760;1698559;1618418;1723392;186964;186964;786432;1885523;1805382;2509824
877262,179;301056;220928;325632;1397503;1397504;1397760;1698559;1618432;1723392;186964;186912;786432;1885523;1805344;2509824
877277,486;301056;221541;325632;1397503;1397504;1397760;1698559;1619045;1723392;187080;187080;786432;1885639;1806125;2509824
877283,338;301056;221530;325632;1397503;1397503;1397760;1698559;1619033;1723392;187247;187080;786432;1885806;1806113;2509824
877296,936;301056;221226;325632;1397503;1397503;1397760;1698559;1618729;1723392;187080;187080;786432;1885639;1805809;2509824
877319,177;301056;222635;325632;1397503;1397504;1397760;1698559;1620139;1723392;187080;186964;786432;1885639;1807103;2509824
877323,449;301056;221283;325632;1397503;1397503;1397760;1698559;1618786;1723392;186964;186964;786432;1885523;1805750;2509824
877327,099;301056;222724;325632;1397503;1397504;1397760;1698559;1620228;1723392;187024;186973;786432;1885583;1807201;2509824
877336,044;301056;224532;325632;1397503;1397503;1397760;1698559;1622035;1723392;187080;187080;786432;1885639;1809115;2509824
877351,129;301056;221872;325632;1397503;1397504;1397760;1698559;1619376;1723392;187080;186964;786432;1885639;1806340;2509824
877355,393;300798;222870;325632;1397503;1397503;1397760;1698301;1620373;1723392;186964;186964;786432;1885265;1807337;2509824
877377,479;301056;222208;325632;1397503;1397503;1397760;1698559;1619711;1723392;186964;186964;786432;1885523;1806675;2509824
877399,569;301056;223004;325632;1397503;1397504;1397760;1698559;1620508;1723392;186964;186964;786432;1885523;1807472;2509824
877404,353;300972;223849;325632;1397666;1397666;1397760;1698638;1621515;1723392;186964;186964;786432;1885602;1808479;2509824
877409,612;301056;224910;325632;1397669;1397507;1397760;1698725;1622417;1723392;187131;187080;786432;1885856;1809497;2509824
877418,003;301056;223405;325632;1397506;1397504;1397760;1698562;1620909;1723392;187080;186964;786432;1885642;1807873;2509824
877426,654;301056;223007;325632;1397503;1397503;1397760;1698559;1620510;1723392;186964;186964;786432;1885523;1807474;2509824
877435,188;301056;223106;325632;1397503;1397504;1397760;1698559;1620610;1723392;186964;186964;786432;1885523;1807574;2509824
877443,828;301056;223852;325632;1397503;1397503;1397760;1698559;1621355;1723392;187131;187080;786432;1885690;1808435;2509824
877459,162;301056;222838;325632;1397503;1397503;1397760;1698559;1620341;1723392;187080;186964;786432;1885639;1807305;2509824
877470,739;301056;223453;325632;1397503;1397503;1397760;1698559;1620956;1723392;186964;186964;786432;1885523;1807920;2509824
877483,284;301056;222948;325632;1397503;1397504;1397760;1698559;1620452;1723392;186964;186964;786432;1885523;1807416;2509824
877488,500;301056;222939;325632;1397503;1397503;1397760;1698559;1620442;1723392;186967;186967;786432;1885526;1807409;2509824
877491,924;301056;223497;325632;1397503;1397503;1397760;1698559;1621000;1723392;186967;186967;786432;1885526;1807967;2509824
877496,797;301056;223451;325632;1397503;1397504;1397760;1698559;1620955;1723392;186967;186967;786432;1885526;1807922;2509824
877500,891;301056;223996;325632;1397503;1397503;1397760;1698559;1621499;1723392;187134;187082;786432;1885693;1808581;2509824
877504,335;300669;224461;325632;1397503;1397503;1397760;1698172;1621964;1723392;187082;186967;786432;1885254;1808931;2509824
877507,344;301056;224941;325632;1397503;1397503;1397760;1698559;1622444;1723392;186967;186967;786432;1885526;1809411;2509824
877523,941;301056;224946;325632;1397503;1397504;1397760;1698559;1622450;1723392;186967;186967;786432;1885526;1809417;2509824
877528,517;301056;226722;325632;1397503;1397504;1397760;1698559;1624226;1723392;186967;186967;786432;1885526;1811193;2509824
877556,418;301056;225892;325632;1397503;1397504;1397760;1698559;1623396;1723392;186967;186967;786432;1885526;1810363;2509824
877561,425;301056;226039;325632;1397503;1397503;1397760;1698559;1623542;1723392;186967;186967;786432;1885526;1810509;2509824
877582,620;301056;226728;325632;1397503;1397503;1397760;1698559;1624231;1723392;186967;186967;786432;1885526;1811198;2509824
877589,503;301056;227566;325632;1397503;1397503;1397760;1698559;1625069;1723392;186967;186967;786432;1885526;1812036;2509824
877605,438;301056;225622;325632;1397503;1397503;1397760;1698559;1623125;1723392;186967;186967;786432;1885526;1810092;2509824
877617,365;301056;227224;325632;1397503;1397504;1397760;1698559;1624728;1723392;186967;186967;786432;1885526;1811695;2509824
877632,346;301056;225571;325632;1397503;1397504;1397760;1698559;1623075;1723392;186967;186967;786432;1885526;1810042;2509824
877636,761;301056;225821;325632;1397503;1397503;1397760;1698559;1623324;1723392;186968;186968;786432;1885527;1810292;2509824
877641,520;301056;226225;325632;1397503;1397503;1397760;1698559;1623728;1723392;186968;186968;786432;1885527;1810696;2509824
877646,739;301056;226820;325632;1397503;1397504;1397760;1698559;1624324;1723392;186968;186968;786432;1885527;1811292;2509824
877650,306;301056;226746;325632;1397503;1397503;1397760;1698559;1624249;1723392;186968;186968;786432;1885527;1811217;2509824
877654,360;301056;226156;325632;1397503;1397503;1397760;1698559;1623659;1723392;186968;186968;786432;1885527;1810627;2509824
877679,111;301056;227105;325632;1397503;1397503;1397760;1698559;1624608;1723392;187136;187084;786432;1885695;1811692;2509824
877686,573;301056;225965;325632;1397503;1397503;1397760;1698559;1623468;1723392;187084;186968;786432;1885643;1810436;2509824
877702,383;301056;225756;325632;1397503;1397503;1397760;1698559;1623259;1723392;186968;186968;786432;1885527;1810227;2509824
877707,209;301056;225912;325632;1397503;1397503;1397760;1698559;1623415;1723392;186968;186968;786432;1885527;1810383;2509824
877712,500;301056;226149;325632;1397503;1397504;1397760;1698559;1623653;1723392;186968;186968;786432;1885527;1810621;2509824
877718,337;301056;226377;325632;1397503;1397504;1397760;1698559;1623881;1723392;186968;186917;786432;1885527;1810798;2509824
877736,142;301056;226677;325632;1397503;1397504;1397760;1698559;1624181;1723392;187084;187084;786432;1885643;1811265;2509824
877739,262;301056;226563;325632;1397503;1397503;1397760;1698559;1624066;1723392;187084;186968;786432;1885643;1811034;2509824
877751,764;301056;227799;325632;1397503;1397503;1397760;1698559;1625302;1723392;186968;186968;786432;1885527;1812270;2509824
877764,548;300787;226703;325632;1397503;1397503;1397760;1698290;1624206;1723392;186968;186968;786432;1885258;1811174;2509824
877795,158;301027;227180;325632;1397534;1397535;1397760;1698561;1624715;1723392;186968;186968;786432;1885529;1811683;2509824
877814,765;301056;226282;325632;1397539;1397503;1397760;1698595;1623785;1723392;186968;186968;786432;1885563;1810753;2509824
877819,001;301056;228155;325632;1397503;1397503;1397760;1698559;1625658;1723392;186968;186968;786432;1885527;1812626;2509824
877833,866;301056;225826;325632;1397503;1397503;1397760;1698559;1623329;1723392;186969;186969;786432;1885528;1810298;2509824
877842,805;301056;225562;325632;1397503;1397503;1397760;1698559;1623065;1723392;186969;186969;786432;1885528;1810034;2509824
877866,785;301056;226522;325632;1397503;1397503;1397760;1698559;1624025;1723392;187136;187084;786432;1885695;1811109;2509824
877887,409;301056;225399;325632;1397503;1397503;1397760;1698559;1622902;1723392;187084;186969;786432;1885643;1809871;2509824
877923,720;301056;225464;325632;1397503;1397503;1397760;1698559;1622967;1723392;186969;186969;786432;1885528;1809936;2509824
877930,468;301056;225516;325632;1397503;1397503;1397760;1698559;1623019;1723392;186969;186969;786432;1885528;1809988;2509824
877938,001;301056;225383;325632;1397503;1397503;1397760;1698559;1622886;1723392;186969;186969;786432;1885528;1809855;2509824
877943,009;301056;225467;325632;1397503;1397503;1397760;1698559;1622970;1723392;186969;186969;786432;1885528;1809939;2509824
877958,676;301056;225228;325632;1397503;1397503;1397760;1698559;1622731;1723392;187136;187084;786432;1885695;1809815;2509824
877966,340;301056;224577;325632;1397503;1397503;1397760;1698559;1622080;1723392;187084;186917;786432;1885643;1808997;2509824
878035,349;301056;218968;325632;1397503;1397504;1397760;1698559;1616472;1723392;187084;187084;786432;1885643;1803556;2509824
878046,954;301056;218859;325632;1397503;1397503;1397760;1698559;1616362;1723392;187084;186969;786432;1885643;1803331;2509824
878068,926;301056;219400;325632;1397503;1397503;1397760;1698559;1616903;1723392;187136;187084;786432;1885695;1803987;2509824
878138,036;301056;218658;325632;1397503;1397503;1397760;1698559;1616161;1723392;187084;186969;786432;1885643;1803130;2509824
878156,994;301056;219342;325632;1397503;1397503;1397760;1698559;1616845;1723392;186969;186966;786432;1885528;1803811;2509824
878188,673;301056;217749;325632;1397503;1397504;1397760;1698559;1615253;1723392;186966;186966;786432;1885525;1802219;2509824
878195,538;301056;217850;325632;1397503;1397503;1397760;1698559;1615353;1723392;186971;186971;786432;1885530;1802324;2509824
878203,255;301056;217691;325632;1397503;1397503;1397760;1698559;1615194;1723392;186971;186971;786432;1885530;1802165;2509824
878207,358;301056;218754;325632;1397503;1397504;1397760;1698559;1616258;1723392;186971;186971;786432;1885530;1803229;2509824
878227,048;301056;220315;325632;1397503;1397504;1397760;1698559;1617819;1723392;187306;187203;786432;1885865;1805022;2509824
878236,194;301056;218077;325632;1397503;1397504;1397760;1698559;1615581;1723392;187203;186971;786432;1885762;1802552;2509824
878258,077;301056;218116;325632;1397503;1397503;1397760;1698559;1615619;1723392;186971;186971;786432;1885530;1802590;2509824
878266,969;301056;218380;325632;1397503;1397503;1397760;1698559;1615883;1723392;186971;186920;786432;1885530;1802803;2509824
878291,192;301056;219172;325632;1397503;1397503;1397760;1698559;1616675;1723392;187087;187087;786432;1885646;1803762;2509824
878298,445;301056;218383;325632;1397503;1397503;1397760;1698559;1615886;1723392;187087;186971;786432;1885646;1802857;2509824
878312,932;301056;219058;325632;1397503;1397503;1397760;1698559;1616561;1723392;187139;187087;786432;1885698;1803648;2509824
878323,604;301056;218775;325632;1397503;1397503;1397760;1698559;1616278;1723392;187087;186971;786432;1885646;1803249;2509824
878332,151;301056;218955;325632;1397503;1397503;1397760;1698559;1616458;1723392;186971;186971;786432;1885530;1803429;2509824
878357,010;301056;219610;325632;1397503;1397503;1397760;1698559;1617113;1723392;187139;187087;786432;1885698;1804200;2509824
878380,718;301056;218941;325632;1397503;1397504;1397760;1698559;1616445;1723392;187087;186971;786432;1885646;1803416;2509824
878387,657;301056;219036;325632;1397503;1397503;1397760;1698559;1616539;1723392;186971;186971;786432;1885530;1803510;2509824
878397,041;301056;219545;325632;1397503;1397503;1397760;1698559;1617048;1723392;186971;186971;786432;1885530;1804019;2509824
878402,431;301056;219756;325632;1397503;1397504;1397760;1698559;1617260;1723392;187010;186907;786432;1885569;1804167;2509824
878421,219;301056;220461;325632;1397503;1397503;1397760;1698559;1617964;1723392;187203;187203;786432;1885762;1805167;2509824
878432,072;301056;219237;325632;1397503;1397503;1397760;1698559;1616740;1723392;187203;186971;786432;1885762;1803711;2509824
878452,360;301056;219304;325632;1397503;1397503;1397760;1698559;1616807;1723392;186971;186971;786432;1885530;1803778;2509824
878458,448;301056;219785;325632;1397503;1397503;1397760;1698559;1617288;1723392;187116;187064;786432;1885675;1804352;2509824
878484,001;301056;220458;325632;1397503;1397503;1397760;1698559;1617961;1723392;187087;187087;786432;1885646;1805048;2509824
878489,847;301056;220208;325632;1397503;1397503;1397760;1698559;1617711;1723392;187087;186971;786432;1885646;1804682;2509824
878495,828;301040;219793;325632;1397504;1397503;1397760;1698544;1617296;1723392;186971;186920;786432;1885515;1804216;2509824
878515,791;301056;220651;325632;1397503;1397503;1397760;1698559;1618154;1723392;187087;187087;786432;1885646;1805241;2509824
878519,242;301056;219780;325632;1397503;1397503;1397760;1698559;1617283;1723392;187087;186971;786432;1885646;1804254;2509824
878523,916;301056;220078;325632;1397503;1397503;1397760;1698559;1617581;1723392;186971;186920;786432;1885530;1804501;2509824
878547,027;301056;220612;325632;1397503;1397504;1397760;1698559;1618116;1723392;187087;187087;786432;1885646;1805203;2509824
878561,705;301056;220039;325632;1397503;1397503;1397760;1698559;1617542;1723392;187087;186891;786432;1885646;1804433;2509824
878597,321;301056;220086;325632;1397503;1397504;1397760;1698559;1617590;1723392;186891;186891;786432;1885450;1804481;2509824
878605,796;301056;219922;325632;1397503;1397503;1397760;1698559;1617425;1723392;186891;186891;786432;1885450;1804316;2509824
878610,770;301056;220364;325632;1397503;1397503;1397760;1698559;1617867;1723392;186891;186891;786432;1885450;1804758;2509824
878629,908;301056;221375;325632;1397503;1397503;1397760;1698559;1618878;1723392;187058;186990;786432;1885617;1805868;2509824
878652,424;301056;221468;325632;1397503;1397503;1397760;1698559;1618971;1723392;187158;186990;786432;1885717;1805961;2509824
878685,617;301056;221775;325632;1397503;1397503;1397760;1698559;1619278;1723392;186996;186880;786432;1885555;1806158;2509824
878707,284;301056;223228;325632;1397503;1397504;1397760;1698559;1620732;1723392;186896;186896;786432;1885455;1807628;2509824
878732,996;301056;221120;325632;1397503;1397503;1397760;1698559;1618623;1723392;186896;186896;786432;1885455;1805519;2509824
878736,948;301056;222575;325632;1397503;1397504;1397760;1698559;1620079;1723392;186898;186898;786432;1885457;1806977;2509824
878759,189;301056;222358;325632;1397503;1397504;1397760;1698559;1619862;1723392;187065;187013;786432;1885624;1806875;2509824
878765,830;301056;217520;325632;1397503;1397503;1397760;1698559;1615023;1723392;187013;186898;786432;1885572;1801921;2509824
878786,625;301056;217051;325632;1397503;1397503;1397760;1698559;1614554;1723392;186898;186898;786432;1885457;1801452;2509824
878807,745;301056;217670;325632;1397503;1397503;1397760;1698559;1615173;1723392;186898;186898;786432;1885457;1802071;2509824
878834,409;301056;217579;325632;1397503;1397503;1397760;1698559;1615082;1723392;186898;186898;786432;1885457;1801980;2509824
878847,389;301056;218046;325632;1397503;1397503;1397760;1698559;1615549;1723392;186898;186898;786432;1885457;1802447;2509824
878853,935;301056;218350;325632;1397503;1397504;1397760;1698559;1615854;1723392;187065;187013;786432;1885624;1802867;2509824
878876,316;301056;218063;325632;1397503;1397503;1397760;1698559;1615566;1723392;187013;187013;786432;1885572;1802579;2509824
878898,120;301056;218895;325632;1397503;1397503;1397760;1698559;1616398;1723392;187046;186930;786432;1885605;1803328;2509824
878928,605;301056;218612;325632;1397503;1397503;1397760;1698559;1616115;1723392;186930;186930;786432;1885489;1803045;2509824
878960,847;301056;217046;325632;1397503;1397504;1397760;1698559;1614550;1723392;186930;186930;786432;1885489;1801480;2509824
878967,683;301040;216889;325632;1397504;1397503;1397760;1698544;1614392;1723392;186930;186878;786432;1885474;1801270;2509824
878975,981;301056;219167;325632;1397503;1397504;1397760;1698559;1616671;1723392;187046;187046;786432;1885605;1803717;2509824
878981,457;301056;220387;325632;1397503;1397504;1397760;1698559;1617891;1723392;187062;186895;786432;1885621;1804786;2509824
879044,108;301056;221393;325632;1397503;1397503;1397760;1698559;1618896;1723392;187046;187046;786432;1885605;1805942;2509824
879096,490;301056;219170;325632;1397503;1397504;1397760;1698559;1616674;1723392;187051;186936;786432;1885610;1803610;2509824
879116,474;301056;220389;325632;1397503;1397504;1397760;1698559;1617893;1723392;186936;186936;786432;1885495;1804829;2509824
879134,441;301056;218208;325632;1397503;1397503;1397760;1698559;1615711;1723392;186936;186936;786432;1885495;1802647;2509824
879160,143;301056;221402;325632;1397503;1397504;1397760;1698559;1618906;1723392;186940;186940;786432;1885499;1805846;2509824
879184,707;301038;219833;325632;1397503;1397503;1397760;1698541;1617336;1723392;186940;186940;786432;1885481;1804276;2509824
879198,619;301056;215096;325632;1397503;1397503;1397760;1698559;1612599;1723392;186943;186943;786432;1885502;1799542;2509824
879204,029;301056;215519;325632;1397503;1397503;1397760;1698559;1613022;1723392;186943;186943;786432;1885502;1799965;2509824
879242,449;301056;217604;325632;1397503;1397503;1397760;1698559;1615107;1723392;186943;186943;786432;1885502;1802050;2509824
879264,238;301056;216720;325632;1397503;1397503;1397760;1698559;1614223;1723392;186943;186943;786432;1885502;1801166;2509824
879292,055;301056;216691;325632;1397503;1397503;1397760;1698559;1614194;1723392;186943;186943;786432;1885502;1801137;2509824
879311,921;301056;216377;325632;1397503;1397503;1397760;1698559;1613880;1723392;186943;186943;786432;1885502;1800823;2509824
879327,254;301056;216262;325632;1397503;1397504;1397760;1698559;1613766;1723392;186943;186943;786432;1885502;1800709;2509824
879334,251;301056;216985;325632;1397503;1397503;1397760;1698559;1614488;1723392;186943;186943;786432;1885502;1801431;2509824
879350,895;301056;219782;325632;1397503;1397504;1397760;1698559;1617286;1723392;187111;187059;786432;1885670;1804345;2509824
879368,242;300869;217298;325632;1397503;1397504;1397760;1698372;1614802;1723392;187059;186929;786432;1885431;1801731;2509824
879394,274;301056;218975;325632;1397503;1397503;1397760;1698559;1616478;1723392;187099;187047;786432;1885658;1803525;2509824
879472,348;301056;216758;325632;1397503;1397503;1397760;1698559;1614261;1723392;187047;186932;786432;1885606;1801193;2509824
879477,471;301056;216782;325632;1397503;1397503;1397760;1698559;1614285;1723392;186932;186932;786432;1885491;1801217;2509824
879490,402;301056;217425;325632;1397503;1397503;1397760;1698559;1614928;1723392;186932;186932;786432;1885491;1801860;2509824
879510,065;301056;218579;325632;1397503;1397503;1397760;1698559;1616082;1723392;186932;186932;786432;1885491;1803014;2509824
879513,621;301056;218376;325632;1397503;1397503;1397760;1698559;1615879;1723392;186932;186932;786432;1885491;1802811;2509824
879523,030;301056;219132;325632;1397503;1397503;1397760;1698559;1616635;1723392;187099;187047;786432;1885658;1803682;2509824
879532,699;301056;217744;325632;1397503;1397503;1397760;1698559;1615247;1723392;187047;186932;786432;1885606;1802179;2509824
879636,792;301056;217429;325632;1397503;1397504;1397760;1698559;1614933;1723392;186932;186932;786432;1885491;1801865;2509824
879646,568;301056;217512;325632;1397503;1397503;1397760;1698559;1615015;1723392;186932;186911;786432;1885491;1801926;2509824
879657,201;301056;218370;325632;1397503;1397504;1397760;1698559;1615874;1723392;187079;187027;786432;1885638;1802901;2509824
879692,063;301056;217666;325632;1397503;1397503;1397760;1698559;1615169;1723392;187027;186911;786432;1885586;1802080;2509824
879726,332;301056;218667;325632;1397503;1397503;1397760;1698559;1616170;1723392;187079;187021;786432;1885638;1803191;2509824
879811,315;301056;218976;325632;1397503;1397503;1397760;1698559;1616479;1723392;187039;186923;786432;1885598;1803402;2509824
879818,891;301056;220475;325632;1397503;1397503;1397760;1698559;1617978;1723392;186923;186923;786432;1885482;1804901;2509824
879866,650;301056;218124;325632;1397503;1397504;1397760;1698559;1615628;1723392;186923;186923;786432;1885482;1802551;2509824
879948,373;301056;216656;325632;1397503;1397503;1397760;1698559;1614159;1723392;186923;186920;786432;1885482;1801079;2509824
880008,694;301056;216682;325632;1397503;1397503;1397760;1698559;1614185;1723392;186920;186920;786432;1885479;1801105;2509824
880016,009;301056;216852;325632;1397503;1397503;1397760;1698559;1614355;1723392;186920;186826;786432;1885479;1801181;2509824
880031,245;301056;216883;325632;1397503;1397504;1397760;1698559;1614387;1723392;186826;186826;786432;1885385;1801213;2509824
880054,818;301056;217650;325632;1397503;1397503;1397760;1698559;1615153;1723392;186994;186942;786432;1885553;1802095;2509824
880161,209;300650;216139;325632;1397503;1397503;1397760;1698153;1613642;1723392;186942;186826;786432;1885095;1800468;2509824
880195,710;301056;219786;325632;1397503;1397503;1397760;1698559;1617289;1723392;186826;186826;786432;1885385;1804115;2509824
880224,337;301056;217286;325632;1397503;1397504;1397760;1698559;1614790;1723392;186827;186809;786432;1885386;1801599;2509824
880242,009;301056;217208;325632;1397503;1397503;1397760;1698559;1614711;1723392;186812;186812;786432;1885371;1801523;2509824
880263,008;301056;216563;325632;1397503;1397503;1397760;1698559;1614066;1723392;186812;186812;786432;1885371;1800878;2509824
880289,172;301038;216771;325632;1397503;1397503;1397760;1698541;1614274;1723392;186980;186928;786432;1885521;1801202;2509824
880303,020;301056;215882;325632;1397503;1397503;1397760;1698559;1613385;1723392;186928;186812;786432;1885487;1800197;2509824
880393,407;301056;215960;325632;1397503;1397504;1397760;1698559;1613464;1723392;186812;186812;786432;1885371;1800276;2509824
880406,083;301056;216554;325632;1397503;1397503;1397760;1698559;1614057;1723392;186980;186928;786432;1885539;1800985;2509824
880511,185;301056;215988;325632;1397503;1397504;1397760;1698559;1613492;1723392;186928;186928;786432;1885487;1800420;2509824
880537,236;301056;216366;325632;1397503;1397503;1397760;1698559;1613869;1723392;187096;186912;786432;1885655;1800781;2509824
880611,702;301006;215833;325632;1397503;1397503;1397760;1698509;1613336;1723392;186924;186808;786432;1885433;1800144;2509824
880667,360;301056;217644;325632;1397503;1397503;1397760;1698559;1615147;1723392;186814;186814;786432;1885373;1801961;2509824
880684,766;301056;218019;325632;1397503;1397503;1397760;1698559;1615522;1723392;186814;186814;786432;1885373;1802336;2509824
880694,163;301056;217630;325632;1397503;1397503;1397760;1698559;1615133;1723392;186814;186814;786432;1885373;1801947;2509824
880705,079;301056;218507;325632;1397503;1397503;1397760;1698559;1616010;1723392;186814;186814;786432;1885373;1802824;2509824
880720,772;301056;216844;325632;1397503;1397503;1397760;1698559;1614347;1723392;186845;186845;786432;1885404;1801192;2509824
880732,881;301056;216375;325632;1397503;1397503;1397760;1698559;1613878;1723392;186845;186845;786432;1885404;1800723;2509824
880745,342;301056;216461;325632;1397503;1397504;1397760;1698559;1613965;1723392;186845;186845;786432;1885404;1800810;2509824
880760,822;301056;216643;325632;1397503;1397503;1397760;1698559;1614146;1723392;186845;186845;786432;1885404;1800991;2509824
880770,986;301056;217798;325632;1397503;1397504;1397760;1698559;1615302;1723392;186845;186794;786432;1885404;1802096;2509824
880802,545;301056;218444;325632;1397503;1397503;1397760;1698559;1615947;1723392;186961;186961;786432;1885520;1802908;2509824
880822,515;301041;217210;325632;1397503;1397503;1397760;1698544;1614713;1723392;186961;186794;786432;1885505;1801507;2509824
880839,696;301056;222876;325632;1397503;1397504;1397760;1698559;1620380;1723392;186961;186961;786432;1885520;1807341;2509824
880871,309;301056;218188;325632;1397503;1397503;1397760;1698559;1615691;1723392;186961;186845;786432;1885520;1802536;2509824
880916,660;301056;216021;325632;1397503;1397503;1397760;1698559;1613524;1723392;186845;186845;786432;1885404;1800369;2509824
880926,170;301056;216204;325632;1397503;1397503;1397760;1698559;1613707;1723392;186845;186845;786432;1885404;1800552;2509824
880930,125;301056;216706;325632;1397503;1397503;1397760;1698559;1614209;1723392;186845;186845;786432;1885404;1801054;2509824
880935,835;301056;216519;325632;1397503;1397503;1397760;1698559;1614022;1723392;186845;186845;786432;1885404;1800867;2509824
880953,309;301056;217130;325632;1397503;1397503;1397760;1698559;1614633;1723392;186845;186845;786432;1885404;1801478;2509824
880977,381;301056;219761;325632;1397503;1397504;1397760;1698559;1617265;1723392;187013;186961;786432;1885572;1804226;2509824
881009,101;301056;217143;325632;1397503;1397503;1397760;1698559;1614646;1723392;186962;186846;786432;1885521;1801492;2509824
881079,943;301056;216935;325632;1397503;1397503;1397760;1698559;1614438;1723392;186846;186846;786432;1885405;1801284;2509824
881088,243;300807;217384;325632;1397503;1397503;1397760;1698310;1614887;1723392;186846;186846;786432;1885156;1801733;2509824
881107,854;301056;217272;325632;1397503;1397503;1397760;1698559;1614775;1723392;186846;186846;786432;1885405;1801621;2509824
881142,691;301056;220050;325632;1397503;1397503;1397760;1698559;1617553;1723392;187031;186979;786432;1885590;1804532;2509824
881163,479;301056;218216;325632;1397503;1397503;1397760;1698559;1615719;1723392;186979;186863;786432;1885538;1802582;2509824
881195,432;301056;219715;325632;1397503;1397504;1397760;1698559;1617219;1723392;186871;186871;786432;1885430;1804090;2509824
881221,059;301056;219940;325632;1397503;1397503;1397760;1698559;1617443;1723392;186871;186871;786432;1885430;1804314;2509824
881229,211;301056;221322;325632;1397503;1397504;1397760;1698559;1618826;1723392;186871;186871;786432;1885430;1805697;2509824
881253,470;301056;218946;325632;1397503;1397503;1397760;1698559;1616449;1723392;186871;186871;786432;1885430;1803320;2509824
881271,599;300888;219574;325632;1397504;1397503;1397760;1698392;1617077;1723392;186871;186871;786432;1885263;1803948;2509824
881290,729;301056;221853;325632;1397503;1397503;1397760;1698559;1619356;1723392;187039;186987;786432;1885598;1806343;2509824
881330,626;301056;220200;325632;1397503;1397503;1397760;1698559;1617703;1723392;186987;186871;786432;1885546;1804574;2509824
881386,718;301056;219525;325632;1397503;1397504;1397760;1698559;1617029;1723392;186871;186871;786432;1885430;1803900;2509824
881407,938;301056;218186;325632;1397503;1397503;1397760;1698559;1615689;1723392;186871;186871;786432;1885430;1802560;2509824
881428,267;301056;218522;325632;1397503;1397504;1397760;1698559;1616026;1723392;186871;186871;786432;1885430;1802897;2509824
881455,988;301056;219351;325632;1397503;1397503;1397760;1698559;1616854;1723392;187050;186999;786432;1885609;1803853;2509824
881523,943;301056;218106;325632;1397503;1397503;1397760;1698559;1615609;1723392;187046;186930;786432;1885605;1802539;2509824
881678,447;301056;217781;325632;1397503;1397503;1397760;1698559;1615284;1723392;186930;186930;786432;1885489;1802214;2509824
881735,804;301056;218984;325632;1397503;1397503;1397760;1698559;1616487;1723392;186930;186913;786432;1885489;1803400;2509824
881774,212;301056;219071;325632;1397503;1397503;1397760;1698559;1616574;1723392;186932;186932;786432;1885491;1803506;2509824
881986,624;301056;218831;325632;1397503;1397503;1397760;1698559;1616334;1723392;186941;186941;786432;1885500;1803275;2509824
882007,693;301056;219176;325632;1397503;1397503;1397760;1698559;1616679;1723392;186944;186841;786432;1885503;1803520;2509824
882058,264;301056;217541;325632;1397503;1397503;1397760;1698559;1615044;1723392;186844;186844;786432;1885403;1801888;2509824
882073,334;301056;216908;325632;1397503;1397503;1397760;1698559;1614411;1723392;186844;186844;786432;1885403;1801255;2509824
882093,723;301056;217055;325632;1397503;1397504;1397760;1698559;1614559;1723392;186844;186844;786432;1885403;1801403;2509824
882275,553;301056;218501;325632;1397503;1397503;1397760;1698559;1616004;1723392;186844;186844;786432;1885403;1802848;2509824
882643,868;301056;217468;325632;1397503;1397503;1397760;1698559;1614971;1723392;186849;186834;786432;1885408;1801805;2509824
882671,049;301056;216832;325632;1397503;1397504;1397760;1698559;1614336;1723392;186834;186282;786432;1885393;1800618;2509824
882687,515;301056;216301;325632;1397503;1397503;1397760;1698559;1613804;1723392;186312;186312;786432;1884871;1800116;2509824
882705,283;301056;216466;325632;1397503;1397503;1397760;1698559;1613969;1723392;186322;186322;786432;1884881;1800291;2509824
882709,820;301056;217934;325632;1397503;1397504;1397760;1698559;1615438;1723392;186397;186397;786432;1884956;1801835;2509824
882721,615;301056;216836;325632;1397503;1397503;1397760;1698559;1614339;1723392;186398;186398;786432;1884957;1800737;2509824
882730,033;301056;216200;325632;1397503;1397503;1397760;1698559;1613703;1723392;186449;186449;786432;1885008;1800152;2509824
882747,865;301056;216501;325632;1397503;1397503;1397760;1698559;1614004;1723392;186454;186454;786432;1885013;1800458;2509824
882767,078;301056;220021;325632;1397503;1397503;1397760;1698559;1617524;1723392;186670;186605;786432;1885229;1804129;2509824
882779,409;301056;216847;325632;1397503;1397503;1397760;1698559;1614350;1723392;186605;186489;786432;1885164;1800839;2509824
882787,760;301056;217019;325632;1397503;1397503;1397760;1698559;1614522;1723392;186583;186583;786432;1885142;1801105;2509824
882890,432;301016;216833;325632;1397504;1397503;1397760;1698520;1614336;1723392;186583;186583;786432;1885103;1800919;2509824
882898,748;301056;217472;325632;1397503;1397504;1397760;1698559;1614976;1723392;186800;186748;786432;1885359;1801724;2509824
883012,745;301056;218276;325632;1397503;1397503;1397760;1698559;1615779;1723392;186924;186873;786432;1885483;1802652;2509824
883022,393;300751;219057;325632;1397503;1397503;1397760;1698254;1616560;1723392;186873;186641;786432;1885127;1803201;2509824
883059,006;301056;220553;325632;1397503;1397504;1397760;1698559;1618057;1723392;186670;186670;786432;1885229;1804727;2509824
883064,825;301056;218724;325632;1397503;1397503;1397760;1698559;1616227;1723392;186670;186670;786432;1885229;1802897;2509824
883086,888;301056;218658;325632;1397503;1397503;1397760;1698559;1616161;1723392;186782;186782;786432;1885341;1802943;2509824
883093,739;301056;217904;325632;1397503;1397504;1397760;1698559;1615408;1723392;186782;186782;786432;1885341;1802190;2509824
883100,737;301056;218755;325632;1397503;1397503;1397760;1698559;1616258;1723392;186782;186782;786432;1885341;1803040;2509824
883108,791;301056;218409;325632;1397503;1397503;1397760;1698559;1615912;1723392;186787;186787;786432;1885346;1802699;2509824
883115,367;301056;218362;325632;1397503;1397503;1397760;1698559;1615865;1723392;186787;186787;786432;1885346;1802652;2509824
883127,942;301056;218628;325632;1397503;1397504;1397760;1698559;1616132;1723392;186787;186787;786432;1885346;1802919;2509824
883137,327;301056;218763;325632;1397503;1397504;1397760;1698559;1616267;1723392;186787;186787;786432;1885346;1803054;2509824
883165,571;301056;219150;325632;1397503;1397503;1397760;1698559;1616653;1723392;186832;186780;786432;1885391;1803433;2509824
883344,350;301056;219428;325632;1397503;1397504;1397760;1698559;1616932;1723392;186948;186948;786432;1885507;1803880;2509824
883435,596;301056;220995;325632;1397503;1397504;1397760;1698559;1618499;1723392;186976;186858;786432;1885535;1805357;2509824
883599,167;300724;219676;325632;1397503;1397503;1397760;1698227;1617179;1723392;186858;186858;786432;1885085;1804037;2509824
883651,391;301056;221242;325632;1397503;1397503;1397760;1698559;1618745;1723392;186861;186814;786432;1885420;1805559;2509824
883684,053;301056;219752;325632;1397503;1397504;1397760;1698559;1617256;1723392;186814;186802;786432;1885373;1804058;2509824
883708,235;301056;219528;325632;1397503;1397503;1397760;1698559;1617031;1723392;186802;186802;786432;1885361;1803833;2509824
883728,499;301056;219653;325632;1397503;1397503;1397760;1698559;1617156;1723392;186802;186802;786432;1885361;1803958;2509824
883747,442;301056;219999;325632;1397503;1397503;1397760;1698559;1617502;1723392;186802;186802;786432;1885361;1804304;2509824
883761,816;301056;224629;325632;1397503;1397504;1397760;1698559;1622133;1723392;186972;186921;786432;1885531;1809054;2509824
883937,098;301056;220156;325632;1397503;1397504;1397760;1698559;1617660;1723392;186921;186805;786432;1885480;1804465;2509824
883971,136;259554;173157;325632;1397504;1397425;1397760;1657058;1570582;1723392;187203;185050;786432;1844261;1755632;2509824
883981,583;175450;172906;325632;1397424;1397674;1397760;1572874;1570580;1723392;185052;185052;786432;1757926;1755632;2509824
